"","X","Unnamed..0","node","ethcat","agecat","treat","Trade_sex","Group_sex","degree","age.gp1","age.gp2","age.gp3","age.gp4","black","white","other","Tr","NoTr","Trade","NoTrade","Group","NoGroup","net"
"1",0,1,1,"black","age.gp3","NoTr","Trade","NoGroup",6,0,3,2,1,1,5,0,2,4,1,5,4,2,1
"2",970,971,971,"white","age.gp2","Tr","NoTrade","Group",26,1,13,8,4,4,20,2,6,20,6,20,16,10,1
"3",2411,2412,2412,"white","age.gp3","NoTr","Trade","Group",12,4,3,3,2,3,8,1,6,6,3,9,4,8,1
"4",2694,2695,2695,"white","age.gp4","NoTr","NoTrade","Group",14,0,1,5,8,2,12,0,6,8,1,13,8,6,1
"5",2729,2730,2730,"black","age.gp3","NoTr","NoTrade","NoGroup",8,1,4,1,2,7,0,1,0,8,1,7,2,6,1
"6",2840,2841,2841,"white","age.gp2","Tr","NoTrade","Group",31,3,15,6,7,4,24,3,6,25,4,27,15,16,1
"7",2964,2965,2965,"white","age.gp2","NoTr","NoTrade","NoGroup",12,0,5,4,3,2,9,1,5,7,1,11,7,5,1
"8",1,2,2,"black","age.gp3","NoTr","Trade","NoGroup",8,0,4,2,2,4,2,2,3,5,2,6,4,4,1
"9",212,213,213,"other","age.gp2","Tr","NoTrade","NoGroup",3,2,0,1,0,1,2,0,1,2,1,2,0,3,1
"10",223,224,224,"black","age.gp2","NoTr","NoTrade","NoGroup",9,1,4,2,2,5,4,0,1,8,2,7,6,3,1
"11",2212,2213,2213,"black","age.gp4","NoTr","Trade","Group",8,0,3,2,3,5,3,0,3,5,1,7,4,4,1
"12",2217,2218,2218,"black","age.gp4","NoTr","Trade","Group",9,0,2,2,5,5,4,0,2,7,3,6,6,3,1
"13",2288,2289,2289,"other","age.gp2","Tr","NoTrade","Group",12,2,4,5,1,3,9,0,4,8,2,10,6,6,1
"14",2363,2364,2364,"white","age.gp3","Tr","NoTrade","NoGroup",8,1,4,3,0,3,4,1,2,6,3,5,4,4,1
"15",2658,2659,2659,"white","age.gp2","NoTr","NoTrade","Group",29,1,15,7,6,5,22,2,11,18,1,28,15,14,1
"16",2690,2691,2691,"black","age.gp3","NoTr","NoTrade","NoGroup",3,1,0,1,1,2,1,0,0,3,1,2,1,2,1
"17",2,3,3,"black","age.gp3","NoTr","Trade","NoGroup",9,0,3,2,4,5,4,0,3,6,1,8,3,6,1
"18",17,18,18,"black","age.gp2","Tr","NoTrade","Group",17,2,5,6,4,9,5,3,4,13,2,15,10,7,1
"19",239,240,240,"white","age.gp2","Tr","NoTrade","Group",20,2,10,4,4,4,11,5,7,13,3,17,10,10,1
"20",517,518,518,"black","age.gp3","NoTr","NoTrade","NoGroup",8,2,1,3,2,7,1,0,2,6,1,7,2,6,1
"21",1270,1271,1271,"black","age.gp3","NoTr","NoTrade","NoGroup",5,0,0,2,3,3,2,0,1,4,2,3,2,3,1
"22",1482,1483,1483,"white","age.gp4","NoTr","NoTrade","NoGroup",4,0,1,3,0,1,3,0,1,3,1,3,1,3,1
"23",1528,1529,1529,"black","age.gp4","NoTr","NoTrade","NoGroup",5,0,0,1,4,3,2,0,0,5,1,4,3,2,1
"24",1696,1697,1697,"white","age.gp4","NoTr","Trade","NoGroup",9,0,2,3,4,1,7,1,4,5,1,8,4,5,1
"25",2269,2270,2270,"white","age.gp4","Tr","NoTrade","Group",11,0,3,2,6,1,9,1,3,8,2,9,7,4,1
"26",2836,2837,2837,"black","age.gp2","NoTr","NoTrade","NoGroup",13,0,5,5,3,7,5,1,4,9,1,12,5,8,1
"27",3,4,4,"black","age.gp3","NoTr","Trade","NoGroup",5,0,1,2,2,2,2,1,1,4,0,5,3,2,1
"28",1367,1368,1368,"black","age.gp4","NoTr","NoTrade","Group",5,0,0,2,3,2,3,0,1,4,1,4,3,2,1
"29",2050,2051,2051,"white","age.gp4","Tr","NoTrade","Group",11,2,2,1,6,1,10,0,2,9,1,10,7,4,1
"30",2131,2132,2132,"white","age.gp3","NoTr","NoTrade","Group",18,2,5,7,4,3,14,1,9,9,1,17,9,9,1
"31",2158,2159,2159,"other","age.gp2","NoTr","NoTrade","NoGroup",3,1,1,1,0,2,1,0,0,3,1,2,1,2,1
"32",2685,2686,2686,"black","age.gp3","NoTr","NoTrade","NoGroup",6,0,0,3,3,4,2,0,2,4,2,4,4,2,1
"33",4,5,5,"black","age.gp3","NoTr","Trade","NoGroup",2,0,0,2,0,1,1,0,0,2,0,2,1,1,1
"34",102,103,103,"white","age.gp3","NoTr","NoTrade","Group",20,4,3,9,4,8,12,0,4,16,3,17,9,11,1
"35",457,458,458,"black","age.gp3","NoTr","NoTrade","NoGroup",6,0,0,5,1,4,2,0,0,6,1,5,2,4,1
"36",5,6,6,"black","age.gp3","NoTr","Trade","NoGroup",8,1,5,1,1,3,4,1,3,5,0,8,2,6,1
"37",54,55,55,"black","age.gp2","NoTr","NoTrade","NoGroup",7,1,2,2,2,4,3,0,1,6,1,6,2,5,1
"38",342,343,343,"white","age.gp2","NoTr","NoTrade","Group",18,1,8,7,2,1,15,2,10,8,1,17,11,7,1
"39",1377,1378,1378,"black","age.gp2","NoTr","NoTrade","NoGroup",10,0,4,3,3,8,2,0,2,8,2,8,5,5,1
"40",1723,1724,1724,"white","age.gp1","Tr","NoTrade","NoGroup",12,5,1,4,2,1,9,2,2,10,2,10,5,7,1
"41",1815,1816,1816,"black","age.gp4","NoTr","NoTrade","NoGroup",1,0,0,1,0,1,0,0,0,1,1,0,0,1,1
"42",2292,2293,2293,"other","age.gp2","Tr","NoTrade","Group",9,1,3,5,0,1,8,0,2,7,2,7,6,3,1
"43",2748,2749,2749,"white","age.gp3","NoTr","NoTrade","NoGroup",8,2,3,3,0,2,6,0,3,5,1,7,4,4,1
"44",2796,2797,2797,"white","age.gp2","Tr","NoTrade","NoGroup",7,2,2,1,2,1,5,1,2,5,1,6,3,4,1
"45",6,7,7,"black","age.gp3","NoTr","Trade","NoGroup",8,0,5,2,1,7,1,0,1,7,0,8,4,4,1
"46",290,291,291,"black","age.gp2","NoTr","NoTrade","Group",19,2,3,7,7,13,6,0,5,14,3,16,8,11,1
"47",398,399,399,"black","age.gp4","NoTr","NoTrade","NoGroup",5,0,1,1,3,2,3,0,1,4,1,4,3,2,1
"48",963,964,964,"black","age.gp2","NoTr","NoTrade","Group",19,3,8,4,4,8,8,3,4,15,5,14,12,7,1
"49",1391,1392,1392,"black","age.gp3","NoTr","NoTrade","NoGroup",8,1,3,3,1,3,4,1,3,5,3,5,5,3,1
"50",1844,1845,1845,"black","age.gp3","NoTr","NoTrade","NoGroup",3,0,0,3,0,2,1,0,0,3,2,1,1,2,1
"51",2163,2164,2164,"white","age.gp2","Tr","NoTrade","NoGroup",20,3,8,6,3,2,16,2,6,14,1,19,8,12,1
"52",2347,2348,2348,"black","age.gp2","NoTr","NoTrade","Group",26,2,15,5,4,12,12,2,8,18,5,21,17,9,1
"53",2605,2606,2606,"black","age.gp2","NoTr","NoTrade","Group",20,1,8,5,6,10,8,2,5,15,2,18,8,12,1
"54",7,8,8,"black","age.gp3","NoTr","Trade","NoGroup",1,0,0,1,0,1,0,0,0,1,0,1,0,1,1
"55",2731,2732,2732,"black","age.gp3","NoTr","NoTrade","NoGroup",7,0,2,3,2,5,2,0,2,5,1,6,1,6,1
"56",8,9,9,"black","age.gp3","NoTr","Trade","NoGroup",11,0,4,4,3,9,2,0,3,8,1,10,7,4,1
"57",16,17,17,"black","age.gp2","Tr","NoTrade","Group",26,6,10,7,3,16,8,2,8,18,6,20,14,12,1
"58",452,453,453,"black","age.gp3","NoTr","NoTrade","NoGroup",6,0,2,3,1,4,2,0,1,5,1,5,4,2,1
"59",484,485,485,"black","age.gp4","NoTr","NoTrade","NoGroup",6,0,2,2,2,3,2,1,1,5,1,5,2,4,1
"60",1249,1250,1250,"white","age.gp2","Tr","NoTrade","Group",27,1,11,7,8,6,19,2,7,20,1,26,14,13,1
"61",1373,1374,1374,"black","age.gp4","NoTr","NoTrade","Group",13,1,3,5,4,9,3,1,1,12,2,11,4,9,1
"62",1417,1418,1418,"black","age.gp2","NoTr","NoTrade","NoGroup",10,1,5,4,0,6,4,0,3,7,2,8,4,6,1
"63",2075,2076,2076,"black","age.gp3","NoTr","NoTrade","NoGroup",9,0,3,2,4,6,3,0,2,7,1,8,5,4,1
"64",2235,2236,2236,"black","age.gp4","NoTr","Trade","Group",8,0,0,4,4,7,1,0,1,7,2,6,3,5,1
"65",2365,2366,2366,"black","age.gp2","Tr","NoTrade","Group",14,1,8,4,1,8,3,3,2,12,4,10,8,6,1
"66",2594,2595,2595,"white","age.gp3","NoTr","NoTrade","Group",13,3,5,3,2,1,10,2,3,10,3,10,11,2,1
"67",2847,2848,2848,"black","age.gp3","NoTr","NoTrade","Group",13,1,1,6,5,6,7,0,2,11,1,12,7,6,1
"68",9,10,10,"black","age.gp3","NoTr","Trade","NoGroup",4,0,1,2,1,1,3,0,1,3,0,4,3,1,1
"69",81,82,82,"white","age.gp4","NoTr","NoTrade","Group",12,1,3,3,5,2,10,0,4,8,1,11,8,4,1
"70",2366,2367,2367,"black","age.gp2","Tr","NoTrade","Group",18,1,8,5,4,8,10,0,6,12,3,15,10,8,1
"71",2401,2402,2402,"white","age.gp3","NoTr","NoTrade","NoGroup",11,2,1,4,4,1,10,0,5,6,1,10,7,4,1
"72",10,11,11,"black","age.gp3","NoTr","Trade","NoGroup",9,1,1,2,5,7,2,0,3,6,0,9,4,5,1
"73",394,395,395,"black","age.gp4","NoTr","NoTrade","NoGroup",5,0,1,3,1,2,3,0,1,4,1,4,1,4,1
"74",699,700,700,"white","age.gp4","Tr","NoTrade","Group",16,0,1,4,11,2,13,1,6,10,1,15,12,4,1
"75",2002,2003,2003,"black","age.gp4","NoTr","NoTrade","NoGroup",4,0,0,3,1,3,1,0,0,4,2,2,2,2,1
"76",2004,2005,2005,"black","age.gp4","NoTr","NoTrade","NoGroup",5,0,1,2,2,2,3,0,2,3,3,2,3,2,1
"77",2026,2027,2027,"black","age.gp4","NoTr","NoTrade","NoGroup",5,0,2,1,2,2,3,0,1,4,1,4,3,2,1
"78",2068,2069,2069,"white","age.gp3","Tr","NoTrade","Group",26,2,11,7,6,2,20,4,11,15,5,21,18,8,1
"79",2459,2460,2460,"black","age.gp1","NoTr","NoTrade","NoGroup",7,4,2,1,0,3,4,0,3,4,3,4,2,5,1
"80",2845,2846,2846,"black","age.gp3","NoTr","NoTrade","Group",10,0,2,6,2,4,5,1,5,5,3,7,6,4,1
"81",11,12,12,"black","age.gp3","NoTr","Trade","NoGroup",3,0,1,1,1,2,1,0,1,2,0,3,2,1,1
"82",446,447,447,"black","age.gp3","NoTr","NoTrade","NoGroup",5,1,1,2,1,3,1,1,0,5,1,4,2,3,1
"83",1369,1370,1370,"black","age.gp4","NoTr","NoTrade","Group",5,0,0,2,3,4,1,0,0,5,3,2,2,3,1
"84",2864,2865,2865,"white","age.gp2","Tr","NoTrade","Group",32,2,16,7,7,3,24,5,9,23,2,30,18,14,1
"85",12,13,13,"black","age.gp3","NoTr","Trade","NoGroup",6,1,2,2,1,4,2,0,1,5,1,5,3,3,1
"86",702,703,703,"white","age.gp2","NoTr","NoTrade","Group",30,3,14,9,4,1,25,4,15,15,2,28,16,14,1
"87",1478,1479,1479,"black","age.gp1","NoTr","NoTrade","NoGroup",5,1,2,1,1,2,2,1,2,3,2,3,4,1,1
"88",1763,1764,1764,"black","age.gp4","NoTr","NoTrade","NoGroup",5,0,1,1,3,3,2,0,2,3,1,4,2,3,1
"89",1843,1844,1844,"black","age.gp3","NoTr","NoTrade","NoGroup",9,1,5,1,2,5,3,1,3,6,1,8,3,6,1
"90",1867,1868,1868,"white","age.gp3","NoTr","NoTrade","Group",22,2,10,5,5,3,16,3,11,11,3,19,17,5,1
"91",2277,2278,2278,"black","age.gp2","Tr","Trade","Group",19,3,8,5,3,12,6,1,4,15,3,16,10,9,1
"92",13,14,14,"black","age.gp3","NoTr","Trade","NoGroup",9,0,2,1,6,3,5,1,1,8,0,9,7,2,1
"93",382,383,383,"black","age.gp4","NoTr","NoTrade","NoGroup",12,1,3,4,4,7,4,1,3,9,5,7,8,4,1
"94",868,869,869,"other","age.gp2","Tr","NoTrade","Group",9,0,4,4,1,1,8,0,4,5,1,8,5,4,1
"95",1060,1061,1061,"white","age.gp4","NoTr","NoTrade","Group",5,0,1,2,2,1,4,0,2,3,1,4,3,2,1
"96",1062,1063,1063,"white","age.gp4","NoTr","NoTrade","Group",11,3,1,2,5,2,8,1,3,8,2,9,6,5,1
"97",1291,1292,1292,"white","age.gp4","NoTr","NoTrade","Group",10,1,3,3,3,4,6,0,5,5,2,8,6,4,1
"98",1326,1327,1327,"white","age.gp3","NoTr","NoTrade","NoGroup",10,1,2,5,2,3,6,1,5,5,1,9,5,5,1
"99",1363,1364,1364,"black","age.gp4","NoTr","NoTrade","Group",15,0,5,6,4,8,6,1,2,13,3,12,7,8,1
"100",1947,1948,1948,"white","age.gp4","NoTr","NoTrade","Group",15,2,3,3,7,2,13,0,6,9,1,14,11,4,1
"101",2346,2347,2347,"black","age.gp2","NoTr","NoTrade","Group",13,0,6,6,1,7,6,0,3,10,2,11,7,6,1
"102",14,15,15,"black","age.gp2","Tr","NoTrade","Group",19,1,11,5,2,13,6,0,2,17,2,17,8,11,1
"103",55,56,56,"black","age.gp2","NoTr","NoTrade","NoGroup",6,1,2,2,1,4,2,0,2,4,1,5,3,3,1
"104",57,58,58,"black","age.gp2","NoTr","NoTrade","NoGroup",4,0,3,1,0,3,1,0,1,3,0,4,2,2,1
"105",85,86,86,"white","age.gp4","NoTr","NoTrade","Group",14,2,4,2,6,2,9,3,4,10,2,12,7,7,1
"106",227,228,228,"black","age.gp2","NoTr","NoTrade","NoGroup",14,1,3,8,2,8,5,1,5,9,2,12,7,7,1
"107",236,237,237,"white","age.gp2","Tr","NoTrade","Group",26,1,13,5,7,3,21,2,10,16,4,22,20,6,1
"108",496,497,497,"black","age.gp4","NoTr","NoTrade","NoGroup",5,0,1,0,4,1,4,0,2,3,1,4,3,2,1
"109",520,521,521,"black","age.gp3","NoTr","NoTrade","NoGroup",6,0,5,0,1,4,2,0,3,3,0,6,5,1,1
"110",962,963,963,"black","age.gp2","NoTr","NoTrade","Group",21,1,7,8,5,11,8,2,4,17,2,19,8,13,1
"111",968,969,969,"white","age.gp2","Tr","NoTrade","Group",25,1,9,7,8,4,18,3,9,16,0,25,17,8,1
"112",1474,1475,1475,"black","age.gp1","NoTr","NoTrade","NoGroup",8,6,1,0,1,4,2,2,1,7,1,7,2,6,1
"113",2206,2207,2207,"black","age.gp2","NoTr","Trade","Group",10,0,5,3,2,8,2,0,2,8,1,9,5,5,1
"114",2390,2391,2391,"black","age.gp2","NoTr","NoTrade","NoGroup",10,0,8,1,1,6,4,0,3,7,1,9,7,3,1
"115",2392,2393,2393,"black","age.gp2","NoTr","NoTrade","NoGroup",5,0,3,2,0,3,2,0,1,4,0,5,2,3,1
"116",2412,2413,2413,"white","age.gp3","NoTr","Trade","Group",19,0,10,6,3,1,14,4,8,11,1,18,10,9,1
"117",2516,2517,2517,"black","age.gp2","NoTr","NoTrade","Group",20,1,14,0,5,8,11,1,8,12,2,18,16,4,1
"118",2723,2724,2724,"black","age.gp3","NoTr","NoTrade","NoGroup",4,0,1,3,0,2,2,0,3,1,0,4,3,1,1
"119",2728,2729,2729,"black","age.gp3","NoTr","NoTrade","NoGroup",12,0,10,2,0,5,4,3,6,6,1,11,7,5,1
"120",2881,2882,2882,"white","age.gp2","NoTr","NoTrade","NoGroup",18,2,11,4,1,2,13,3,11,7,0,18,13,5,1
"121",15,16,16,"black","age.gp2","Tr","NoTrade","Group",29,0,14,9,6,15,12,2,7,22,4,25,18,11,1
"122",148,149,149,"white","age.gp3","NoTr","NoTrade","Group",15,2,4,4,5,2,11,2,8,7,1,14,11,4,1
"123",294,295,295,"black","age.gp2","NoTr","NoTrade","Group",17,1,12,3,1,7,8,2,3,14,3,14,8,9,1
"124",299,300,300,"white","age.gp4","NoTr","NoTrade","Group",7,1,3,1,2,2,4,1,3,4,1,6,4,3,1
"125",464,465,465,"black","age.gp3","NoTr","Trade","Group",16,0,7,6,3,12,4,0,4,12,0,16,7,9,1
"126",470,471,471,"black","age.gp3","NoTr","Trade","Group",13,0,7,2,4,5,7,1,4,9,2,11,4,9,1
"127",474,475,475,"black","age.gp3","NoTr","Trade","Group",15,2,6,4,3,13,2,0,5,10,4,11,9,6,1
"128",708,709,709,"white","age.gp2","Tr","NoTrade","Group",18,0,11,2,5,1,17,0,9,9,1,17,11,7,1
"129",709,710,710,"white","age.gp2","Tr","NoTrade","Group",30,4,10,10,6,2,26,2,10,20,1,29,21,9,1
"130",742,743,743,"white","age.gp2","Tr","NoTrade","Group",17,0,9,4,4,2,13,2,8,9,0,17,15,2,1
"131",964,965,965,"black","age.gp2","NoTr","NoTrade","Group",15,1,10,2,2,8,6,1,7,8,1,14,7,8,1
"132",1041,1042,1042,"black","age.gp4","NoTr","NoTrade","NoGroup",6,0,3,1,2,1,5,0,3,3,0,6,5,1,1
"133",1104,1105,1105,"black","age.gp2","NoTr","NoTrade","NoGroup",9,0,7,1,1,4,3,2,6,3,1,8,6,3,1
"134",1525,1526,1526,"black","age.gp4","NoTr","NoTrade","NoGroup",6,0,1,0,5,5,1,0,1,5,2,4,4,2,1
"135",1808,1809,1809,"white","age.gp2","Tr","NoTrade","Group",35,5,14,9,7,3,31,1,9,26,2,33,18,17,1
"136",1925,1926,1926,"other","age.gp2","NoTr","NoTrade","NoGroup",6,0,3,3,0,1,5,0,3,3,0,6,4,2,1
"137",2006,2007,2007,"black","age.gp4","NoTr","NoTrade","NoGroup",2,0,2,0,0,1,1,0,1,1,0,2,2,0,1
"138",2079,2080,2080,"black","age.gp3","NoTr","NoTrade","NoGroup",3,0,2,1,0,3,0,0,1,2,0,3,3,0,1
"139",2108,2109,2109,"white","age.gp2","NoTr","NoTrade","NoGroup",13,1,4,7,1,2,8,3,3,10,2,11,11,2,1
"140",2138,2139,2139,"other","age.gp2","NoTr","NoTrade","NoGroup",7,1,3,2,1,2,5,0,3,4,2,5,5,2,1
"141",2209,2210,2210,"black","age.gp2","NoTr","Trade","Group",13,1,9,1,2,3,8,2,8,5,0,13,8,5,1
"142",2263,2264,2264,"white","age.gp4","Tr","NoTrade","Group",13,2,3,0,8,3,10,0,1,12,2,11,9,4,1
"143",2391,2392,2392,"black","age.gp2","NoTr","NoTrade","NoGroup",10,2,5,1,2,5,5,0,4,6,0,10,5,5,1
"144",2407,2408,2408,"white","age.gp3","NoTr","NoTrade","NoGroup",5,0,4,1,0,1,4,0,4,1,0,5,5,0,1
"145",2563,2564,2564,"white","age.gp4","NoTr","NoTrade","Group",12,0,5,2,5,2,9,1,4,8,3,9,5,7,1
"146",2595,2596,2596,"white","age.gp3","NoTr","NoTrade","Group",20,3,9,5,3,1,14,5,5,15,2,18,15,5,1
"147",2681,2682,2682,"black","age.gp3","NoTr","NoTrade","NoGroup",11,0,3,3,5,5,6,0,4,7,2,9,8,3,1
"148",2841,2842,2842,"white","age.gp2","Tr","NoTrade","Group",22,2,8,5,7,2,19,1,11,11,0,22,16,6,1
"149",2846,2847,2847,"black","age.gp3","NoTr","NoTrade","Group",17,1,3,7,6,11,6,0,3,14,3,14,11,6,1
"150",53,54,54,"white","age.gp2","Tr","NoTrade","Group",30,4,18,7,1,3,22,5,18,12,1,29,19,11,1
"151",98,99,99,"white","age.gp3","NoTr","NoTrade","Group",26,2,11,8,5,3,20,3,12,14,0,26,17,9,1
"152",345,346,346,"white","age.gp2","NoTr","NoTrade","Group",24,1,14,5,4,1,21,2,16,8,1,23,21,3,1
"153",631,632,632,"other","age.gp1","NoTr","Trade","Group",11,4,3,3,1,1,10,0,3,8,1,10,8,3,1
"154",885,886,886,"white","age.gp3","NoTr","Trade","Group",21,2,11,6,2,4,15,2,14,7,0,21,10,11,1
"155",1322,1323,1323,"white","age.gp2","Tr","NoTrade","Group",28,1,18,7,2,2,22,4,9,19,3,25,19,9,1
"156",1362,1363,1363,"black","age.gp4","NoTr","NoTrade","Group",12,0,3,1,8,10,2,0,3,9,3,9,7,5,1
"157",1554,1555,1555,"white","age.gp3","NoTr","NoTrade","Group",19,3,7,6,3,1,16,2,8,11,0,19,13,6,1
"158",1597,1598,1598,"black","age.gp1","Tr","Trade","NoGroup",7,4,3,0,0,4,2,1,2,5,0,7,3,4,1
"159",1667,1668,1668,"black","age.gp1","Tr","Trade","Group",15,6,2,1,6,9,3,3,4,11,1,14,6,9,1
"160",1830,1831,1831,"black","age.gp4","NoTr","NoTrade","NoGroup",3,0,1,1,1,2,1,0,1,2,0,3,2,1,1
"161",1904,1905,1905,"black","age.gp1","NoTr","NoTrade","NoGroup",5,1,1,2,1,3,2,0,2,3,1,4,2,3,1
"162",1930,1931,1931,"other","age.gp2","NoTr","NoTrade","NoGroup",12,0,6,4,2,2,10,0,3,9,0,12,9,3,1
"163",2037,2038,2038,"white","age.gp4","Tr","NoTrade","Group",10,1,3,1,5,1,8,1,4,6,0,10,8,2,1
"164",2088,2089,2089,"black","age.gp3","NoTr","NoTrade","NoGroup",8,0,4,1,3,6,2,0,3,5,0,8,6,2,1
"165",2164,2165,2165,"black","age.gp2","NoTr","NoTrade","NoGroup",13,2,5,5,1,6,5,2,3,10,0,13,9,4,1
"166",2368,2369,2369,"black","age.gp2","Tr","NoTrade","Group",26,2,12,6,6,17,8,1,10,16,3,23,16,10,1
"167",2458,2459,2459,"black","age.gp1","NoTr","NoTrade","NoGroup",10,7,2,0,1,6,4,0,3,7,1,9,3,7,1
"168",2461,2462,2462,"black","age.gp1","NoTr","NoTrade","NoGroup",9,5,3,1,0,4,2,3,3,6,1,8,4,5,1
"169",2606,2607,2607,"black","age.gp2","NoTr","NoTrade","Group",26,0,18,2,6,12,10,4,9,17,2,24,14,12,1
"170",226,227,227,"black","age.gp2","NoTr","NoTrade","NoGroup",11,0,5,5,1,5,6,0,3,8,0,11,6,5,1
"171",296,297,297,"white","age.gp4","NoTr","NoTrade","Group",13,2,4,4,3,2,9,2,5,8,1,12,9,4,1
"172",634,635,635,"other","age.gp1","NoTr","Trade","Group",10,5,2,1,2,1,9,0,5,5,1,9,6,4,1
"173",663,664,664,"white","age.gp2","NoTr","NoTrade","Group",21,2,12,3,4,4,14,3,10,11,0,21,12,9,1
"174",681,682,682,"white","age.gp4","Tr","NoTrade","Group",13,1,3,2,7,2,11,0,5,8,1,12,11,2,1
"175",1260,1261,1261,"black","age.gp3","NoTr","NoTrade","NoGroup",7,0,4,1,2,5,2,0,2,5,1,6,4,3,1
"176",1349,1350,1350,"black","age.gp4","NoTr","NoTrade","Group",9,1,2,3,3,7,2,0,2,7,0,9,3,6,1
"177",1385,1386,1386,"black","age.gp3","NoTr","NoTrade","NoGroup",10,1,2,3,4,6,4,0,6,4,0,10,5,5,1
"178",1761,1762,1762,"black","age.gp4","NoTr","NoTrade","NoGroup",5,1,2,1,1,4,1,0,3,2,0,5,2,3,1
"179",2069,2070,2070,"white","age.gp3","Tr","NoTrade","Group",22,4,11,4,3,3,18,1,6,16,0,22,13,9,1
"180",2173,2174,2174,"white","age.gp2","NoTr","NoTrade","Group",16,2,11,2,1,1,12,3,14,2,0,16,10,6,1
"181",2297,2298,2298,"other","age.gp2","Tr","NoTrade","Group",10,0,6,3,1,2,8,0,5,5,0,10,9,1,1
"182",2367,2368,2368,"black","age.gp2","Tr","NoTrade","Group",17,1,7,6,3,9,8,0,4,13,3,14,11,6,1
"183",2479,2480,2480,"other","age.gp1","NoTr","NoTrade","NoGroup",9,3,2,2,2,2,7,0,2,7,1,8,3,6,1
"184",2686,2687,2687,"black","age.gp3","NoTr","NoTrade","NoGroup",6,1,3,0,2,3,2,1,2,4,0,6,2,4,1
"185",2854,2855,2855,"black","age.gp3","NoTr","NoTrade","Group",15,0,10,4,1,8,6,1,5,10,0,15,10,5,1
"186",18,19,19,"black","age.gp2","Tr","NoTrade","Group",19,0,6,7,6,12,7,0,2,17,4,15,13,6,1
"187",293,294,294,"black","age.gp2","NoTr","NoTrade","Group",17,1,9,3,4,7,9,1,4,13,2,15,11,6,1
"188",932,933,933,"white","age.gp3","NoTr","NoTrade","NoGroup",7,1,2,3,1,1,6,0,7,0,1,6,5,2,1
"189",1050,1051,1051,"black","age.gp4","NoTr","NoTrade","NoGroup",8,0,3,0,5,5,3,0,3,5,1,7,5,3,1
"190",1346,1347,1347,"black","age.gp4","NoTr","NoTrade","Group",10,0,2,3,5,6,4,0,4,6,1,9,7,3,1
"191",1358,1359,1359,"black","age.gp4","NoTr","NoTrade","Group",9,1,3,1,4,6,3,0,3,6,1,8,4,5,1
"192",1375,1376,1376,"black","age.gp2","NoTr","NoTrade","NoGroup",15,1,11,3,0,6,8,1,5,10,3,12,8,7,1
"193",1394,1395,1395,"black","age.gp3","NoTr","NoTrade","NoGroup",8,1,2,2,3,5,3,0,2,6,1,7,6,2,1
"194",1710,1711,1711,"white","age.gp2","Tr","NoTrade","Group",23,1,12,7,3,2,18,3,9,14,0,23,16,7,1
"195",1852,1853,1853,"black","age.gp3","NoTr","NoTrade","NoGroup",4,0,2,1,1,2,1,1,1,3,1,3,2,2,1
"196",2091,2092,2092,"black","age.gp3","NoTr","NoTrade","NoGroup",12,2,6,3,1,5,5,2,7,5,2,10,9,3,1
"197",2105,2106,2106,"white","age.gp2","Tr","NoTrade","Group",18,3,7,4,4,1,14,3,9,9,4,14,15,3,1
"198",2208,2209,2209,"black","age.gp2","NoTr","Trade","Group",19,4,6,6,3,11,7,1,5,14,2,17,11,8,1
"199",2229,2230,2230,"black","age.gp4","NoTr","Trade","Group",10,0,1,2,7,8,2,0,1,9,0,10,3,7,1
"200",2600,2601,2601,"white","age.gp3","NoTr","NoTrade","Group",10,2,6,1,1,1,7,2,6,4,0,10,8,2,1
"201",2705,2706,2706,"white","age.gp4","NoTr","NoTrade","Group",13,0,6,3,4,2,9,2,6,7,2,11,9,4,1
"202",19,20,20,"black","age.gp4","NoTr","Trade","NoGroup",1,0,0,0,1,1,0,0,0,1,0,1,1,0,1
"203",20,21,21,"black","age.gp4","NoTr","Trade","NoGroup",1,0,1,0,0,0,1,0,0,1,0,1,1,0,1
"204",1096,1097,1097,"white","age.gp2","NoTr","NoTrade","Group",27,3,13,4,7,3,21,3,16,11,1,26,13,14,1
"205",21,22,22,"black","age.gp4","NoTr","Trade","NoGroup",4,1,0,1,2,2,2,0,2,2,1,3,3,1,1
"206",682,683,683,"white","age.gp4","Tr","NoTrade","Group",14,1,3,4,6,3,9,2,1,13,1,13,5,9,1
"207",829,830,830,"white","age.gp3","NoTr","NoTrade","NoGroup",10,0,3,2,5,2,8,0,4,6,1,9,3,7,1
"208",1368,1369,1369,"black","age.gp4","NoTr","NoTrade","Group",10,0,3,0,7,6,4,0,2,8,2,8,4,6,1
"209",1665,1666,1666,"black","age.gp1","Tr","Trade","Group",17,7,4,4,2,8,6,3,3,14,2,15,3,14,1
"210",22,23,23,"black","age.gp4","NoTr","Trade","NoGroup",1,0,0,0,1,1,0,0,0,1,0,1,0,1,1
"211",486,487,487,"black","age.gp4","NoTr","NoTrade","NoGroup",3,0,0,1,2,3,0,0,0,3,1,2,0,3,1
"212",23,24,24,"black","age.gp4","NoTr","Trade","NoGroup",1,0,1,0,0,0,1,0,1,0,0,1,1,0,1
"213",229,230,230,"white","age.gp2","Tr","NoTrade","Group",25,2,11,5,7,1,19,5,8,17,3,22,18,7,1
"214",24,25,25,"black","age.gp4","NoTr","Trade","NoGroup",3,0,1,0,2,0,3,0,3,0,0,3,3,0,1
"215",1425,1426,1426,"white","age.gp2","Tr","NoTrade","Group",26,3,11,5,7,3,20,3,12,14,3,23,18,8,1
"216",1800,1801,1801,"white","age.gp4","Tr","NoTrade","Group",15,0,4,2,9,3,12,0,5,10,1,14,7,8,1
"217",2057,2058,2058,"white","age.gp4","Tr","NoTrade","Group",14,0,2,3,9,3,11,0,2,12,1,13,9,5,1
"218",26,27,27,"black","age.gp4","NoTr","Trade","NoGroup",4,0,0,1,3,3,1,0,0,4,1,3,1,3,1
"219",162,163,163,"white","age.gp3","NoTr","NoTrade","NoGroup",7,2,2,0,3,1,5,1,4,3,1,6,2,5,1
"220",349,350,350,"black","age.gp4","NoTr","NoTrade","NoGroup",8,0,2,1,5,6,0,2,2,6,2,6,5,3,1
"221",1833,1834,1834,"black","age.gp4","NoTr","NoTrade","NoGroup",7,0,1,2,4,3,3,1,1,6,1,6,1,6,1
"222",2238,2239,2239,"black","age.gp4","NoTr","Trade","Group",10,0,1,2,7,5,5,0,3,7,1,9,4,6,1
"223",27,28,28,"black","age.gp4","NoTr","Trade","NoGroup",5,0,1,2,2,2,2,1,2,3,0,5,4,1,1
"224",1057,1058,1058,"white","age.gp4","NoTr","NoTrade","Group",13,1,5,1,6,2,9,2,4,9,1,12,7,6,1
"225",1729,1730,1730,"white","age.gp3","Tr","NoTrade","Group",21,5,3,7,6,3,13,5,2,19,2,19,10,11,1
"226",1754,1755,1755,"black","age.gp4","NoTr","NoTrade","NoGroup",5,0,0,4,1,2,3,0,1,4,2,3,2,3,1
"227",2280,2281,2281,"other","age.gp2","Tr","NoTrade","Group",8,2,4,0,2,3,5,0,2,6,1,7,5,3,1
"228",2853,2854,2854,"black","age.gp3","NoTr","NoTrade","Group",16,3,5,4,4,11,3,2,4,12,3,13,7,9,1
"229",28,29,29,"black","age.gp4","NoTr","Trade","NoGroup",1,0,0,0,1,0,1,0,0,1,0,1,1,0,1
"230",2581,2582,2582,"white","age.gp4","NoTr","NoTrade","Group",17,0,4,4,9,2,14,1,9,8,2,15,12,5,1
"231",29,30,30,"black","age.gp4","NoTr","Trade","NoGroup",3,1,0,0,2,2,1,0,1,2,2,1,2,1,1
"232",1594,1595,1595,"black","age.gp1","Tr","Trade","NoGroup",10,7,1,0,2,6,3,1,3,7,2,8,3,7,1
"233",2211,2212,2212,"black","age.gp4","NoTr","Trade","Group",5,1,1,0,3,3,1,1,0,5,2,3,3,2,1
"234",2935,2936,2936,"white","age.gp4","NoTr","NoTrade","Group",17,1,5,3,8,4,11,2,8,9,1,16,9,8,1
"235",30,31,31,"black","age.gp4","NoTr","Trade","NoGroup",2,0,0,1,1,1,1,0,0,2,0,2,1,1,1
"236",447,448,448,"black","age.gp3","NoTr","NoTrade","NoGroup",14,2,3,1,8,7,5,2,4,10,2,12,9,5,1
"237",2926,2927,2927,"white","age.gp4","NoTr","NoTrade","Group",6,0,3,1,2,1,5,0,2,4,2,4,4,2,1
"238",32,33,33,"black","age.gp4","NoTr","Trade","NoGroup",3,0,2,0,1,1,2,0,1,2,0,3,3,0,1
"239",2053,2054,2054,"white","age.gp4","Tr","NoTrade","Group",21,3,4,4,10,2,16,3,2,19,3,18,13,8,1
"240",2742,2743,2743,"white","age.gp2","NoTr","NoTrade","Group",19,0,9,4,6,2,17,0,10,9,2,17,13,6,1
"241",33,34,34,"black","age.gp4","NoTr","Trade","NoGroup",3,0,1,0,2,2,0,1,1,2,0,3,1,2,1
"242",851,852,852,"other","age.gp2","Tr","NoTrade","Group",10,0,3,4,3,1,9,0,4,6,1,9,8,2,1
"243",1043,1044,1044,"black","age.gp4","NoTr","NoTrade","NoGroup",1,0,0,0,1,1,0,0,0,1,1,0,0,1,1
"244",34,35,35,"black","age.gp4","NoTr","Trade","NoGroup",2,0,1,0,1,0,2,0,0,2,0,2,2,0,1
"245",837,838,838,"white","age.gp2","NoTr","NoTrade","Group",25,0,11,7,7,3,21,1,11,14,3,22,17,8,1
"246",1290,1291,1291,"white","age.gp4","NoTr","NoTrade","Group",9,0,3,1,5,1,7,1,6,3,1,8,6,3,1
"247",35,36,36,"black","age.gp4","NoTr","Trade","NoGroup",6,0,2,1,3,4,2,0,2,4,1,5,2,4,1
"248",47,48,48,"black","age.gp4","NoTr","Trade","NoGroup",4,0,1,1,2,2,2,0,1,3,1,3,2,2,1
"249",282,283,283,"white","age.gp2","Tr","NoTrade","Group",20,1,10,5,4,2,17,1,8,12,2,18,13,7,1
"250",389,390,390,"black","age.gp4","NoTr","NoTrade","NoGroup",3,0,1,0,2,2,1,0,0,3,1,2,1,2,1
"251",738,739,739,"black","age.gp4","NoTr","NoTrade","NoGroup",5,0,0,0,5,5,0,0,0,5,1,4,0,5,1
"252",966,967,967,"white","age.gp2","Tr","NoTrade","Group",22,2,9,3,8,3,18,1,9,13,1,21,16,6,1
"253",36,37,37,"black","age.gp4","NoTr","Trade","NoGroup",1,0,0,1,0,0,1,0,1,0,0,1,1,0,1
"254",2330,2331,2331,"white","age.gp3","Tr","NoTrade","Group",24,4,6,9,5,2,19,3,8,16,3,21,14,10,1
"255",37,38,38,"black","age.gp4","NoTr","Trade","NoGroup",2,1,1,0,0,2,0,0,0,2,0,2,1,1,1
"256",1905,1906,1906,"black","age.gp1","NoTr","NoTrade","NoGroup",10,4,2,1,3,8,2,0,3,7,2,8,4,6,1
"257",2349,2350,2350,"black","age.gp2","NoTr","NoTrade","Group",14,0,6,4,4,4,9,1,4,10,1,13,8,6,1
"258",38,39,39,"black","age.gp4","NoTr","Trade","NoGroup",1,0,0,0,1,1,0,0,0,1,0,1,0,1,1
"259",483,484,484,"black","age.gp4","NoTr","NoTrade","NoGroup",5,0,3,0,2,2,1,2,1,4,2,3,1,4,1
"260",39,40,40,"black","age.gp4","NoTr","Trade","NoGroup",3,0,0,0,3,2,1,0,0,3,0,3,2,1,1
"261",1348,1349,1349,"black","age.gp4","NoTr","NoTrade","Group",14,0,4,2,8,9,4,1,1,13,1,13,5,9,1
"262",1838,1839,1839,"black","age.gp4","NoTr","NoTrade","NoGroup",1,0,0,0,1,1,0,0,0,1,1,0,0,1,1
"263",1938,1939,1939,"white","age.gp4","NoTr","NoTrade","Group",9,1,1,1,6,2,6,1,3,6,1,8,6,3,1
"264",40,41,41,"black","age.gp4","NoTr","Trade","NoGroup",2,0,0,1,1,1,1,0,0,2,1,1,2,0,1
"265",471,472,472,"black","age.gp3","NoTr","Trade","Group",16,1,8,5,2,5,8,3,7,9,2,14,6,10,1
"266",2932,2933,2933,"white","age.gp4","NoTr","NoTrade","Group",5,0,0,0,5,1,4,0,2,3,1,4,4,1,1
"267",41,42,42,"black","age.gp4","NoTr","Trade","NoGroup",1,0,0,0,1,0,1,0,1,0,0,1,1,0,1
"268",2242,2243,2243,"white","age.gp4","Tr","NoTrade","Group",17,1,1,5,10,3,13,1,1,16,1,16,9,8,1
"269",42,43,43,"black","age.gp4","NoTr","Trade","NoGroup",4,0,0,0,4,2,2,0,0,4,0,4,3,1,1
"270",1048,1049,1049,"black","age.gp4","NoTr","NoTrade","NoGroup",6,0,0,2,4,2,4,0,2,4,1,5,2,4,1
"271",1354,1355,1355,"black","age.gp4","NoTr","NoTrade","Group",12,2,2,2,6,5,7,0,4,8,2,10,9,3,1
"272",1952,1953,1953,"white","age.gp4","NoTr","NoTrade","Group",12,1,4,1,6,2,9,1,3,9,2,10,9,3,1
"273",43,44,44,"black","age.gp4","NoTr","Trade","NoGroup",6,0,2,3,1,2,4,0,3,3,0,6,4,2,1
"274",1616,1617,1617,"white","age.gp3","Tr","NoTrade","NoGroup",12,0,5,3,4,2,9,1,4,8,1,11,8,4,1
"275",1741,1742,1742,"white","age.gp3","Tr","NoTrade","Group",13,1,5,2,5,1,9,3,4,9,1,12,10,3,1
"276",1960,1961,1961,"white","age.gp4","NoTr","NoTrade","Group",10,0,4,0,6,3,7,0,3,7,1,9,5,5,1
"277",2094,2095,2095,"black","age.gp3","NoTr","NoTrade","NoGroup",8,1,3,3,1,2,6,0,2,6,3,5,4,4,1
"278",44,45,45,"black","age.gp4","NoTr","Trade","NoGroup",3,0,1,0,2,1,2,0,1,2,0,3,2,1,1
"279",1250,1251,1251,"white","age.gp2","Tr","NoTrade","Group",27,5,12,7,3,2,19,6,7,20,1,26,15,12,1
"280",2003,2004,2004,"black","age.gp4","NoTr","NoTrade","NoGroup",6,0,2,0,4,1,5,0,2,4,1,5,1,5,1
"281",2933,2934,2934,"white","age.gp4","NoTr","NoTrade","Group",17,1,3,6,7,4,12,1,4,13,2,15,11,6,1
"282",45,46,46,"black","age.gp4","NoTr","Trade","NoGroup",6,0,4,0,2,4,1,1,1,5,1,5,2,4,1
"283",238,239,239,"white","age.gp2","Tr","NoTrade","Group",23,2,12,3,6,1,21,1,12,11,2,21,10,13,1
"284",363,364,364,"black","age.gp4","NoTr","NoTrade","NoGroup",3,0,0,1,2,2,1,0,1,2,1,2,1,2,1
"285",1664,1665,1665,"other","age.gp2","NoTr","NoTrade","NoGroup",7,0,3,1,3,2,5,0,2,5,1,6,2,5,1
"286",2207,2208,2208,"black","age.gp2","NoTr","Trade","Group",21,1,8,6,6,12,8,1,6,15,3,18,11,10,1
"287",46,47,47,"black","age.gp4","NoTr","Trade","NoGroup",1,0,0,0,1,0,1,0,0,1,0,1,1,0,1
"288",2944,2945,2945,"white","age.gp4","NoTr","NoTrade","Group",7,0,2,1,4,2,5,0,0,7,1,6,4,3,1
"289",247,248,248,"white","age.gp2","Tr","NoTrade","Group",21,4,8,7,2,3,15,3,8,13,2,19,15,6,1
"290",1837,1838,1838,"black","age.gp4","NoTr","NoTrade","NoGroup",4,0,0,0,4,2,2,0,1,3,1,3,2,2,1
"291",1856,1857,1857,"white","age.gp3","NoTr","NoTrade","Group",21,3,9,5,4,3,15,3,6,15,2,19,12,9,1
"292",48,49,49,"black","age.gp4","NoTr","Trade","NoGroup",1,1,0,0,0,1,0,0,0,1,0,1,0,1,1
"293",49,50,50,"white","age.gp2","Tr","NoTrade","Group",27,5,7,10,5,2,22,3,13,14,5,22,22,5,1
"294",141,142,142,"white","age.gp3","NoTr","NoTrade","Group",13,1,2,7,3,1,11,1,4,9,1,12,10,3,1
"295",142,143,143,"white","age.gp3","NoTr","NoTrade","Group",21,2,10,6,3,0,20,1,7,14,1,20,15,6,1
"296",341,342,342,"white","age.gp1","NoTr","Trade","Group",24,12,5,5,2,3,18,3,9,15,3,21,13,11,1
"297",635,636,636,"other","age.gp1","NoTr","Trade","Group",11,2,7,2,0,1,10,0,4,7,3,8,9,2,1
"298",710,711,711,"white","age.gp2","Tr","NoTrade","Group",12,0,7,3,2,1,9,2,6,6,1,11,8,4,1
"299",842,843,843,"white","age.gp2","Tr","NoTrade","NoGroup",10,1,2,3,4,1,9,0,4,6,1,9,8,2,1
"300",857,858,858,"other","age.gp2","Tr","NoTrade","Group",14,0,9,4,1,5,9,0,7,7,0,14,7,7,1
"301",873,874,874,"white","age.gp3","NoTr","Trade","Group",18,2,6,4,6,1,15,2,6,12,0,18,10,8,1
"302",897,898,898,"other","age.gp1","Tr","NoTrade","NoGroup",5,1,2,1,1,0,5,0,1,4,1,4,5,0,1
"303",953,954,954,"white","age.gp3","Tr","NoTrade","Group",22,2,6,6,8,3,19,0,7,15,0,22,11,11,1
"304",1325,1326,1326,"white","age.gp3","NoTr","NoTrade","NoGroup",5,0,4,0,1,0,3,2,3,2,0,5,4,1,1
"305",1419,1420,1420,"white","age.gp2","NoTr","NoTrade","Group",14,1,10,0,3,1,12,1,6,8,1,13,9,5,1
"306",1572,1573,1573,"white","age.gp4","Tr","NoTrade","Group",17,1,4,3,9,1,15,1,6,11,2,15,15,2,1
"307",1847,1848,1848,"black","age.gp3","NoTr","NoTrade","NoGroup",16,1,8,1,6,8,5,3,5,11,0,16,4,12,1
"308",2043,2044,2044,"white","age.gp4","Tr","NoTrade","Group",14,1,3,5,5,2,12,0,3,11,1,13,9,5,1
"309",2073,2074,2074,"white","age.gp3","Tr","NoTrade","Group",18,2,5,6,5,2,14,2,6,12,1,17,11,7,1
"310",2210,2211,2211,"black","age.gp2","NoTr","Trade","Group",21,2,7,7,5,14,6,1,6,15,4,17,11,10,1
"311",2243,2244,2244,"white","age.gp4","Tr","NoTrade","Group",15,0,3,2,10,2,12,1,8,7,1,14,10,5,1
"312",2257,2258,2258,"white","age.gp4","Tr","NoTrade","Group",14,0,4,2,8,3,11,0,3,11,0,14,8,6,1
"313",2385,2386,2386,"white","age.gp2","Tr","NoTrade","Group",23,3,10,6,4,0,19,4,8,15,3,20,13,10,1
"314",2415,2416,2416,"white","age.gp3","NoTr","Trade","Group",14,0,6,5,3,1,12,1,8,6,1,13,9,5,1
"315",2740,2741,2741,"white","age.gp2","Tr","NoTrade","Group",17,1,8,5,3,3,12,2,7,10,0,17,13,4,1
"316",2756,2757,2757,"white","age.gp3","NoTr","NoTrade","NoGroup",5,0,1,2,2,2,3,0,1,4,0,5,3,2,1
"317",2871,2872,2872,"white","age.gp1","NoTr","NoTrade","Group",27,7,7,7,6,1,23,3,10,17,3,24,14,13,1
"318",2973,2974,2974,"white","age.gp1","NoTr","NoTrade","Group",19,8,4,6,1,1,17,1,4,15,2,17,7,12,1
"319",50,51,51,"white","age.gp2","Tr","NoTrade","Group",16,1,7,5,3,3,11,2,3,13,2,14,10,6,1
"320",734,735,735,"black","age.gp4","NoTr","NoTrade","NoGroup",1,0,1,0,0,0,1,0,1,0,0,1,1,0,1
"321",822,823,823,"white","age.gp3","NoTr","NoTrade","NoGroup",12,2,5,4,1,1,9,2,4,8,0,12,8,4,1
"322",839,840,840,"white","age.gp2","NoTr","NoTrade","Group",27,2,14,6,5,3,22,2,16,11,2,25,22,5,1
"323",1018,1019,1019,"white","age.gp2","NoTr","Trade","Group",18,1,10,5,2,1,16,1,8,10,1,17,10,8,1
"324",1549,1550,1550,"white","age.gp3","NoTr","NoTrade","Group",17,4,6,3,4,4,12,1,5,12,0,17,12,5,1
"325",1663,1664,1664,"other","age.gp2","NoTr","NoTrade","NoGroup",9,1,4,3,1,0,8,1,6,3,0,9,6,3,1
"326",1749,1750,1750,"black","age.gp4","NoTr","NoTrade","NoGroup",1,0,1,0,0,0,1,0,1,0,0,1,1,0,1
"327",2045,2046,2046,"white","age.gp4","Tr","NoTrade","Group",11,1,3,1,6,2,9,0,4,7,0,11,5,6,1
"328",2130,2131,2131,"white","age.gp3","NoTr","NoTrade","Group",21,3,8,5,5,3,14,4,7,14,1,20,14,7,1
"329",2475,2476,2476,"white","age.gp2","Tr","NoTrade","Group",20,1,10,6,3,1,17,2,8,12,0,20,15,5,1
"330",2477,2478,2478,"other","age.gp1","NoTr","NoTrade","NoGroup",3,1,2,0,0,0,3,0,2,1,0,3,1,2,1
"331",2744,2745,2745,"white","age.gp2","NoTr","NoTrade","Group",22,0,13,8,1,2,18,2,10,12,2,20,16,6,1
"332",2838,2839,2839,"black","age.gp2","NoTr","NoTrade","NoGroup",1,0,1,0,0,0,1,0,1,0,0,1,1,0,1
"333",2959,2960,2960,"white","age.gp2","NoTr","NoTrade","Group",29,1,15,8,5,3,21,5,12,17,2,27,18,11,1
"334",51,52,52,"white","age.gp2","Tr","NoTrade","Group",25,4,8,5,8,0,22,3,8,17,1,24,19,6,1
"335",790,791,791,"white","age.gp4","NoTr","NoTrade","NoGroup",6,0,2,1,3,0,5,1,2,4,0,6,4,2,1
"336",1008,1009,1009,"white","age.gp1","Tr","NoTrade","NoGroup",12,4,1,5,2,0,11,1,5,7,2,10,10,2,1
"337",1097,1098,1098,"white","age.gp2","NoTr","NoTrade","Group",21,0,14,2,5,0,21,0,7,14,2,19,18,3,1
"338",1258,1259,1259,"white","age.gp1","Tr","Trade","Group",21,10,4,4,3,5,13,3,3,18,1,20,9,12,1
"339",1407,1408,1408,"white","age.gp3","NoTr","NoTrade","Group",22,0,9,6,7,1,16,5,8,14,2,20,16,6,1
"340",1547,1548,1548,"white","age.gp3","NoTr","NoTrade","Group",19,1,8,2,8,4,11,4,11,8,1,18,12,7,1
"341",1565,1566,1566,"white","age.gp4","Tr","NoTrade","Group",10,0,3,3,4,2,8,0,2,8,0,10,6,4,1
"342",1583,1584,1584,"white","age.gp4","Tr","NoTrade","Group",19,1,3,4,11,0,17,2,6,13,2,17,13,6,1
"343",1620,1621,1621,"white","age.gp2","Tr","NoTrade","Group",20,3,7,8,2,1,18,1,6,14,2,18,12,8,1
"344",1720,1721,1721,"white","age.gp2","NoTr","NoTrade","Group",23,4,16,1,2,1,15,7,9,14,0,23,17,6,1
"345",1888,1889,1889,"other","age.gp1","NoTr","NoTrade","Group",10,5,3,0,2,0,10,0,6,4,0,10,5,5,1
"346",2192,2193,2193,"white","age.gp4","NoTr","NoTrade","NoGroup",8,1,1,4,2,1,7,0,2,6,1,7,4,4,1
"347",2290,2291,2291,"other","age.gp2","Tr","NoTrade","Group",7,1,5,1,0,1,6,0,3,4,0,7,5,2,1
"348",2322,2323,2323,"white","age.gp1","NoTr","NoTrade","NoGroup",7,2,1,2,2,1,6,0,3,4,0,7,2,5,1
"349",2520,2521,2521,"white","age.gp2","Tr","NoTrade","Group",35,6,16,9,4,0,31,4,13,22,3,32,27,8,1
"350",2598,2599,2599,"white","age.gp3","NoTr","NoTrade","Group",18,3,6,4,5,0,18,0,9,9,1,17,14,4,1
"351",2601,2602,2602,"white","age.gp3","NoTr","NoTrade","Group",22,4,7,6,5,0,21,1,12,10,2,20,17,5,1
"352",2624,2625,2625,"white","age.gp4","NoTr","NoTrade","NoGroup",3,0,3,0,0,0,2,1,1,2,0,3,2,1,1
"353",2706,2707,2707,"white","age.gp4","NoTr","NoTrade","Group",11,1,3,2,5,2,9,0,5,6,0,11,6,5,1
"354",2782,2783,2783,"white","age.gp3","NoTr","NoTrade","Group",13,2,7,0,4,2,10,1,6,7,1,12,6,7,1
"355",2816,2817,2817,"other","age.gp2","NoTr","NoTrade","NoGroup",5,0,4,0,1,0,5,0,4,1,0,5,3,2,1
"356",2923,2924,2924,"white","age.gp4","NoTr","NoTrade","Group",12,1,3,3,5,0,12,0,2,10,0,12,8,4,1
"357",2946,2947,2947,"white","age.gp4","NoTr","NoTrade","Group",14,0,1,4,9,4,10,0,4,10,0,14,10,4,1
"358",2960,2961,2961,"white","age.gp2","NoTr","NoTrade","Group",18,2,8,5,3,0,16,2,8,10,0,18,13,5,1
"359",52,53,53,"white","age.gp2","Tr","NoTrade","Group",24,3,6,9,6,3,19,2,8,16,0,24,15,9,1
"360",73,74,74,"white","age.gp4","NoTr","NoTrade","Group",11,0,4,3,4,1,10,0,8,3,0,11,9,2,1
"361",95,96,96,"white","age.gp3","NoTr","NoTrade","Group",14,1,8,3,2,2,10,2,7,7,1,13,13,1,1
"362",186,187,187,"white","age.gp3","Tr","NoTrade","NoGroup",5,0,4,1,0,0,4,1,3,2,0,5,2,3,1
"363",344,345,345,"white","age.gp2","NoTr","NoTrade","Group",19,1,11,4,3,2,15,2,6,13,1,18,10,9,1
"364",489,490,490,"black","age.gp4","NoTr","NoTrade","NoGroup",1,0,1,0,0,0,1,0,1,0,0,1,1,0,1
"365",522,523,523,"black","age.gp3","NoTr","NoTrade","NoGroup",10,0,5,2,3,3,6,1,4,6,0,10,6,4,1
"366",951,952,952,"white","age.gp3","Tr","NoTrade","Group",12,3,4,1,4,1,10,1,5,7,0,12,9,3,1
"367",952,953,953,"white","age.gp3","Tr","NoTrade","Group",26,3,14,7,2,2,22,2,12,14,3,23,19,7,1
"368",1381,1382,1382,"white","age.gp1","NoTr","NoTrade","NoGroup",12,4,3,4,1,0,9,3,4,8,1,11,6,6,1
"369",1556,1557,1557,"white","age.gp3","NoTr","NoTrade","Group",16,1,6,5,4,5,8,3,6,10,1,15,11,5,1
"370",1711,1712,1712,"white","age.gp2","Tr","NoTrade","Group",27,4,9,8,6,0,25,2,12,15,0,27,19,8,1
"371",1779,1780,1780,"white","age.gp4","Tr","NoTrade","Group",12,1,3,2,6,3,8,1,4,8,1,11,8,4,1
"372",1868,1869,1869,"other","age.gp1","NoTr","NoTrade","Group",5,2,2,1,0,1,4,0,2,3,0,5,2,3,1
"373",1875,1876,1876,"other","age.gp1","NoTr","NoTrade","Group",8,2,2,2,2,2,5,1,5,3,0,8,5,3,1
"374",1968,1969,1969,"white","age.gp4","Tr","NoTrade","NoGroup",12,1,2,1,8,0,12,0,7,5,1,11,11,1,1
"375",2109,2110,2110,"white","age.gp2","NoTr","NoTrade","NoGroup",11,1,6,4,0,0,11,0,7,4,1,10,7,4,1
"376",2314,2315,2315,"white","age.gp2","Tr","NoTrade","NoGroup",12,1,4,3,4,0,10,2,5,7,0,12,11,1,1
"377",2341,2342,2342,"white","age.gp2","Tr","NoTrade","Group",26,2,10,5,9,4,18,4,6,20,1,25,13,13,1
"378",2406,2407,2407,"white","age.gp3","NoTr","NoTrade","NoGroup",8,0,2,5,1,1,7,0,4,4,0,8,6,2,1
"379",2607,2608,2608,"black","age.gp2","NoTr","NoTrade","Group",13,2,5,4,2,8,3,2,2,11,1,12,7,6,1
"380",2669,2670,2670,"white","age.gp3","NoTr","NoTrade","NoGroup",1,0,1,0,0,0,1,0,1,0,0,1,1,0,1
"381",2719,2720,2720,"white","age.gp4","NoTr","NoTrade","Group",11,0,2,1,8,0,10,1,6,5,0,11,8,3,1
"382",2773,2774,2774,"white","age.gp3","NoTr","NoTrade","Group",15,3,5,2,5,4,11,0,7,8,1,14,9,6,1
"383",184,185,185,"white","age.gp3","Tr","NoTrade","NoGroup",14,2,5,3,4,1,12,1,6,8,0,14,5,9,1
"384",856,857,857,"other","age.gp2","Tr","NoTrade","Group",8,0,6,1,1,1,7,0,4,4,1,7,6,2,1
"385",950,951,951,"white","age.gp3","Tr","NoTrade","Group",19,3,5,6,5,2,16,1,9,10,1,18,14,5,1
"386",956,957,957,"black","age.gp2","Tr","NoTrade","NoGroup",12,0,7,1,4,6,5,1,3,9,1,11,5,7,1
"387",1021,1022,1022,"white","age.gp2","NoTr","Trade","Group",18,3,9,4,2,3,11,4,6,12,1,17,10,8,1
"388",1242,1243,1243,"white","age.gp2","Tr","NoTrade","NoGroup",11,0,7,1,3,0,11,0,4,7,1,10,10,1,1
"389",1429,1430,1430,"white","age.gp3","Tr","NoTrade","NoGroup",10,2,2,3,3,0,8,2,4,6,1,9,6,4,1
"390",1455,1456,1456,"white","age.gp1","NoTr","NoTrade","NoGroup",9,2,4,1,2,0,8,1,3,6,0,9,6,3,1
"391",1560,1561,1561,"white","age.gp3","NoTr","NoTrade","Group",13,1,6,5,1,1,11,1,3,10,2,11,7,6,1
"392",1598,1599,1599,"white","age.gp2","Tr","NoTrade","NoGroup",11,0,4,5,2,1,9,1,7,4,1,10,10,1,1
"393",1626,1627,1627,"white","age.gp1","NoTr","NoTrade","NoGroup",16,8,2,6,0,3,10,3,7,9,2,14,10,6,1
"394",2064,2065,2065,"white","age.gp3","Tr","NoTrade","Group",12,0,4,1,7,1,10,1,3,9,0,12,5,7,1
"395",2102,2103,2103,"white","age.gp2","Tr","NoTrade","Group",18,0,11,5,2,2,13,3,8,10,2,16,14,4,1
"396",2152,2153,2153,"other","age.gp2","NoTr","NoTrade","NoGroup",6,1,1,4,0,1,5,0,4,2,1,5,5,1,1
"397",2279,2280,2280,"other","age.gp2","Tr","NoTrade","Group",6,1,5,0,0,0,6,0,3,3,0,6,5,1,1
"398",2283,2284,2284,"other","age.gp2","Tr","NoTrade","Group",10,1,4,3,2,0,10,0,4,6,1,9,8,2,1
"399",2301,2302,2302,"other","age.gp2","Tr","NoTrade","Group",9,0,5,4,0,0,9,0,7,2,1,8,7,2,1
"400",2318,2319,2319,"white","age.gp2","NoTr","NoTrade","NoGroup",7,1,3,2,1,1,5,1,4,3,0,7,4,3,1
"401",2329,2330,2330,"white","age.gp3","Tr","NoTrade","Group",19,3,3,7,6,1,18,0,9,10,1,18,13,6,1
"402",2348,2349,2349,"black","age.gp2","NoTr","NoTrade","Group",22,0,10,7,5,9,11,2,11,11,1,21,13,9,1
"403",2629,2630,2630,"white","age.gp4","NoTr","NoTrade","NoGroup",2,0,1,0,1,0,2,0,1,1,0,2,2,0,1
"404",2642,2643,2643,"white","age.gp1","NoTr","NoTrade","NoGroup",10,8,1,1,0,1,6,3,3,7,0,10,3,7,1
"405",2975,2976,2976,"white","age.gp1","NoTr","NoTrade","Group",28,14,4,6,4,2,20,6,6,22,6,22,16,12,1
"406",779,780,780,"white","age.gp2","NoTr","NoTrade","NoGroup",8,0,5,2,1,2,4,2,3,5,0,8,5,3,1
"407",1303,1304,1304,"white","age.gp4","NoTr","NoTrade","Group",17,0,9,2,6,2,11,4,8,9,1,16,11,6,1
"408",1411,1412,1412,"white","age.gp3","NoTr","NoTrade","Group",22,1,6,7,8,1,21,0,7,15,1,21,14,8,1
"409",1633,1634,1634,"black","age.gp1","Tr","NoTrade","NoGroup",10,3,2,4,1,6,4,0,4,6,1,9,4,6,1
"410",1835,1836,1836,"black","age.gp4","NoTr","NoTrade","NoGroup",6,1,2,1,2,3,2,1,1,5,1,5,4,2,1
"411",2166,2167,2167,"black","age.gp2","NoTr","NoTrade","NoGroup",11,1,6,1,3,5,5,1,4,7,1,10,7,4,1
"412",127,128,128,"white","age.gp1","NoTr","NoTrade","NoGroup",15,6,6,2,1,2,11,2,5,10,1,14,7,8,1
"413",365,366,366,"black","age.gp4","NoTr","NoTrade","NoGroup",4,0,1,1,2,4,0,0,0,4,1,3,1,3,1
"414",468,469,469,"black","age.gp3","NoTr","Trade","Group",14,1,7,3,3,12,2,0,2,12,4,10,6,8,1
"415",2735,2736,2736,"black","age.gp3","NoTr","NoTrade","NoGroup",4,0,1,3,0,2,2,0,1,3,1,3,2,2,1
"416",2956,2957,2957,"white","age.gp2","Tr","NoTrade","Group",18,1,10,4,3,4,13,1,8,10,1,17,11,7,1
"417",56,57,57,"black","age.gp2","NoTr","NoTrade","NoGroup",10,2,7,1,0,6,4,0,2,8,0,10,4,6,1
"418",137,138,138,"white","age.gp2","NoTr","NoTrade","NoGroup",13,1,4,2,6,1,12,0,5,8,1,12,10,3,1
"419",292,293,293,"black","age.gp2","NoTr","NoTrade","Group",13,0,6,4,3,4,6,3,4,9,1,12,8,5,1
"420",949,950,950,"white","age.gp3","Tr","NoTrade","Group",23,4,6,10,3,4,17,2,6,17,2,21,12,11,1
"421",1379,1380,1380,"black","age.gp2","NoTr","NoTrade","NoGroup",7,0,3,4,0,4,2,1,2,5,0,7,2,5,1
"422",1476,1477,1477,"black","age.gp1","NoTr","NoTrade","NoGroup",7,5,1,0,1,3,3,1,1,6,3,4,4,3,1
"423",2106,2107,2107,"white","age.gp2","Tr","NoTrade","Group",27,1,13,8,5,4,22,1,13,14,0,27,20,7,1
"424",2468,2469,2469,"white","age.gp1","NoTr","NoTrade","NoGroup",17,9,5,0,3,1,14,2,8,9,0,17,9,8,1
"425",2509,2510,2510,"black","age.gp2","NoTr","NoTrade","NoGroup",9,0,5,4,0,6,3,0,0,9,0,9,4,5,1
"426",2608,2609,2609,"black","age.gp2","NoTr","NoTrade","Group",26,4,13,5,4,12,10,4,8,18,3,23,17,9,1
"427",2671,2672,2672,"white","age.gp3","NoTr","NoTrade","NoGroup",10,0,6,1,3,1,9,0,4,6,0,10,6,4,1
"428",58,59,59,"black","age.gp2","NoTr","NoTrade","NoGroup",3,1,2,0,0,2,1,0,2,1,1,2,2,1,1
"429",788,789,789,"black","age.gp1","Tr","NoTrade","NoGroup",12,5,1,4,2,6,4,2,1,11,1,11,3,9,1
"430",59,60,60,"white","age.gp4","NoTr","NoTrade","Group",7,0,0,1,6,1,6,0,3,4,0,7,4,3,1
"431",76,77,77,"white","age.gp4","NoTr","NoTrade","Group",9,1,1,1,6,2,7,0,4,5,1,8,7,2,1
"432",930,931,931,"white","age.gp3","NoTr","NoTrade","NoGroup",8,1,2,2,3,0,7,1,4,4,0,8,5,3,1
"433",1071,1072,1072,"white","age.gp4","NoTr","NoTrade","Group",12,1,1,0,10,0,11,1,3,9,0,12,9,3,1
"434",1772,1773,1773,"white","age.gp4","Tr","NoTrade","Group",17,1,2,3,11,0,16,1,5,12,0,17,12,5,1
"435",1969,1970,1970,"white","age.gp4","Tr","NoTrade","NoGroup",8,1,2,0,5,1,6,1,1,7,0,8,5,3,1
"436",2028,2029,2029,"white","age.gp4","Tr","NoTrade","Group",12,0,1,1,10,1,11,0,3,9,0,12,7,5,1
"437",60,61,61,"white","age.gp4","NoTr","NoTrade","Group",9,1,3,1,4,2,7,0,2,7,0,9,8,1,1
"438",70,71,71,"white","age.gp4","NoTr","NoTrade","Group",11,2,3,0,6,0,11,0,7,4,2,9,9,2,1
"439",295,296,296,"white","age.gp4","NoTr","NoTrade","Group",14,1,2,5,6,0,14,0,8,6,1,13,11,3,1
"440",695,696,696,"white","age.gp4","Tr","NoTrade","Group",11,0,3,1,7,1,9,1,1,10,1,10,7,4,1
"441",1400,1401,1401,"white","age.gp3","NoTr","NoTrade","Group",16,2,8,1,5,3,12,1,8,8,2,14,11,5,1
"442",1428,1429,1429,"white","age.gp2","Tr","NoTrade","Group",21,3,11,5,2,1,15,5,8,13,2,19,14,7,1
"443",1948,1949,1949,"white","age.gp4","NoTr","NoTrade","Group",15,0,3,2,10,2,13,0,7,8,1,14,13,2,1
"444",2467,2468,2468,"white","age.gp1","NoTr","NoTrade","NoGroup",13,7,4,1,1,3,9,1,5,8,0,13,7,6,1
"445",61,62,62,"white","age.gp4","NoTr","NoTrade","Group",17,5,0,2,10,1,15,1,3,14,1,16,8,9,1
"446",174,175,175,"white","age.gp3","NoTr","NoTrade","NoGroup",4,0,2,1,1,1,3,0,1,3,0,4,2,2,1
"447",260,261,261,"white","age.gp4","NoTr","NoTrade","NoGroup",5,0,0,1,4,1,4,0,0,5,0,5,3,2,1
"448",264,265,265,"white","age.gp4","NoTr","NoTrade","NoGroup",6,1,0,2,3,0,5,1,2,4,0,6,6,0,1
"449",322,323,323,"white","age.gp4","NoTr","NoTrade","Group",8,0,1,1,6,1,7,0,1,7,0,8,6,2,1
"450",603,604,604,"other","age.gp4","NoTr","NoTrade","NoGroup",1,0,0,0,1,0,1,0,0,1,0,1,1,0,1
"451",1076,1077,1077,"white","age.gp4","NoTr","NoTrade","Group",15,2,3,1,9,1,12,2,7,8,1,14,10,5,1
"452",1460,1461,1461,"white","age.gp1","NoTr","NoTrade","NoGroup",9,5,0,1,3,0,5,4,4,5,0,9,4,5,1
"453",1510,1511,1511,"white","age.gp4","NoTr","NoTrade","NoGroup",3,0,2,0,1,0,3,0,2,1,0,3,3,0,1
"454",1575,1576,1576,"white","age.gp4","Tr","NoTrade","Group",20,1,3,5,11,2,15,3,2,18,3,17,11,9,1
"455",1726,1727,1727,"white","age.gp1","Tr","NoTrade","NoGroup",13,5,3,3,2,0,10,3,4,9,1,12,5,8,1
"456",2227,2228,2228,"black","age.gp4","NoTr","Trade","Group",10,1,1,2,6,5,5,0,4,6,2,8,7,3,1
"457",2337,2338,2338,"white","age.gp3","Tr","NoTrade","Group",24,3,5,10,6,5,17,2,5,19,3,21,12,12,1
"458",2578,2579,2579,"white","age.gp4","NoTr","NoTrade","Group",15,1,2,4,8,1,13,1,4,11,3,12,13,2,1
"459",2769,2770,2770,"white","age.gp1","NoTr","NoTrade","NoGroup",13,7,1,2,3,0,12,1,4,9,3,10,7,6,1
"460",62,63,63,"white","age.gp4","NoTr","NoTrade","Group",11,1,1,1,8,3,8,0,2,9,0,11,4,7,1
"461",406,407,407,"black","age.gp4","NoTr","NoTrade","NoGroup",3,0,1,0,2,2,1,0,0,3,1,2,2,1,1
"462",807,808,808,"white","age.gp4","NoTr","NoTrade","NoGroup",2,0,0,0,2,0,2,0,0,2,0,2,2,0,1
"463",1045,1046,1046,"black","age.gp4","NoTr","NoTrade","NoGroup",7,1,0,1,5,3,3,1,2,5,1,6,4,3,1
"464",1162,1163,1163,"white","age.gp4","NoTr","NoTrade","NoGroup",5,0,1,2,2,0,4,1,2,3,0,5,2,3,1
"465",1622,1623,1623,"white","age.gp2","Tr","NoTrade","Group",19,1,7,7,4,3,16,0,4,15,1,18,13,6,1
"466",2570,2571,2571,"white","age.gp4","NoTr","NoTrade","Group",11,0,2,3,6,1,9,1,6,5,0,11,9,2,1
"467",2632,2633,2633,"white","age.gp4","NoTr","NoTrade","NoGroup",9,0,2,3,4,0,9,0,4,5,0,9,7,2,1
"468",2726,2727,2727,"black","age.gp3","NoTr","NoTrade","NoGroup",4,0,3,0,1,1,3,0,1,3,1,3,4,0,1
"469",63,64,64,"white","age.gp4","NoTr","NoTrade","Group",11,0,5,3,3,0,10,1,5,6,1,10,10,1,1
"470",214,215,215,"other","age.gp2","Tr","NoTrade","NoGroup",3,0,1,1,1,0,3,0,1,2,0,3,3,0,1
"471",241,242,242,"white","age.gp2","Tr","NoTrade","Group",29,4,10,8,7,5,22,2,6,23,3,26,21,8,1
"472",954,955,955,"white","age.gp3","Tr","NoTrade","Group",15,2,5,6,2,1,14,0,8,7,1,14,12,3,1
"473",1801,1802,1802,"white","age.gp4","Tr","NoTrade","Group",9,0,3,2,4,1,8,0,6,3,0,9,6,3,1
"474",2123,2124,2124,"white","age.gp3","NoTr","NoTrade","Group",22,2,6,7,7,3,17,2,4,18,1,21,15,7,1
"475",2170,2171,2171,"white","age.gp2","NoTr","NoTrade","Group",27,3,11,6,7,3,24,0,10,17,1,26,15,12,1
"476",2416,2417,2417,"white","age.gp3","NoTr","Trade","Group",14,1,4,4,5,0,12,2,5,9,1,13,11,3,1
"477",2561,2562,2562,"white","age.gp4","NoTr","NoTrade","Group",11,1,1,2,7,3,7,1,2,9,1,10,6,5,1
"478",2972,2973,2973,"white","age.gp2","NoTr","NoTrade","Group",23,2,9,6,6,1,18,4,9,14,1,22,17,6,1
"479",64,65,65,"white","age.gp4","NoTr","NoTrade","Group",14,1,5,3,5,0,14,0,6,8,0,14,12,2,1
"480",72,73,73,"white","age.gp4","NoTr","NoTrade","Group",12,1,3,1,7,1,10,1,2,10,1,11,9,3,1
"481",143,144,144,"white","age.gp3","NoTr","NoTrade","Group",21,1,10,5,5,1,19,1,11,10,0,21,15,6,1
"482",157,158,158,"white","age.gp1","NoTr","NoTrade","Group",27,15,6,1,5,1,20,6,6,21,2,25,14,13,1
"483",443,444,444,"white","age.gp4","NoTr","NoTrade","NoGroup",1,0,0,0,1,0,1,0,0,1,0,1,1,0,1
"484",1278,1279,1279,"white","age.gp4","NoTr","NoTrade","Group",15,2,2,1,10,2,12,1,3,12,2,13,11,4,1
"485",1709,1710,1710,"white","age.gp2","Tr","NoTrade","Group",22,0,11,6,5,1,20,1,9,13,1,21,16,6,1
"486",1857,1858,1858,"white","age.gp3","NoTr","NoTrade","Group",16,2,4,6,4,3,11,2,5,11,1,15,11,5,1
"487",2103,2104,2104,"white","age.gp2","Tr","NoTrade","Group",19,2,6,6,5,3,14,2,5,14,3,16,13,6,1
"488",2160,2161,2161,"white","age.gp2","Tr","NoTrade","NoGroup",14,1,7,2,4,0,13,1,6,8,0,14,8,6,1
"489",2339,2340,2340,"white","age.gp3","Tr","NoTrade","Group",21,1,6,4,10,2,18,1,6,15,2,19,14,7,1
"490",2950,2951,2951,"white","age.gp4","NoTr","NoTrade","Group",14,0,4,4,6,4,8,2,5,9,1,13,9,5,1
"491",2970,2971,2971,"white","age.gp2","NoTr","NoTrade","Group",23,1,12,5,5,2,19,2,8,15,4,19,14,9,1
"492",65,66,66,"white","age.gp4","NoTr","NoTrade","Group",7,0,1,3,3,2,5,0,3,4,0,7,4,3,1
"493",1281,1282,1282,"white","age.gp4","NoTr","NoTrade","Group",14,0,3,3,8,1,10,3,4,10,0,14,9,5,1
"494",1566,1567,1567,"white","age.gp4","Tr","NoTrade","Group",5,1,1,1,2,0,4,1,1,4,1,4,4,1,1
"495",1848,1849,1849,"black","age.gp3","NoTr","NoTrade","NoGroup",5,0,1,0,4,2,3,0,0,5,0,5,3,2,1
"496",2014,2015,2015,"black","age.gp4","NoTr","NoTrade","NoGroup",1,0,0,0,1,0,1,0,0,1,0,1,1,0,1
"497",2332,2333,2333,"white","age.gp3","Tr","NoTrade","Group",23,3,9,7,4,2,19,2,7,16,0,23,16,7,1
"498",2676,2677,2677,"white","age.gp3","NoTr","NoTrade","NoGroup",7,0,3,1,3,0,7,0,1,6,2,5,5,2,1
"499",66,67,67,"white","age.gp4","NoTr","NoTrade","Group",12,0,0,4,8,2,10,0,4,8,1,11,5,7,1
"500",685,686,686,"white","age.gp4","Tr","NoTrade","Group",9,1,3,2,3,0,7,2,5,4,0,9,7,2,1
"501",761,762,762,"white","age.gp4","NoTr","NoTrade","NoGroup",5,2,0,1,2,0,4,1,1,4,0,5,2,3,1
"502",876,877,877,"white","age.gp3","NoTr","Trade","Group",22,1,9,4,8,3,16,3,8,14,1,21,14,8,1
"503",1188,1189,1189,"white","age.gp4","Tr","NoTrade","NoGroup",8,1,0,5,2,0,8,0,2,6,0,8,5,3,1
"504",1433,1434,1434,"white","age.gp3","Tr","NoTrade","NoGroup",11,0,4,2,5,0,10,1,3,8,0,11,6,5,1
"505",1589,1590,1590,"white","age.gp4","Tr","NoTrade","Group",12,0,3,2,7,1,11,0,4,8,2,10,9,3,1
"506",2005,2006,2006,"black","age.gp4","NoTr","NoTrade","NoGroup",3,0,1,0,2,2,1,0,0,3,1,2,3,0,1
"507",2024,2025,2025,"black","age.gp4","NoTr","NoTrade","NoGroup",4,0,1,0,3,1,2,1,1,3,0,4,3,1,1
"508",2675,2676,2676,"white","age.gp3","NoTr","NoTrade","NoGroup",10,1,5,3,1,1,8,1,5,5,1,9,7,3,1
"509",2757,2758,2758,"white","age.gp3","NoTr","NoTrade","NoGroup",7,1,1,2,3,1,5,1,1,6,1,6,4,3,1
"510",67,68,68,"white","age.gp4","NoTr","NoTrade","Group",10,0,3,2,5,2,8,0,3,7,0,10,8,2,1
"511",92,93,93,"white","age.gp3","NoTr","NoTrade","Group",15,2,6,4,3,0,14,1,6,9,0,15,10,5,1
"512",1024,1025,1025,"black","age.gp4","NoTr","NoTrade","NoGroup",6,0,1,2,3,2,3,1,2,4,0,6,4,2,1
"513",1766,1767,1767,"black","age.gp4","NoTr","NoTrade","NoGroup",5,0,1,0,4,3,2,0,0,5,0,5,3,2,1
"514",2712,2713,2713,"white","age.gp4","NoTr","NoTrade","Group",14,0,3,3,8,1,12,1,3,11,0,14,10,4,1
"515",2745,2746,2746,"white","age.gp2","NoTr","NoTrade","Group",28,4,11,8,5,2,23,3,13,15,1,27,20,8,1
"516",2968,2969,2969,"white","age.gp2","NoTr","NoTrade","Group",23,4,11,6,2,1,17,5,7,16,5,18,16,7,1
"517",68,69,69,"white","age.gp4","NoTr","NoTrade","Group",16,1,1,7,7,3,13,0,5,11,2,14,12,4,1
"518",475,476,476,"black","age.gp3","NoTr","Trade","Group",15,3,5,3,4,7,7,1,4,11,3,12,9,6,1
"519",482,483,483,"black","age.gp4","NoTr","NoTrade","NoGroup",1,0,0,0,1,0,1,0,0,1,0,1,1,0,1
"520",874,875,875,"white","age.gp3","NoTr","Trade","Group",16,1,6,6,3,3,13,0,7,9,0,16,13,3,1
"521",944,945,945,"white","age.gp3","Tr","NoTrade","Group",17,0,2,9,6,1,15,1,6,11,1,16,12,5,1
"522",1101,1102,1102,"black","age.gp2","NoTr","NoTrade","NoGroup",2,0,1,0,1,1,1,0,0,2,0,2,1,1,1
"523",1194,1195,1195,"white","age.gp4","Tr","NoTrade","NoGroup",1,0,0,0,1,0,1,0,0,1,0,1,1,0,1
"524",1408,1409,1409,"white","age.gp3","NoTr","NoTrade","Group",20,3,6,7,4,4,14,2,8,12,2,18,12,8,1
"525",1936,1937,1937,"white","age.gp4","NoTr","NoTrade","Group",6,1,1,2,2,0,6,0,4,2,0,6,4,2,1
"526",2129,2130,2130,"white","age.gp3","NoTr","NoTrade","Group",18,1,6,5,6,0,15,3,8,10,0,18,13,5,1
"527",2260,2261,2261,"white","age.gp4","Tr","NoTrade","Group",18,0,2,3,13,1,17,0,5,13,2,16,10,8,1
"528",2334,2335,2335,"white","age.gp3","Tr","NoTrade","Group",23,3,5,8,7,3,18,2,6,17,1,22,15,8,1
"529",2579,2580,2580,"white","age.gp4","NoTr","NoTrade","Group",11,1,0,1,9,0,11,0,3,8,1,10,7,4,1
"530",2885,2886,2886,"white","age.gp1","NoTr","NoTrade","Group",21,11,4,4,2,3,15,3,4,17,2,19,10,11,1
"531",69,70,70,"white","age.gp4","NoTr","NoTrade","Group",11,1,0,3,7,1,9,1,3,8,0,11,6,5,1
"532",164,165,165,"white","age.gp3","NoTr","NoTrade","NoGroup",9,1,0,3,5,1,7,1,4,5,0,9,6,3,1
"533",381,382,382,"black","age.gp4","NoTr","NoTrade","NoGroup",1,0,0,0,1,0,1,0,0,1,0,1,1,0,1
"534",1081,1082,1082,"white","age.gp4","NoTr","NoTrade","Group",9,0,3,0,6,1,7,1,3,6,0,9,7,2,1
"535",1299,1300,1300,"white","age.gp4","NoTr","NoTrade","Group",11,0,4,2,5,1,9,1,8,3,0,11,8,3,1
"536",1780,1781,1781,"white","age.gp4","Tr","NoTrade","Group",19,1,2,5,11,0,18,1,4,15,2,17,14,5,1
"537",1784,1785,1785,"white","age.gp4","Tr","NoTrade","Group",5,0,3,1,1,0,5,0,1,4,0,5,3,2,1
"538",1949,1950,1950,"white","age.gp4","NoTr","NoTrade","Group",6,0,2,1,3,0,6,0,3,3,1,5,4,2,1
"539",2118,2119,2119,"white","age.gp3","NoTr","NoTrade","Group",18,1,6,6,5,0,16,2,4,14,0,18,12,6,1
"540",2175,2176,2176,"white","age.gp4","NoTr","NoTrade","NoGroup",5,0,2,2,1,0,4,1,2,3,0,5,2,3,1
"541",2909,2910,2910,"other","age.gp1","NoTr","NoTrade","NoGroup",6,2,1,2,1,2,4,0,0,6,1,5,3,3,1
"542",411,412,412,"white","age.gp2","Tr","Trade","Group",18,1,6,8,3,1,16,1,7,11,1,17,11,7,1
"543",680,681,681,"white","age.gp4","Tr","NoTrade","Group",12,0,5,1,6,2,9,1,3,9,0,12,7,5,1
"544",1321,1322,1322,"white","age.gp2","Tr","NoTrade","Group",22,4,11,3,4,3,18,1,7,15,0,22,10,12,1
"545",1324,1325,1325,"white","age.gp2","Tr","NoTrade","Group",24,1,11,8,4,3,18,3,9,15,3,21,16,8,1
"546",1682,1683,1683,"white","age.gp4","NoTr","Trade","NoGroup",8,1,0,2,5,0,8,0,2,6,0,8,7,1,1
"547",1792,1793,1793,"white","age.gp4","Tr","NoTrade","Group",12,0,1,5,6,1,10,1,1,11,0,12,6,6,1
"548",2244,2245,2245,"white","age.gp4","Tr","NoTrade","Group",12,2,1,1,8,1,11,0,3,9,2,10,10,2,1
"549",2768,2769,2769,"white","age.gp1","NoTr","NoTrade","NoGroup",9,3,2,3,1,0,8,1,3,6,1,8,5,4,1
"550",71,72,72,"white","age.gp4","NoTr","NoTrade","Group",15,1,1,4,9,0,15,0,7,8,1,14,11,4,1
"551",314,315,315,"white","age.gp4","NoTr","NoTrade","Group",11,1,3,0,7,0,11,0,4,7,0,11,7,4,1
"552",696,697,697,"white","age.gp4","Tr","NoTrade","Group",6,2,0,1,3,0,5,1,2,4,0,6,3,3,1
"553",801,802,802,"white","age.gp4","NoTr","NoTrade","NoGroup",6,0,2,2,2,0,6,0,3,3,0,6,5,1,1
"554",942,943,943,"white","age.gp3","Tr","NoTrade","Group",15,2,8,3,2,0,15,0,10,5,2,13,12,3,1
"555",1069,1070,1070,"white","age.gp4","NoTr","NoTrade","Group",11,1,4,3,3,0,10,1,4,7,0,11,7,4,1
"556",1136,1137,1137,"white","age.gp2","Tr","NoTrade","Group",21,2,10,5,4,1,19,1,13,8,1,20,14,7,1
"557",1562,1563,1563,"white","age.gp4","Tr","NoTrade","Group",12,2,3,2,5,2,9,1,2,10,0,12,9,3,1
"558",1603,1604,1604,"white","age.gp3","Tr","NoTrade","NoGroup",10,1,3,4,2,0,10,0,3,7,1,9,4,6,1
"559",1704,1705,1705,"white","age.gp4","NoTr","Trade","NoGroup",7,0,3,1,3,0,6,1,2,5,0,7,3,4,1
"560",1954,1955,1955,"white","age.gp4","NoTr","NoTrade","Group",17,1,7,2,7,1,16,0,8,9,0,17,13,4,1
"561",2027,2028,2028,"white","age.gp4","Tr","NoTrade","Group",13,0,4,4,5,0,12,1,4,9,0,13,7,6,1
"562",83,84,84,"white","age.gp4","NoTr","NoTrade","Group",10,0,3,1,6,1,9,0,4,6,0,10,8,2,1
"563",629,630,630,"other","age.gp1","NoTr","Trade","Group",8,3,3,1,1,0,8,0,1,7,2,6,4,4,1
"564",768,769,769,"white","age.gp4","NoTr","NoTrade","NoGroup",7,0,1,0,6,1,6,0,3,4,0,7,6,1,1
"565",1422,1423,1423,"white","age.gp2","NoTr","NoTrade","Group",25,3,14,5,3,4,19,2,6,19,3,22,15,10,1
"566",1532,1533,1533,"black","age.gp4","NoTr","NoTrade","NoGroup",8,0,2,1,5,3,5,0,2,6,1,7,6,2,1
"567",2116,2117,2117,"white","age.gp2","NoTr","NoTrade","NoGroup",10,1,5,0,4,1,7,2,4,6,0,10,8,2,1
"568",2338,2339,2339,"white","age.gp3","Tr","NoTrade","Group",17,1,4,9,3,0,16,1,8,9,1,16,13,4,1
"569",2523,2524,2524,"white","age.gp2","Tr","NoTrade","Group",28,3,12,7,6,3,22,3,8,20,2,26,20,8,1
"570",2567,2568,2568,"white","age.gp4","NoTr","NoTrade","Group",10,0,0,1,9,0,10,0,5,5,0,10,8,2,1
"571",941,942,942,"white","age.gp3","Tr","NoTrade","Group",18,2,7,3,6,0,16,2,9,9,1,17,13,5,1
"572",1133,1134,1134,"white","age.gp2","Tr","NoTrade","Group",26,0,12,6,8,2,22,2,5,21,6,20,19,7,1
"573",1421,1422,1422,"white","age.gp2","NoTr","NoTrade","Group",23,1,14,7,1,0,23,0,11,12,3,20,19,4,1
"574",1822,1823,1823,"black","age.gp4","NoTr","NoTrade","NoGroup",4,1,1,1,1,1,2,1,0,4,1,3,3,1,1
"575",2055,2056,2056,"white","age.gp4","Tr","NoTrade","Group",9,0,3,1,5,2,7,0,1,8,0,9,4,5,1
"576",2271,2272,2272,"white","age.gp4","Tr","NoTrade","Group",7,2,0,0,5,2,4,1,1,6,0,7,5,2,1
"577",2272,2273,2273,"white","age.gp4","Tr","NoTrade","Group",7,0,4,1,2,0,6,1,2,5,0,7,6,1,1
"578",2405,2406,2406,"white","age.gp3","NoTr","NoTrade","NoGroup",5,0,2,2,1,0,5,0,1,4,0,5,4,1,1
"579",2865,2866,2866,"white","age.gp2","Tr","NoTrade","Group",31,2,10,10,9,0,30,1,12,19,1,30,21,10,1
"580",74,75,75,"white","age.gp4","NoTr","NoTrade","Group",16,5,2,2,7,1,12,3,4,12,4,12,12,4,1
"581",302,303,303,"white","age.gp4","NoTr","NoTrade","Group",10,0,2,1,7,1,9,0,5,5,0,10,6,4,1
"582",441,442,442,"white","age.gp4","NoTr","NoTrade","NoGroup",3,1,0,0,2,0,1,2,0,3,0,3,2,1,1
"583",642,643,643,"other","age.gp1","NoTr","Trade","Group",12,4,0,5,3,2,10,0,3,9,1,11,5,7,1
"584",643,644,644,"other","age.gp1","NoTr","Trade","Group",8,5,0,1,2,0,8,0,3,5,3,5,6,2,1
"585",878,879,879,"white","age.gp3","NoTr","Trade","Group",22,6,3,5,8,1,18,3,10,12,3,19,14,8,1
"586",1256,1257,1257,"white","age.gp1","Tr","Trade","Group",19,7,3,5,4,0,17,2,7,12,2,17,11,8,1
"587",1334,1335,1335,"white","age.gp3","NoTr","NoTrade","NoGroup",8,0,3,2,3,1,6,1,3,5,0,8,4,4,1
"588",1760,1761,1761,"black","age.gp4","NoTr","NoTrade","NoGroup",1,0,0,0,1,0,1,0,0,1,0,1,1,0,1
"589",2521,2522,2522,"white","age.gp2","Tr","NoTrade","Group",23,3,12,3,5,3,16,4,11,12,1,22,15,8,1
"590",2566,2567,2567,"white","age.gp4","NoTr","NoTrade","Group",8,1,2,0,5,0,7,1,3,5,1,7,7,1,1
"591",2577,2578,2578,"white","age.gp4","NoTr","NoTrade","Group",14,0,4,1,9,1,12,1,6,8,0,14,10,4,1
"592",2691,2692,2692,"white","age.gp4","NoTr","NoTrade","Group",9,2,2,1,4,1,6,2,2,7,1,8,5,4,1
"593",2883,2884,2884,"white","age.gp1","NoTr","NoTrade","Group",33,14,6,6,7,2,26,5,11,22,6,27,19,14,1
"594",2899,2900,2900,"other","age.gp1","NoTr","NoTrade","NoGroup",5,2,1,0,2,1,4,0,3,2,1,4,4,1,1
"595",75,76,76,"white","age.gp4","NoTr","NoTrade","Group",15,2,0,0,13,1,13,1,4,11,0,15,8,7,1
"596",80,81,81,"white","age.gp4","NoTr","NoTrade","Group",9,1,1,0,7,0,9,0,1,8,0,9,9,0,1
"597",255,256,256,"white","age.gp4","NoTr","NoTrade","NoGroup",1,0,0,0,1,0,1,0,0,1,0,1,1,0,1
"598",529,530,530,"white","age.gp4","NoTr","NoTrade","NoGroup",6,0,0,0,6,1,5,0,2,4,0,6,4,2,1
"599",1006,1007,1007,"white","age.gp1","Tr","NoTrade","Group",18,6,7,2,3,2,13,3,6,12,1,17,7,11,1
"600",1168,1169,1169,"white","age.gp4","NoTr","NoTrade","NoGroup",4,1,0,2,1,0,4,0,2,2,0,4,3,1,1
"601",1212,1213,1213,"white","age.gp4","NoTr","NoTrade","NoGroup",6,1,1,1,3,0,5,1,2,4,1,5,5,1,1
"602",1216,1217,1217,"white","age.gp4","NoTr","NoTrade","NoGroup",4,0,0,0,4,0,4,0,2,2,0,4,4,0,1
"603",1225,1226,1226,"white","age.gp4","NoTr","NoTrade","NoGroup",7,0,1,2,4,0,7,0,3,4,0,7,6,1,1
"604",1296,1297,1297,"white","age.gp4","NoTr","NoTrade","Group",17,0,4,3,10,0,16,1,6,11,0,17,12,5,1
"605",1579,1580,1580,"white","age.gp4","Tr","NoTrade","Group",11,1,1,4,5,3,7,1,1,10,1,10,8,3,1
"606",1582,1583,1583,"white","age.gp4","Tr","NoTrade","Group",11,2,6,1,2,0,8,3,5,6,0,11,6,5,1
"607",1768,1769,1769,"black","age.gp4","NoTr","NoTrade","NoGroup",3,0,0,0,3,1,2,0,1,2,0,3,3,0,1
"608",1880,1881,1881,"other","age.gp1","NoTr","NoTrade","Group",13,6,2,2,3,2,11,0,3,10,0,13,8,5,1
"609",2558,2559,2559,"white","age.gp4","NoTr","NoTrade","Group",5,0,2,2,1,1,3,1,2,3,0,5,2,3,1
"610",338,339,339,"white","age.gp1","NoTr","Trade","Group",18,11,2,0,5,0,14,4,7,11,1,17,13,5,1
"611",688,689,689,"white","age.gp4","Tr","NoTrade","Group",12,0,0,2,10,1,11,0,3,9,0,12,10,2,1
"612",1791,1792,1792,"white","age.gp4","Tr","NoTrade","Group",9,1,0,3,5,0,9,0,2,7,0,9,4,5,1
"613",1826,1827,1827,"black","age.gp4","NoTr","NoTrade","NoGroup",6,1,1,1,3,3,3,0,1,5,1,5,2,4,1
"614",1963,1964,1964,"white","age.gp4","NoTr","NoTrade","Group",10,1,2,2,5,0,9,1,5,5,2,8,6,4,1
"615",2258,2259,2259,"white","age.gp4","Tr","NoTrade","Group",10,0,2,1,7,0,9,1,3,7,0,10,7,3,1
"616",2733,2734,2734,"black","age.gp3","NoTr","NoTrade","NoGroup",5,0,2,0,3,1,4,0,0,5,0,5,3,2,1
"617",77,78,78,"white","age.gp4","NoTr","NoTrade","Group",10,1,2,1,6,3,7,0,4,6,1,9,8,2,1
"618",1033,1034,1034,"black","age.gp4","NoTr","NoTrade","NoGroup",3,0,0,0,3,2,1,0,0,3,1,2,3,0,1
"619",1371,1372,1372,"black","age.gp4","NoTr","NoTrade","Group",11,2,3,1,5,7,3,1,1,10,0,11,5,6,1
"620",1740,1741,1741,"white","age.gp3","Tr","NoTrade","Group",21,1,11,5,4,0,18,3,8,13,0,21,12,9,1
"621",1937,1938,1938,"white","age.gp4","NoTr","NoTrade","Group",13,0,1,1,11,1,11,1,3,10,0,13,10,3,1
"622",78,79,79,"white","age.gp4","NoTr","NoTrade","Group",9,0,3,2,4,0,8,1,5,4,0,9,6,3,1
"623",806,807,807,"white","age.gp4","NoTr","NoTrade","NoGroup",7,0,1,4,2,0,7,0,2,5,0,7,4,3,1
"624",1080,1081,1081,"white","age.gp4","NoTr","NoTrade","Group",7,0,3,0,4,1,6,0,3,4,0,7,5,2,1
"625",1600,1601,1601,"white","age.gp2","Tr","NoTrade","NoGroup",15,2,6,2,5,1,14,0,7,8,4,11,10,5,1
"626",1737,1738,1738,"white","age.gp3","Tr","NoTrade","Group",21,0,8,8,5,3,18,0,6,15,0,21,12,9,1
"627",1923,1924,1924,"other","age.gp2","NoTr","NoTrade","NoGroup",4,0,2,0,2,1,3,0,2,2,0,4,2,2,1
"628",2032,2033,2033,"white","age.gp4","Tr","NoTrade","Group",17,4,2,3,8,1,13,3,1,16,1,16,9,8,1
"629",79,80,80,"white","age.gp4","NoTr","NoTrade","Group",10,0,1,2,7,1,9,0,4,6,0,10,7,3,1
"630",100,101,101,"white","age.gp3","NoTr","NoTrade","Group",8,3,1,1,3,1,6,1,2,6,1,7,6,2,1
"631",231,232,232,"white","age.gp2","Tr","NoTrade","Group",21,1,7,6,7,3,17,1,9,12,2,19,12,9,1
"632",306,307,307,"white","age.gp4","NoTr","NoTrade","Group",10,0,3,1,6,1,9,0,2,8,2,8,6,4,1
"633",326,327,327,"white","age.gp4","NoTr","NoTrade","Group",12,1,2,2,7,0,10,2,6,6,0,12,7,5,1
"634",687,688,688,"white","age.gp4","Tr","NoTrade","Group",14,0,5,2,7,0,12,2,7,7,0,14,11,3,1
"635",1608,1609,1609,"white","age.gp3","Tr","NoTrade","NoGroup",9,1,3,2,3,2,7,0,5,4,1,8,6,3,1
"636",2438,2439,2439,"white","age.gp4","NoTr","NoTrade","NoGroup",5,0,1,0,4,0,5,0,3,2,0,5,4,1,1
"637",90,91,91,"white","age.gp4","NoTr","NoTrade","Group",13,0,5,2,6,1,11,1,6,7,0,13,11,2,1
"638",1061,1062,1062,"white","age.gp4","NoTr","NoTrade","Group",11,0,3,0,8,0,11,0,3,8,0,11,10,1,1
"639",2586,2587,2587,"white","age.gp4","NoTr","NoTrade","Group",11,0,1,2,8,0,11,0,5,6,0,11,10,1,1
"640",2872,2873,2873,"white","age.gp1","NoTr","NoTrade","Group",34,17,9,3,5,7,17,10,9,25,2,32,15,19,1
"641",2936,2937,2937,"white","age.gp4","NoTr","NoTrade","Group",19,1,4,3,11,2,14,3,5,14,0,19,15,4,1
"642",488,489,489,"black","age.gp4","NoTr","NoTrade","NoGroup",4,0,0,1,3,3,1,0,0,4,0,4,2,2,1
"643",937,938,938,"white","age.gp3","NoTr","NoTrade","NoGroup",6,1,2,1,2,1,4,1,1,5,1,5,4,2,1
"644",1070,1071,1071,"white","age.gp4","NoTr","NoTrade","Group",16,1,3,4,8,1,14,1,2,14,0,16,13,3,1
"645",1341,1342,1342,"white","age.gp1","Tr","NoTrade","NoGroup",9,3,2,3,1,0,8,1,4,5,1,8,7,2,1
"646",1719,1720,1720,"white","age.gp2","NoTr","NoTrade","Group",24,1,9,5,9,1,22,1,7,17,2,22,15,9,1
"647",2775,2776,2776,"white","age.gp3","NoTr","NoTrade","Group",18,4,7,2,5,1,15,2,10,8,2,16,13,5,1
"648",82,83,83,"white","age.gp4","NoTr","NoTrade","Group",16,0,3,4,9,1,14,1,3,13,1,15,10,6,1
"649",253,254,254,"white","age.gp4","NoTr","NoTrade","NoGroup",1,0,0,0,1,0,1,0,0,1,0,1,1,0,1
"650",325,326,326,"white","age.gp4","NoTr","NoTrade","Group",13,1,3,3,6,2,10,1,1,12,0,13,9,4,1
"651",577,578,578,"other","age.gp4","NoTr","NoTrade","NoGroup",5,0,2,0,3,1,4,0,0,5,0,5,2,3,1
"652",674,675,675,"white","age.gp4","Tr","NoTrade","Group",11,0,2,4,5,0,10,1,2,9,0,11,9,2,1
"653",678,679,679,"white","age.gp4","Tr","NoTrade","Group",18,2,1,4,11,2,15,1,2,16,0,18,11,7,1
"654",836,837,837,"white","age.gp2","NoTr","NoTrade","Group",30,2,11,9,8,2,28,0,15,15,0,30,19,11,1
"655",936,937,937,"white","age.gp3","NoTr","NoTrade","NoGroup",6,1,2,2,1,0,5,1,2,4,0,6,5,1,1
"656",1001,1002,1002,"white","age.gp4","NoTr","NoTrade","NoGroup",6,0,0,1,5,0,6,0,4,2,0,6,4,2,1
"657",1673,1674,1674,"white","age.gp2","Tr","NoTrade","NoGroup",11,1,8,0,2,0,10,1,5,6,0,11,7,4,1
"658",2233,2234,2234,"black","age.gp4","NoTr","Trade","Group",8,0,3,1,4,4,4,0,1,7,2,6,8,0,1
"659",2781,2782,2782,"white","age.gp3","NoTr","NoTrade","Group",15,1,5,5,4,0,14,1,6,9,1,14,12,3,1
"660",228,229,229,"white","age.gp2","Tr","NoTrade","Group",32,2,16,7,7,4,27,1,10,22,1,31,21,11,1
"661",776,777,777,"white","age.gp4","NoTr","NoTrade","NoGroup",7,1,2,1,3,0,7,0,3,4,1,6,5,2,1
"662",1412,1413,1413,"white","age.gp3","NoTr","NoTrade","Group",13,0,6,3,4,0,12,1,5,8,2,11,11,2,1
"663",1982,1983,1983,"white","age.gp4","Tr","NoTrade","NoGroup",7,0,2,2,3,0,7,0,2,5,0,7,7,0,1
"664",2268,2269,2269,"white","age.gp4","Tr","NoTrade","Group",12,0,2,1,9,0,10,2,3,9,0,12,9,3,1
"665",2576,2577,2577,"white","age.gp4","NoTr","NoTrade","Group",17,1,5,5,6,1,15,1,6,11,1,16,16,1,1
"666",2695,2696,2696,"white","age.gp4","NoTr","NoTrade","Group",14,0,4,2,8,1,12,1,2,12,0,14,10,4,1
"667",2863,2864,2864,"white","age.gp2","Tr","NoTrade","Group",26,1,10,5,10,0,23,3,9,17,3,23,18,8,1
"668",84,85,85,"white","age.gp4","NoTr","NoTrade","Group",18,1,1,2,14,1,16,1,7,11,0,18,12,6,1
"669",318,319,319,"white","age.gp4","NoTr","NoTrade","Group",15,2,2,5,6,0,14,1,4,11,1,14,10,5,1
"670",430,431,431,"white","age.gp4","NoTr","NoTrade","NoGroup",7,0,1,2,4,2,4,1,0,7,0,7,3,4,1
"671",552,553,553,"white","age.gp4","NoTr","NoTrade","NoGroup",7,0,0,0,7,0,7,0,2,5,0,7,5,2,1
"672",849,850,850,"other","age.gp2","Tr","NoTrade","Group",12,2,1,5,4,1,11,0,1,11,1,11,10,2,1
"673",1564,1565,1565,"white","age.gp4","Tr","NoTrade","Group",8,0,2,1,5,1,7,0,3,5,0,8,6,2,1
"674",1580,1581,1581,"white","age.gp4","Tr","NoTrade","Group",14,1,6,4,3,0,13,1,4,10,1,13,10,4,1
"675",1722,1723,1723,"white","age.gp1","Tr","NoTrade","NoGroup",13,7,4,0,2,1,10,2,3,10,4,9,9,4,1
"676",1933,1934,1934,"white","age.gp4","NoTr","NoTrade","Group",10,1,0,1,8,1,9,0,3,7,0,10,9,1,1
"677",1946,1947,1947,"white","age.gp4","NoTr","NoTrade","Group",5,0,3,1,1,0,4,1,3,2,0,5,3,2,1
"678",2041,2042,2042,"white","age.gp4","Tr","NoTrade","Group",14,0,2,5,7,1,13,0,4,10,3,11,11,3,1
"679",2044,2045,2045,"white","age.gp4","Tr","NoTrade","Group",10,1,1,3,5,1,9,0,2,8,0,10,7,3,1
"680",2433,2434,2434,"white","age.gp4","NoTr","NoTrade","NoGroup",4,0,0,0,4,0,4,0,1,3,0,4,2,2,1
"681",2445,2446,2446,"white","age.gp4","NoTr","NoTrade","NoGroup",6,1,1,0,4,0,6,0,2,4,0,6,4,2,1
"682",2573,2574,2574,"white","age.gp4","NoTr","NoTrade","Group",16,0,2,5,9,2,14,0,6,10,3,13,12,4,1
"683",591,592,592,"other","age.gp4","NoTr","NoTrade","NoGroup",1,0,0,0,1,0,1,0,0,1,0,1,1,0,1
"684",1232,1233,1233,"white","age.gp4","NoTr","NoTrade","NoGroup",5,0,1,0,4,0,5,0,3,2,0,5,5,0,1
"685",1469,1470,1470,"white","age.gp1","NoTr","NoTrade","NoGroup",15,6,3,2,4,0,13,2,5,10,2,13,13,2,1
"686",1685,1686,1686,"white","age.gp4","NoTr","Trade","NoGroup",1,0,0,0,1,0,1,0,0,1,0,1,1,0,1
"687",1913,1914,1914,"other","age.gp2","NoTr","NoTrade","NoGroup",4,0,1,1,2,2,2,0,1,3,0,4,3,1,1
"688",2040,2041,2041,"white","age.gp4","Tr","NoTrade","Group",8,1,1,1,5,1,6,1,0,8,1,7,6,2,1
"689",2127,2128,2128,"white","age.gp3","NoTr","NoTrade","Group",17,0,4,4,9,1,15,1,4,13,1,16,13,4,1
"690",2386,2387,2387,"white","age.gp2","Tr","NoTrade","Group",16,1,10,1,4,3,11,2,5,11,1,15,10,6,1
"691",2500,2501,2501,"other","age.gp1","NoTr","NoTrade","NoGroup",4,3,0,0,1,1,2,1,0,4,0,4,2,2,1
"692",86,87,87,"white","age.gp4","NoTr","NoTrade","Group",9,1,2,0,6,1,7,1,2,7,1,8,6,3,1
"693",316,317,317,"white","age.gp4","NoTr","NoTrade","Group",11,0,1,1,9,0,10,1,5,6,0,11,6,5,1
"694",2054,2055,2055,"white","age.gp4","Tr","NoTrade","Group",13,1,2,2,8,4,7,2,2,11,0,13,6,7,1
"695",2189,2190,2190,"white","age.gp4","NoTr","NoTrade","NoGroup",3,0,0,0,3,1,2,0,1,2,0,3,2,1,1
"696",2201,2202,2202,"white","age.gp4","NoTr","NoTrade","NoGroup",5,1,1,1,2,0,4,1,3,2,0,5,4,1,1
"697",2236,2237,2237,"black","age.gp4","NoTr","Trade","Group",5,0,0,1,4,2,3,0,1,4,1,4,4,1,1
"698",2289,2290,2290,"other","age.gp2","Tr","NoTrade","Group",14,1,7,3,3,2,12,0,7,7,3,11,11,3,1
"699",2384,2385,2385,"white","age.gp1","NoTr","NoTrade","NoGroup",14,9,0,2,3,0,12,2,3,11,2,12,7,7,1
"700",87,88,88,"white","age.gp4","NoTr","NoTrade","Group",8,0,3,1,4,0,7,1,5,3,1,7,3,5,1
"701",111,112,112,"white","age.gp3","NoTr","NoTrade","NoGroup",14,1,7,3,3,3,10,1,5,9,2,12,11,3,1
"702",230,231,231,"white","age.gp2","Tr","NoTrade","Group",20,1,12,4,3,0,18,2,12,8,2,18,14,6,1
"703",860,861,861,"other","age.gp2","Tr","NoTrade","Group",14,1,6,4,3,4,10,0,3,11,1,13,9,5,1
"704",1706,1707,1707,"white","age.gp4","NoTr","Trade","NoGroup",1,0,0,0,1,0,1,0,0,1,0,1,1,0,1
"705",1966,1967,1967,"white","age.gp4","Tr","NoTrade","NoGroup",9,1,3,0,5,1,7,1,2,7,0,9,4,5,1
"706",1970,1971,1971,"white","age.gp4","Tr","NoTrade","NoGroup",5,1,1,1,2,0,4,1,2,3,1,4,3,2,1
"707",2196,2197,2197,"white","age.gp4","NoTr","NoTrade","NoGroup",9,1,1,1,6,4,4,1,1,8,1,8,5,4,1
"708",88,89,89,"white","age.gp4","NoTr","NoTrade","Group",10,1,2,3,4,1,8,1,3,7,0,10,6,4,1
"709",145,146,146,"white","age.gp3","NoTr","NoTrade","Group",23,3,9,3,8,2,18,3,8,15,2,21,14,9,1
"710",929,930,930,"white","age.gp3","NoTr","NoTrade","NoGroup",3,0,2,0,1,0,3,0,1,2,0,3,1,2,1
"711",1037,1038,1038,"black","age.gp4","NoTr","NoTrade","NoGroup",5,0,2,1,2,3,2,0,0,5,1,4,3,2,1
"712",1132,1133,1133,"other","age.gp1","NoTr","NoTrade","NoGroup",4,2,1,0,1,0,4,0,1,3,0,4,2,2,1
"713",1328,1329,1329,"white","age.gp3","NoTr","NoTrade","NoGroup",4,2,0,0,2,0,3,1,1,3,1,3,3,1,1
"714",1707,1708,1708,"white","age.gp2","Tr","NoTrade","Group",22,3,8,5,6,0,20,2,9,13,3,19,15,7,1
"715",89,90,90,"white","age.gp4","NoTr","NoTrade","Group",12,0,3,2,7,1,10,1,5,7,0,12,8,4,1
"716",319,320,320,"white","age.gp4","NoTr","NoTrade","Group",11,0,5,0,6,2,8,1,2,9,0,11,7,4,1
"717",423,424,424,"white","age.gp4","NoTr","NoTrade","NoGroup",1,0,0,0,1,0,1,0,0,1,0,1,1,0,1
"718",588,589,589,"other","age.gp4","NoTr","NoTrade","NoGroup",4,1,2,0,1,2,2,0,1,3,0,4,2,2,1
"719",692,693,693,"white","age.gp4","Tr","NoTrade","Group",15,3,3,1,8,2,12,1,1,14,1,14,11,4,1
"720",828,829,829,"white","age.gp3","NoTr","NoTrade","NoGroup",11,1,2,4,4,0,9,2,4,7,1,10,8,3,1
"721",1287,1288,1288,"white","age.gp4","NoTr","NoTrade","Group",14,1,2,3,8,1,12,1,6,8,2,12,11,3,1
"722",1773,1774,1774,"white","age.gp4","Tr","NoTrade","Group",11,2,2,2,5,2,7,2,4,7,2,9,7,4,1
"723",1803,1804,1804,"white","age.gp4","Tr","NoTrade","Group",16,2,2,0,12,1,15,0,5,11,0,16,10,6,1
"724",2167,2168,2168,"black","age.gp2","NoTr","NoTrade","NoGroup",9,2,1,2,4,4,5,0,2,7,3,6,6,3,1
"725",2738,2739,2739,"white","age.gp2","Tr","NoTrade","Group",22,1,8,8,5,1,18,3,6,16,1,21,15,7,1
"726",2842,2843,2843,"white","age.gp2","Tr","NoTrade","Group",15,2,5,4,4,2,12,1,5,10,2,13,8,7,1
"727",195,196,196,"white","age.gp2","Tr","NoTrade","NoGroup",10,2,2,3,3,0,10,0,2,8,0,10,7,3,1
"728",298,299,299,"white","age.gp4","NoTr","NoTrade","Group",7,0,3,1,3,1,6,0,3,4,0,7,5,2,1
"729",582,583,583,"other","age.gp4","NoTr","NoTrade","NoGroup",3,0,1,0,2,0,3,0,1,2,0,3,3,0,1
"730",955,956,956,"white","age.gp3","Tr","NoTrade","Group",21,1,9,5,6,2,19,0,6,15,1,20,12,9,1
"731",967,968,968,"white","age.gp2","Tr","NoTrade","Group",21,1,11,4,5,1,20,0,7,14,3,18,16,5,1
"732",1586,1587,1587,"white","age.gp4","Tr","NoTrade","Group",17,4,1,5,7,0,17,0,8,9,1,16,12,5,1
"733",2791,2792,2792,"white","age.gp2","NoTr","NoTrade","Group",14,1,5,5,3,0,13,1,10,4,0,14,9,5,1
"734",91,92,92,"white","age.gp3","NoTr","NoTrade","Group",23,1,11,6,5,3,18,2,9,14,1,22,16,7,1
"735",140,141,141,"white","age.gp2","NoTr","NoTrade","NoGroup",6,0,1,2,3,2,4,0,1,5,0,6,4,2,1
"736",284,285,285,"white","age.gp2","Tr","NoTrade","Group",20,1,11,4,4,2,14,4,8,12,0,20,13,7,1
"737",312,313,313,"white","age.gp4","NoTr","NoTrade","Group",6,0,0,1,5,0,6,0,0,6,0,6,4,2,1
"738",467,468,468,"black","age.gp3","NoTr","Trade","Group",15,0,4,6,5,6,9,0,6,9,2,13,10,5,1
"739",854,855,855,"other","age.gp2","Tr","NoTrade","Group",9,1,5,3,0,0,9,0,6,3,0,9,7,2,1
"740",1013,1014,1014,"white","age.gp1","NoTr","NoTrade","NoGroup",12,7,3,2,0,1,9,2,2,10,2,10,8,4,1
"741",1074,1075,1075,"white","age.gp4","NoTr","NoTrade","Group",16,0,4,6,6,1,14,1,5,11,0,16,11,5,1
"742",1210,1211,1211,"white","age.gp4","NoTr","NoTrade","NoGroup",3,0,0,2,1,0,3,0,0,3,1,2,3,0,1
"743",1243,1244,1244,"white","age.gp2","Tr","NoTrade","NoGroup",5,1,1,1,2,2,2,1,1,4,0,5,3,2,1
"744",1438,1439,1439,"white","age.gp3","Tr","NoTrade","NoGroup",8,0,2,3,3,1,7,0,2,6,0,8,7,1,1
"745",1502,1503,1503,"white","age.gp4","NoTr","NoTrade","NoGroup",4,1,0,2,1,0,4,0,0,4,0,4,4,0,1
"746",1550,1551,1551,"white","age.gp3","NoTr","NoTrade","Group",12,1,4,4,3,2,10,0,5,7,1,11,7,5,1
"747",2060,2061,2061,"white","age.gp3","Tr","NoTrade","Group",22,3,9,6,4,4,16,2,10,12,1,21,14,8,1
"748",2096,2097,2097,"black","age.gp3","NoTr","NoTrade","NoGroup",6,1,2,3,0,1,4,1,1,5,1,5,4,2,1
"749",2247,2248,2248,"white","age.gp4","Tr","NoTrade","Group",11,0,1,5,5,2,9,0,2,9,1,10,7,4,1
"750",2303,2304,2304,"other","age.gp2","Tr","NoTrade","Group",9,1,5,3,0,0,9,0,4,5,0,9,6,3,1
"751",2524,2525,2525,"white","age.gp2","Tr","NoTrade","Group",23,2,14,3,4,1,19,3,8,15,1,22,18,5,1
"752",2609,2610,2610,"black","age.gp2","NoTr","NoTrade","Group",22,2,8,5,7,11,10,1,5,17,1,21,13,9,1
"753",2746,2747,2747,"white","age.gp2","NoTr","NoTrade","Group",33,5,20,5,3,0,27,6,17,16,2,31,25,8,1
"754",287,288,288,"white","age.gp1","NoTr","NoTrade","NoGroup",10,4,3,3,0,0,8,2,2,8,0,10,4,6,1
"755",778,779,779,"white","age.gp4","NoTr","NoTrade","NoGroup",1,0,0,1,0,0,1,0,0,1,0,1,1,0,1
"756",841,842,842,"white","age.gp2","Tr","NoTrade","NoGroup",8,2,3,2,1,1,5,2,1,7,1,7,4,4,1
"757",1099,1100,1100,"white","age.gp2","NoTr","NoTrade","Group",18,1,7,8,2,2,13,3,4,14,2,16,10,8,1
"758",1383,1384,1384,"white","age.gp1","NoTr","NoTrade","NoGroup",9,4,1,4,0,0,8,1,1,8,1,8,6,3,1
"759",1439,1440,1440,"white","age.gp3","Tr","NoTrade","NoGroup",10,0,2,5,3,1,9,0,3,7,0,10,6,4,1
"760",1578,1579,1579,"white","age.gp4","Tr","NoTrade","Group",10,0,3,3,4,1,9,0,3,7,2,8,9,1,1
"761",2299,2300,2300,"other","age.gp2","Tr","NoTrade","Group",15,0,7,5,3,1,14,0,4,11,3,12,14,1,1
"762",2597,2598,2598,"white","age.gp3","NoTr","NoTrade","Group",20,2,7,6,5,1,16,3,8,12,0,20,9,11,1
"763",2660,2661,2661,"white","age.gp2","NoTr","NoTrade","Group",25,1,10,11,3,2,23,0,7,18,0,25,18,7,1
"764",93,94,94,"white","age.gp3","NoTr","NoTrade","Group",19,2,9,4,4,0,12,7,8,11,0,19,14,5,1
"765",103,104,104,"white","age.gp3","NoTr","NoTrade","Group",14,2,8,4,0,0,13,1,9,5,1,13,9,5,1
"766",570,571,571,"other","age.gp4","NoTr","NoTrade","NoGroup",3,0,0,1,2,0,3,0,0,3,0,3,3,0,1
"767",848,849,849,"other","age.gp2","Tr","NoTrade","Group",15,0,5,7,3,3,12,0,4,11,1,14,11,4,1
"768",858,859,859,"other","age.gp2","Tr","NoTrade","Group",8,0,3,5,0,1,7,0,3,5,1,7,7,1,1
"769",1134,1135,1135,"white","age.gp2","Tr","NoTrade","Group",31,4,14,9,4,2,23,6,14,17,4,27,24,7,1
"770",1149,1150,1150,"white","age.gp4","NoTr","NoTrade","NoGroup",4,0,2,2,0,0,3,1,1,3,0,4,2,2,1
"771",1789,1790,1790,"white","age.gp4","Tr","NoTrade","Group",18,1,2,4,11,3,14,1,8,10,1,17,14,4,1
"772",1870,1871,1871,"other","age.gp1","NoTr","NoTrade","Group",9,4,2,3,0,1,8,0,2,7,0,9,2,7,1
"773",1959,1960,1960,"white","age.gp4","NoTr","NoTrade","Group",14,2,1,4,7,3,10,1,2,12,2,12,11,3,1
"774",2120,2121,2121,"white","age.gp3","NoTr","NoTrade","Group",20,2,11,5,2,1,17,2,6,14,2,18,14,6,1
"775",2132,2133,2133,"other","age.gp2","NoTr","NoTrade","NoGroup",4,1,1,1,1,0,4,0,2,2,0,4,2,2,1
"776",2281,2282,2282,"other","age.gp2","Tr","NoTrade","Group",3,0,1,2,0,0,3,0,1,2,0,3,3,0,1
"777",2522,2523,2523,"white","age.gp2","Tr","NoTrade","Group",17,1,6,7,3,1,15,1,6,11,1,16,9,8,1
"778",2604,2605,2605,"white","age.gp3","NoTr","NoTrade","Group",23,3,10,5,5,4,19,0,11,12,1,22,18,5,1
"779",2774,2775,2775,"white","age.gp3","NoTr","NoTrade","Group",7,0,2,4,1,0,7,0,1,6,0,7,6,1,1
"780",2914,2915,2915,"other","age.gp1","NoTr","NoTrade","NoGroup",5,2,1,2,0,0,5,0,2,3,2,3,4,1,1
"781",94,95,95,"white","age.gp3","NoTr","NoTrade","Group",28,4,11,5,8,4,21,3,10,18,1,27,17,11,1
"782",117,118,118,"white","age.gp3","NoTr","NoTrade","NoGroup",10,2,3,3,2,1,9,0,0,10,1,9,6,4,1
"783",156,157,157,"white","age.gp1","NoTr","NoTrade","Group",27,9,5,9,4,1,24,2,6,21,2,25,18,9,1
"784",203,204,204,"other","age.gp2","Tr","NoTrade","NoGroup",7,0,3,2,2,1,6,0,3,4,1,6,6,1,1
"785",267,268,268,"white","age.gp4","NoTr","NoTrade","NoGroup",7,0,1,3,3,2,5,0,2,5,2,5,6,1,1
"786",509,510,510,"white","age.gp2","Tr","NoTrade","NoGroup",12,1,7,3,1,1,8,3,7,5,1,11,8,4,1
"787",599,600,600,"other","age.gp4","NoTr","NoTrade","NoGroup",3,0,0,1,2,0,3,0,0,3,0,3,1,2,1
"788",1020,1021,1021,"white","age.gp2","NoTr","Trade","Group",23,4,8,7,4,3,19,1,11,12,3,20,19,4,1
"789",1051,1052,1052,"black","age.gp4","NoTr","NoTrade","NoGroup",1,0,0,1,0,0,1,0,0,1,0,1,1,0,1
"790",1088,1089,1089,"black","age.gp2","Tr","NoTrade","NoGroup",12,1,6,5,0,9,3,0,2,10,1,11,5,7,1
"791",1098,1099,1099,"white","age.gp2","NoTr","NoTrade","Group",32,3,12,12,5,0,30,2,11,21,1,31,21,11,1
"792",1627,1628,1628,"white","age.gp1","NoTr","NoTrade","NoGroup",7,4,0,3,0,0,6,1,0,7,2,5,5,2,1
"793",1746,1747,1747,"black","age.gp4","NoTr","NoTrade","NoGroup",4,0,0,2,2,2,2,0,0,4,1,3,3,1,1
"794",1790,1791,1791,"white","age.gp4","Tr","NoTrade","Group",16,0,3,4,9,3,13,0,4,12,2,14,11,5,1
"795",1842,1843,1843,"black","age.gp3","NoTr","NoTrade","NoGroup",2,0,0,2,0,1,1,0,0,2,0,2,1,1,1
"796",1874,1875,1875,"other","age.gp1","NoTr","NoTrade","Group",10,5,0,3,2,1,9,0,1,9,1,9,5,5,1
"797",1899,1900,1900,"white","age.gp1","Tr","NoTrade","NoGroup",10,8,1,1,0,0,7,3,2,8,0,10,3,7,1
"798",2059,2060,2060,"white","age.gp3","Tr","NoTrade","Group",19,2,5,6,6,5,13,1,4,15,2,17,11,8,1
"799",2387,2388,2388,"white","age.gp2","Tr","NoTrade","Group",20,2,6,9,3,1,17,2,8,12,1,19,15,5,1
"800",2693,2694,2694,"white","age.gp4","NoTr","NoTrade","Group",14,0,4,5,5,3,11,0,6,8,0,14,8,6,1
"801",2709,2710,2710,"white","age.gp4","NoTr","NoTrade","Group",11,3,1,1,6,0,11,0,2,9,1,10,8,3,1
"802",644,645,645,"other","age.gp1","NoTr","Trade","Group",15,7,0,4,4,1,14,0,5,10,2,13,10,5,1
"803",865,866,866,"other","age.gp2","Tr","NoTrade","Group",7,0,5,2,0,1,6,0,3,4,0,7,5,2,1
"804",1854,1855,1855,"white","age.gp3","NoTr","NoTrade","Group",16,3,7,3,3,1,12,3,6,10,3,13,11,5,1
"805",2065,2066,2066,"white","age.gp3","Tr","NoTrade","Group",19,3,6,4,6,2,16,1,8,11,2,17,14,5,1
"806",2519,2520,2520,"black","age.gp2","NoTr","NoTrade","Group",15,1,7,5,2,8,7,0,8,7,3,12,7,8,1
"807",2560,2561,2561,"white","age.gp4","NoTr","NoTrade","Group",17,1,2,2,12,2,14,1,7,10,2,15,13,4,1
"808",96,97,97,"white","age.gp3","NoTr","NoTrade","Group",17,0,6,6,5,3,14,0,5,12,1,16,11,6,1
"809",166,167,167,"white","age.gp3","NoTr","NoTrade","NoGroup",14,4,3,5,2,2,11,1,3,11,2,12,10,4,1
"810",417,418,418,"white","age.gp4","NoTr","NoTrade","NoGroup",6,0,2,1,3,0,6,0,1,5,0,6,6,0,1
"811",945,946,946,"white","age.gp3","Tr","NoTrade","Group",16,0,5,7,4,1,14,1,5,11,2,14,10,6,1
"812",1102,1103,1103,"black","age.gp2","NoTr","NoTrade","NoGroup",5,0,2,3,0,3,2,0,0,5,0,5,1,4,1
"813",1426,1427,1427,"white","age.gp2","Tr","NoTrade","Group",26,3,9,10,4,1,21,4,10,16,2,24,15,11,1
"814",2200,2201,2201,"white","age.gp4","NoTr","NoTrade","NoGroup",5,0,0,3,2,1,4,0,0,5,1,4,3,2,1
"815",2418,2419,2419,"white","age.gp3","NoTr","Trade","Group",17,1,7,5,4,1,14,2,6,11,2,15,13,4,1
"816",2843,2844,2844,"white","age.gp2","Tr","NoTrade","Group",20,1,9,5,5,2,16,2,7,13,0,20,13,7,1
"817",97,98,98,"white","age.gp3","NoTr","NoTrade","Group",16,1,4,5,6,3,13,0,7,9,2,14,15,1,1
"818",1409,1410,1410,"white","age.gp3","NoTr","NoTrade","Group",21,2,7,5,7,1,18,2,7,14,2,19,13,8,1
"819",1561,1562,1562,"white","age.gp4","Tr","NoTrade","Group",10,0,2,3,5,0,10,0,4,6,0,10,8,2,1
"820",1567,1568,1568,"white","age.gp4","Tr","NoTrade","Group",16,0,3,4,9,3,12,1,3,13,4,12,9,7,1
"821",1576,1577,1577,"white","age.gp4","Tr","NoTrade","Group",14,0,2,4,8,4,10,0,4,10,0,14,7,7,1
"822",1950,1951,1951,"white","age.gp4","NoTr","NoTrade","Group",11,2,0,1,8,0,11,0,2,9,1,10,6,5,1
"823",2072,2073,2073,"white","age.gp3","Tr","NoTrade","Group",15,0,5,6,4,1,14,0,4,11,3,12,12,3,1
"824",2515,2516,2516,"black","age.gp2","NoTr","NoTrade","Group",18,1,7,6,4,9,7,2,5,13,2,16,11,7,1
"825",2528,2529,2529,"white","age.gp2","NoTr","NoTrade","Group",26,1,8,12,5,4,20,2,6,20,2,24,17,9,1
"826",2849,2850,2850,"black","age.gp3","NoTr","NoTrade","Group",7,0,1,5,1,4,3,0,1,6,0,7,3,4,1
"827",2851,2852,2852,"black","age.gp3","NoTr","NoTrade","Group",10,2,3,4,1,5,5,0,2,8,0,10,8,2,1
"828",130,131,131,"white","age.gp1","NoTr","NoTrade","NoGroup",7,1,2,2,2,0,6,1,2,5,0,7,6,1,1
"829",651,652,652,"black","age.gp2","NoTr","NoTrade","NoGroup",6,0,1,3,2,1,4,1,2,4,0,6,5,1,1
"830",834,835,835,"white","age.gp3","NoTr","NoTrade","NoGroup",5,0,2,3,0,0,5,0,1,4,0,5,3,2,1
"831",866,867,867,"other","age.gp2","Tr","NoTrade","Group",11,0,3,4,4,2,9,0,3,8,0,11,7,4,1
"832",1401,1402,1402,"white","age.gp3","NoTr","NoTrade","Group",14,1,6,4,3,0,14,0,3,11,0,14,9,5,1
"833",1414,1415,1415,"black","age.gp2","NoTr","NoTrade","NoGroup",8,0,4,4,0,0,8,0,3,5,1,7,7,1,1
"834",1487,1488,1488,"white","age.gp4","NoTr","NoTrade","NoGroup",3,0,1,1,1,1,2,0,1,2,0,3,3,0,1
"835",1794,1795,1795,"white","age.gp4","Tr","NoTrade","Group",13,2,3,2,6,0,12,1,4,9,0,13,7,6,1
"836",2063,2064,2064,"white","age.gp3","Tr","NoTrade","Group",25,2,10,7,6,1,22,2,9,16,0,25,19,6,1
"837",2245,2246,2246,"white","age.gp4","Tr","NoTrade","Group",14,1,0,6,7,0,13,1,2,12,1,13,10,4,1
"838",2278,2279,2279,"other","age.gp2","Tr","NoTrade","Group",15,0,3,10,2,1,14,0,5,10,1,14,7,8,1
"839",2569,2570,2570,"white","age.gp4","NoTr","NoTrade","Group",12,0,1,5,6,0,12,0,3,9,1,11,9,3,1
"840",2760,2761,2761,"white","age.gp3","NoTr","NoTrade","NoGroup",6,0,2,2,2,0,6,0,3,3,0,6,5,1,1
"841",2778,2779,2779,"white","age.gp3","NoTr","NoTrade","Group",16,1,7,4,4,0,15,1,5,11,1,15,12,4,1
"842",99,100,100,"white","age.gp3","NoTr","NoTrade","Group",26,3,9,9,5,3,20,3,11,15,1,25,16,10,1
"843",105,106,106,"white","age.gp3","NoTr","NoTrade","Group",18,3,6,3,6,1,16,1,6,12,0,18,12,6,1
"844",244,245,245,"white","age.gp2","Tr","NoTrade","Group",24,5,7,4,8,2,18,4,6,18,1,23,15,9,1
"845",461,462,462,"white","age.gp1","NoTr","NoTrade","NoGroup",11,6,0,5,0,0,11,0,2,9,1,10,7,4,1
"846",739,740,740,"black","age.gp4","NoTr","NoTrade","NoGroup",4,0,0,1,3,2,2,0,0,4,0,4,2,2,1
"847",1238,1239,1239,"white","age.gp4","NoTr","NoTrade","NoGroup",5,0,1,2,2,1,4,0,2,3,1,4,5,0,1
"848",1283,1284,1284,"white","age.gp4","NoTr","NoTrade","Group",9,1,3,2,3,1,7,1,5,4,1,8,7,2,1
"849",1555,1556,1556,"white","age.gp3","NoTr","NoTrade","Group",25,4,9,8,4,1,19,5,9,16,2,23,18,7,1
"850",1631,1632,1632,"white","age.gp1","NoTr","NoTrade","NoGroup",6,1,1,2,2,1,5,0,0,6,1,5,3,3,1
"851",1655,1656,1656,"other","age.gp2","NoTr","NoTrade","NoGroup",6,0,3,3,0,0,6,0,3,3,0,6,5,1,1
"852",1795,1796,1796,"white","age.gp4","Tr","NoTrade","Group",9,1,1,3,4,1,8,0,2,7,0,9,5,4,1
"853",1872,1873,1873,"other","age.gp1","NoTr","NoTrade","Group",14,3,4,2,5,2,12,0,5,9,0,14,9,5,1
"854",1976,1977,1977,"white","age.gp4","Tr","NoTrade","NoGroup",1,0,0,1,0,0,1,0,0,1,0,1,1,0,1
"855",2061,2062,2062,"white","age.gp3","Tr","NoTrade","Group",21,1,9,7,4,2,18,1,5,16,1,20,13,8,1
"856",2067,2068,2068,"white","age.gp3","Tr","NoTrade","Group",15,1,5,4,5,2,11,2,2,13,0,15,14,1,1
"857",2100,2101,2101,"black","age.gp3","NoTr","NoTrade","NoGroup",6,0,1,4,1,4,2,0,1,5,2,4,4,2,1
"858",2362,2363,2363,"white","age.gp3","Tr","NoTrade","NoGroup",8,0,4,3,1,0,7,1,4,4,0,8,7,1,1
"859",2389,2390,2390,"white","age.gp2","Tr","NoTrade","Group",23,1,9,10,3,2,18,3,5,18,1,22,15,8,1
"860",2402,2403,2403,"white","age.gp3","NoTr","NoTrade","NoGroup",6,0,4,2,0,0,6,0,3,3,0,6,4,2,1
"861",2525,2526,2526,"white","age.gp2","NoTr","NoTrade","Group",15,1,7,4,3,2,12,1,1,14,1,14,10,5,1
"862",2737,2738,2738,"white","age.gp2","Tr","NoTrade","Group",29,4,15,8,2,3,23,3,13,16,2,27,20,9,1
"863",246,247,247,"white","age.gp2","Tr","NoTrade","Group",26,1,15,6,4,1,19,6,12,14,0,26,19,7,1
"864",646,647,647,"other","age.gp1","NoTr","Trade","Group",10,5,0,3,2,1,9,0,3,7,2,8,7,3,1
"865",1732,1733,1733,"white","age.gp3","Tr","NoTrade","Group",18,3,9,4,2,2,10,6,2,16,2,16,11,7,1
"866",2513,2514,2514,"white","age.gp1","NoTr","NoTrade","NoGroup",13,8,2,1,2,0,7,6,4,9,2,11,5,8,1
"867",2934,2935,2935,"white","age.gp4","NoTr","NoTrade","Group",12,0,0,3,9,2,9,1,2,10,1,11,8,4,1
"868",101,102,102,"white","age.gp3","NoTr","NoTrade","Group",14,1,6,4,3,1,13,0,2,12,0,14,9,5,1
"869",107,108,108,"white","age.gp2","NoTr","NoTrade","NoGroup",11,1,5,2,3,1,8,2,5,6,0,11,9,2,1
"870",346,347,347,"white","age.gp2","NoTr","NoTrade","Group",25,2,10,4,9,6,17,2,7,18,2,23,17,8,1
"871",1223,1224,1224,"white","age.gp4","NoTr","NoTrade","NoGroup",8,0,3,3,2,1,7,0,1,7,2,6,6,2,1
"872",1246,1247,1247,"white","age.gp1","NoTr","NoTrade","NoGroup",9,6,1,2,0,1,7,1,3,6,0,9,1,8,1
"873",1402,1403,1403,"white","age.gp3","NoTr","NoTrade","Group",21,2,6,9,4,2,19,0,10,11,1,20,14,7,1
"874",1548,1549,1549,"white","age.gp3","NoTr","NoTrade","Group",18,1,6,5,6,0,15,3,7,11,1,17,13,5,1
"875",1781,1782,1782,"white","age.gp4","Tr","NoTrade","Group",14,1,1,7,5,0,14,0,4,10,1,13,10,4,1
"876",2663,2664,2664,"white","age.gp3","NoTr","NoTrade","NoGroup",14,3,6,3,2,2,11,1,8,6,0,14,7,7,1
"877",2743,2744,2744,"white","age.gp2","NoTr","NoTrade","Group",21,2,12,3,4,1,20,0,9,12,3,18,16,5,1
"878",2776,2777,2777,"white","age.gp3","NoTr","NoTrade","Group",12,0,5,4,3,0,12,0,3,9,0,12,9,3,1
"879",2940,2941,2941,"white","age.gp4","NoTr","NoTrade","Group",7,0,3,1,3,1,5,1,3,4,0,7,5,2,1
"880",124,125,125,"white","age.gp3","NoTr","NoTrade","NoGroup",11,0,4,5,2,0,11,0,2,9,0,11,9,2,1
"881",303,304,304,"white","age.gp4","NoTr","NoTrade","Group",9,1,1,2,5,1,8,0,5,4,0,9,7,2,1
"882",328,329,329,"white","age.gp1","NoTr","NoTrade","NoGroup",7,2,1,3,1,0,6,1,3,4,0,7,2,5,1
"883",340,341,341,"white","age.gp1","NoTr","Trade","Group",21,11,5,5,0,0,12,9,10,11,4,17,12,9,1
"884",516,517,517,"black","age.gp3","NoTr","NoTrade","NoGroup",8,1,3,2,2,7,1,0,1,7,2,6,4,4,1
"885",725,726,726,"black","age.gp4","NoTr","NoTrade","NoGroup",6,0,3,2,1,3,3,0,2,4,0,6,3,3,1
"886",1850,1851,1851,"black","age.gp3","NoTr","NoTrade","NoGroup",9,1,2,4,2,4,5,0,2,7,1,8,6,3,1
"887",2113,2114,2114,"white","age.gp2","NoTr","NoTrade","NoGroup",12,2,6,4,0,1,9,2,6,6,0,12,9,3,1
"888",2328,2329,2329,"white","age.gp3","Tr","NoTrade","Group",18,4,5,7,2,4,12,2,7,11,2,16,12,6,1
"889",2529,2530,2530,"white","age.gp2","NoTr","NoTrade","Group",22,2,12,6,2,3,18,1,9,13,3,19,16,6,1
"890",2876,2877,2877,"white","age.gp1","NoTr","NoTrade","NoGroup",12,7,1,2,2,1,8,3,2,10,0,12,8,4,1
"891",232,233,233,"white","age.gp2","Tr","NoTrade","Group",19,2,8,5,4,1,17,1,8,11,1,18,16,3,1
"892",407,408,408,"white","age.gp2","Tr","Trade","Group",22,2,10,7,3,3,17,2,9,13,3,19,17,5,1
"893",659,660,660,"white","age.gp2","Tr","NoTrade","NoGroup",14,3,6,2,3,2,10,2,4,10,1,13,6,8,1
"894",661,662,662,"white","age.gp2","NoTr","NoTrade","Group",19,2,9,6,2,2,14,3,10,9,2,17,12,7,1
"895",1320,1321,1321,"white","age.gp2","Tr","NoTrade","Group",21,2,12,3,4,1,17,3,11,10,3,18,15,6,1
"896",1406,1407,1407,"white","age.gp3","NoTr","NoTrade","Group",16,1,6,6,3,0,16,0,8,8,0,16,13,3,1
"897",1611,1612,1612,"white","age.gp3","Tr","NoTrade","NoGroup",7,2,0,3,2,0,7,0,2,5,0,7,5,2,1
"898",2542,2543,2543,"other","age.gp1","NoTr","NoTrade","NoGroup",3,2,0,1,0,0,3,0,0,3,1,2,2,1,1
"899",2596,2597,2597,"white","age.gp3","NoTr","NoTrade","Group",20,5,8,3,4,0,19,1,13,7,0,20,14,6,1
"900",2862,2863,2863,"white","age.gp1","Tr","NoTrade","NoGroup",8,4,2,2,0,2,5,1,3,5,1,7,5,3,1
"901",104,105,105,"white","age.gp3","NoTr","NoTrade","Group",17,3,5,8,1,0,16,1,10,7,2,15,11,6,1
"902",187,188,188,"white","age.gp3","Tr","NoTrade","NoGroup",13,3,2,6,2,1,12,0,2,11,2,11,9,4,1
"903",886,887,887,"white","age.gp3","NoTr","Trade","Group",25,2,14,6,3,2,19,4,10,15,1,24,16,9,1
"904",1123,1124,1124,"other","age.gp1","NoTr","NoTrade","NoGroup",4,2,1,1,0,0,4,0,1,3,0,4,3,1,1
"905",1424,1425,1425,"white","age.gp2","Tr","NoTrade","Group",21,1,10,8,2,0,19,2,9,12,2,19,15,6,1
"906",1456,1457,1457,"white","age.gp1","NoTr","NoTrade","NoGroup",10,6,2,2,0,0,9,1,4,6,0,10,4,6,1
"907",1609,1610,1610,"white","age.gp3","Tr","NoTrade","NoGroup",8,1,0,4,3,0,7,1,3,5,0,8,5,3,1
"908",1805,1806,1806,"white","age.gp2","Tr","NoTrade","Group",28,5,13,5,5,1,24,3,8,20,2,26,20,8,1
"909",2121,2122,2122,"white","age.gp3","NoTr","NoTrade","Group",20,3,11,4,2,1,15,4,10,10,0,20,8,12,1
"910",2172,2173,2173,"white","age.gp2","NoTr","NoTrade","Group",18,1,8,5,4,2,16,0,5,13,1,17,14,4,1
"911",2254,2255,2255,"white","age.gp4","Tr","NoTrade","Group",12,2,0,2,8,1,11,0,4,8,0,12,7,5,1
"912",2666,2667,2667,"white","age.gp3","NoTr","NoTrade","NoGroup",9,0,3,2,4,3,6,0,3,6,1,8,8,1,1
"913",146,147,147,"white","age.gp3","NoTr","NoTrade","Group",23,3,6,9,5,1,21,1,8,15,0,23,14,9,1
"914",604,605,605,"other","age.gp4","NoTr","NoTrade","NoGroup",3,0,0,2,1,0,3,0,1,2,0,3,1,2,1
"915",683,684,684,"white","age.gp4","Tr","NoTrade","Group",7,0,1,2,4,0,6,1,4,3,0,7,7,0,1
"916",705,706,706,"white","age.gp2","NoTr","NoTrade","Group",19,1,9,4,5,3,16,0,9,10,0,19,11,8,1
"917",1806,1807,1807,"white","age.gp2","Tr","NoTrade","Group",19,2,8,5,4,2,15,2,5,14,1,18,9,10,1
"918",2058,2059,2059,"white","age.gp4","Tr","NoTrade","Group",9,1,2,2,4,1,7,1,4,5,0,9,7,2,1
"919",2252,2253,2253,"white","age.gp4","Tr","NoTrade","Group",12,1,1,6,4,0,12,0,2,10,0,12,7,5,1
"920",2311,2312,2312,"white","age.gp2","Tr","NoTrade","NoGroup",11,1,5,4,1,0,9,2,1,10,1,10,9,2,1
"921",2514,2515,2515,"white","age.gp1","NoTr","NoTrade","NoGroup",15,7,2,4,2,1,13,1,7,8,2,13,9,6,1
"922",2787,2788,2788,"white","age.gp2","NoTr","NoTrade","Group",31,2,12,12,5,1,25,5,10,21,1,30,18,13,1
"923",2941,2942,2942,"white","age.gp4","NoTr","NoTrade","Group",4,0,0,2,2,1,3,0,1,3,0,4,3,1,1
"924",106,107,107,"white","age.gp2","NoTr","NoTrade","NoGroup",11,3,5,1,2,0,10,1,7,4,1,10,5,6,1
"925",178,179,179,"white","age.gp3","Tr","NoTrade","NoGroup",7,0,6,0,1,1,3,3,2,5,0,7,2,5,1
"926",898,899,899,"other","age.gp1","Tr","NoTrade","NoGroup",3,2,1,0,0,0,2,1,0,3,0,3,1,2,1
"927",1022,1023,1023,"white","age.gp2","NoTr","Trade","Group",15,2,8,3,2,0,15,0,8,7,0,15,9,6,1
"928",1165,1166,1166,"white","age.gp4","NoTr","NoTrade","NoGroup",4,0,2,0,2,1,3,0,2,2,0,4,3,1,1
"929",1896,1897,1897,"white","age.gp1","Tr","NoTrade","NoGroup",11,8,2,0,1,0,11,0,3,8,1,10,3,8,1
"930",2305,2306,2306,"white","age.gp2","NoTr","NoTrade","NoGroup",12,1,8,2,1,3,8,1,6,6,0,12,6,6,1
"931",1205,1206,1206,"white","age.gp4","Tr","NoTrade","NoGroup",7,1,2,2,2,0,6,1,2,5,2,5,5,2,1
"932",1886,1887,1887,"other","age.gp1","NoTr","NoTrade","Group",11,4,3,2,2,0,11,0,4,7,1,10,3,8,1
"933",1961,1962,1962,"white","age.gp4","NoTr","NoTrade","Group",10,1,3,1,5,1,7,2,3,7,1,9,6,4,1
"934",1967,1968,1968,"white","age.gp4","Tr","NoTrade","NoGroup",1,0,1,0,0,0,1,0,0,1,0,1,0,1,1
"935",2476,2477,2477,"white","age.gp2","Tr","NoTrade","Group",22,3,9,6,4,3,15,4,10,12,1,21,17,5,1
"936",2772,2773,2773,"white","age.gp3","NoTr","NoTrade","Group",16,1,6,3,6,2,12,2,9,7,2,14,12,4,1
"937",108,109,109,"white","age.gp2","NoTr","NoTrade","NoGroup",7,1,1,2,3,0,7,0,1,6,0,7,6,1,1
"938",272,273,273,"white","age.gp4","NoTr","NoTrade","NoGroup",10,0,4,2,4,1,9,0,2,8,0,10,4,6,1
"939",1557,1558,1558,"white","age.gp3","NoTr","NoTrade","Group",18,3,4,5,6,0,17,1,12,6,1,17,12,6,1
"940",2562,2563,2563,"white","age.gp4","NoTr","NoTrade","Group",8,0,4,2,2,1,7,0,3,5,1,7,6,2,1
"941",109,110,110,"white","age.gp2","NoTr","NoTrade","NoGroup",7,0,3,2,2,1,4,2,2,5,0,7,3,4,1
"942",614,615,615,"other","age.gp4","NoTr","NoTrade","NoGroup",3,0,1,0,2,0,3,0,0,3,0,3,1,2,1
"943",1252,1253,1253,"white","age.gp2","Tr","NoTrade","Group",21,2,12,3,4,1,17,3,9,12,1,20,14,7,1
"944",1920,1921,1921,"other","age.gp2","NoTr","NoTrade","NoGroup",2,0,2,0,0,0,2,0,0,2,0,2,1,1,1
"945",2921,2922,2922,"white","age.gp4","NoTr","NoTrade","Group",8,0,1,1,6,0,8,0,1,7,0,8,5,3,1
"946",110,111,111,"white","age.gp2","NoTr","NoTrade","NoGroup",11,3,3,2,3,0,8,3,4,7,2,9,7,4,1
"947",219,220,220,"other","age.gp2","Tr","NoTrade","NoGroup",4,0,2,1,1,0,4,0,2,2,0,4,2,2,1
"948",329,330,330,"white","age.gp1","NoTr","NoTrade","NoGroup",7,4,3,0,0,0,6,1,4,3,0,7,4,3,1
"949",637,638,638,"other","age.gp1","NoTr","Trade","Group",11,7,2,0,2,0,11,0,6,5,0,11,6,5,1
"950",1175,1176,1176,"white","age.gp4","Tr","NoTrade","NoGroup",5,0,1,1,3,0,4,1,0,5,0,5,3,2,1
"951",1405,1406,1406,"white","age.gp3","NoTr","NoTrade","Group",18,1,9,3,5,2,15,1,9,9,1,17,12,6,1
"952",2117,2118,2118,"white","age.gp3","NoTr","NoTrade","Group",14,2,4,5,3,0,11,3,7,7,1,13,9,5,1
"953",2635,2636,2636,"white","age.gp4","NoTr","NoTrade","NoGroup",7,0,3,2,2,0,7,0,1,6,0,7,4,3,1
"954",2969,2970,2970,"white","age.gp2","NoTr","NoTrade","Group",29,3,13,8,5,2,25,2,11,18,1,28,21,8,1
"955",632,633,633,"other","age.gp1","NoTr","Trade","Group",10,5,0,5,0,2,8,0,2,8,1,9,4,6,1
"956",700,701,701,"white","age.gp4","Tr","NoTrade","Group",13,0,2,5,6,1,12,0,6,7,0,13,9,4,1
"957",1031,1032,1032,"black","age.gp4","NoTr","NoTrade","NoGroup",3,0,0,2,1,2,1,0,0,3,0,3,1,2,1
"958",1376,1377,1377,"black","age.gp2","NoTr","NoTrade","NoGroup",4,0,1,2,1,1,2,1,2,2,0,4,3,1,1
"959",2356,2357,2357,"white","age.gp3","Tr","NoTrade","NoGroup",9,0,2,5,2,0,8,1,4,5,0,9,6,3,1
"960",2420,2421,2421,"white","age.gp3","NoTr","Trade","Group",15,1,9,2,3,3,11,1,11,4,1,14,12,3,1
"961",2474,2475,2475,"white","age.gp2","Tr","NoTrade","Group",26,1,9,7,9,2,22,2,10,16,1,25,16,10,1
"962",2661,2662,2662,"white","age.gp2","NoTr","NoTrade","Group",20,2,6,9,3,3,16,1,7,13,1,19,11,9,1
"963",2958,2959,2959,"white","age.gp2","NoTr","NoTrade","Group",14,0,7,6,1,2,11,1,4,10,0,14,6,8,1
"964",112,113,113,"white","age.gp3","NoTr","NoTrade","NoGroup",10,0,3,3,4,1,9,0,2,8,2,8,7,3,1
"965",995,996,996,"white","age.gp4","NoTr","NoTrade","NoGroup",1,0,0,1,0,0,1,0,0,1,0,1,0,1,1
"966",1466,1467,1467,"white","age.gp2","NoTr","Trade","Group",23,0,12,7,4,1,21,1,10,13,2,21,16,7,1
"967",1939,1940,1940,"white","age.gp4","NoTr","NoTrade","Group",10,3,2,2,3,0,8,2,5,5,0,10,3,7,1
"968",113,114,114,"white","age.gp3","NoTr","NoTrade","NoGroup",1,1,0,0,0,0,1,0,1,0,0,1,0,1,1
"969",114,115,115,"white","age.gp3","NoTr","NoTrade","NoGroup",7,0,6,1,0,1,6,0,4,3,2,5,7,0,1
"970",660,661,661,"white","age.gp2","NoTr","NoTrade","Group",23,1,11,8,3,3,20,0,12,11,1,22,17,6,1
"971",2739,2740,2740,"white","age.gp2","Tr","NoTrade","Group",22,2,10,4,6,2,18,2,8,14,1,21,16,6,1
"972",115,116,116,"white","age.gp3","NoTr","NoTrade","NoGroup",11,0,6,3,2,1,10,0,5,6,2,9,8,3,1
"973",410,411,411,"white","age.gp2","Tr","Trade","Group",21,4,9,5,3,0,18,3,7,14,0,21,11,10,1
"974",1309,1310,1310,"white","age.gp2","Tr","NoTrade","NoGroup",15,2,4,5,4,2,12,1,2,13,2,13,9,6,1
"975",1619,1620,1620,"white","age.gp2","Tr","NoTrade","Group",18,2,11,1,4,1,15,2,7,11,2,16,13,5,1
"976",2358,2359,2359,"white","age.gp3","Tr","NoTrade","NoGroup",10,1,4,4,1,1,6,3,1,9,0,10,5,5,1
"977",2602,2603,2603,"white","age.gp3","NoTr","NoTrade","Group",17,1,10,3,3,0,16,1,7,10,1,16,14,3,1
"978",2788,2789,2789,"white","age.gp2","NoTr","NoTrade","Group",23,2,10,8,3,1,19,3,8,15,2,21,13,10,1
"979",2971,2972,2972,"white","age.gp2","NoTr","NoTrade","Group",24,0,13,6,5,1,23,0,11,13,1,23,17,7,1
"980",116,117,117,"white","age.gp3","NoTr","NoTrade","NoGroup",8,1,4,2,1,1,7,0,3,5,2,6,3,5,1
"981",511,512,512,"white","age.gp2","Tr","NoTrade","NoGroup",14,3,7,3,1,1,12,1,6,8,3,11,11,3,1
"982",816,817,817,"white","age.gp4","NoTr","NoTrade","NoGroup",6,1,1,1,3,2,4,0,2,4,0,6,2,4,1
"983",918,919,919,"white","age.gp1","NoTr","Trade","NoGroup",15,12,0,3,0,1,12,2,1,14,2,13,5,10,1
"984",1545,1546,1546,"white","age.gp2","NoTr","NoTrade","NoGroup",9,2,2,3,2,0,9,0,3,6,1,8,7,2,1
"985",1708,1709,1709,"white","age.gp2","Tr","NoTrade","Group",28,3,12,8,5,4,19,5,9,19,4,24,17,11,1
"986",2668,2669,2669,"white","age.gp3","NoTr","NoTrade","NoGroup",9,2,2,2,3,0,8,1,4,5,0,9,5,4,1
"987",1145,1146,1146,"white","age.gp4","NoTr","NoTrade","NoGroup",1,0,0,1,0,0,1,0,0,1,0,1,0,1,1
"988",1632,1633,1633,"white","age.gp1","NoTr","NoTrade","NoGroup",7,4,0,1,2,0,7,0,1,6,2,5,2,5,1
"989",2086,2087,2087,"black","age.gp3","NoTr","NoTrade","NoGroup",4,2,0,2,0,1,3,0,0,4,1,3,1,3,1
"990",2659,2660,2660,"white","age.gp2","NoTr","NoTrade","Group",21,2,8,7,4,2,18,1,6,15,2,19,14,7,1
"991",118,119,119,"white","age.gp3","NoTr","NoTrade","NoGroup",9,0,5,1,3,0,8,1,5,4,0,9,6,3,1
"992",746,747,747,"white","age.gp2","Tr","NoTrade","Group",31,2,16,11,2,2,27,2,17,14,3,28,18,13,1
"993",2304,2305,2305,"other","age.gp2","Tr","NoTrade","Group",16,1,7,5,3,2,14,0,9,7,0,16,8,8,1
"994",119,120,120,"white","age.gp3","NoTr","NoTrade","NoGroup",7,2,3,0,2,1,5,1,2,5,1,6,3,4,1
"995",1226,1227,1227,"white","age.gp4","NoTr","NoTrade","NoGroup",5,1,2,2,0,0,5,0,2,3,1,4,2,3,1
"996",1239,1240,1240,"white","age.gp2","Tr","NoTrade","NoGroup",10,2,3,5,0,0,8,2,3,7,2,8,7,3,1
"997",2465,2466,2466,"white","age.gp1","Tr","NoTrade","NoGroup",16,8,4,2,2,2,12,2,6,10,2,14,9,7,1
"998",120,121,121,"white","age.gp3","NoTr","NoTrade","NoGroup",9,0,4,3,2,2,7,0,0,9,3,6,9,0,1
"999",1056,1057,1057,"white","age.gp4","NoTr","NoTrade","Group",11,1,5,3,2,0,9,2,4,7,0,11,6,5,1
"1000",1464,1465,1465,"white","age.gp2","NoTr","Trade","Group",14,1,6,6,1,0,13,1,4,10,0,14,12,2,1
"1001",2413,2414,2414,"white","age.gp3","NoTr","Trade","Group",18,3,4,6,5,0,17,1,6,12,2,16,12,6,1
"1002",2716,2717,2717,"white","age.gp4","NoTr","NoTrade","Group",11,0,1,2,8,2,9,0,5,6,2,9,9,2,1
"1003",121,122,122,"white","age.gp3","NoTr","NoTrade","NoGroup",7,1,3,1,2,0,6,1,4,3,1,6,4,3,1
"1004",666,667,667,"white","age.gp2","Tr","NoTrade","NoGroup",9,0,4,4,1,0,9,0,3,6,0,9,6,3,1
"1005",697,698,698,"white","age.gp4","Tr","NoTrade","Group",14,1,4,2,7,1,10,3,6,8,0,14,10,4,1
"1006",1169,1170,1170,"white","age.gp4","NoTr","NoTrade","NoGroup",5,1,1,2,1,1,4,0,2,3,0,5,2,3,1
"1007",2552,2553,2553,"other","age.gp1","NoTr","NoTrade","NoGroup",4,0,1,1,2,0,4,0,2,2,0,4,3,1,1
"1008",122,123,123,"white","age.gp3","NoTr","NoTrade","NoGroup",9,1,3,2,3,1,8,0,6,3,0,9,5,4,1
"1009",512,513,513,"black","age.gp3","NoTr","NoTrade","NoGroup",5,0,0,4,1,2,3,0,0,5,1,4,3,2,1
"1010",656,657,657,"white","age.gp2","Tr","NoTrade","NoGroup",19,2,6,6,5,3,14,2,8,11,1,18,11,8,1
"1011",2253,2254,2254,"white","age.gp4","Tr","NoTrade","Group",13,2,2,3,6,1,12,0,2,11,0,13,9,4,1
"1012",2511,2512,2512,"white","age.gp1","NoTr","NoTrade","NoGroup",21,12,6,3,0,0,17,4,12,9,4,17,12,9,1
"1013",123,124,124,"white","age.gp3","NoTr","NoTrade","NoGroup",3,1,0,0,2,0,2,1,0,3,1,2,1,2,1
"1014",1964,1965,1965,"white","age.gp4","NoTr","NoTrade","Group",17,0,4,5,8,1,16,0,4,13,2,15,12,5,1
"1015",2490,2491,2491,"other","age.gp1","NoTr","NoTrade","NoGroup",7,3,2,1,1,1,6,0,1,6,0,7,1,6,1
"1016",830,831,831,"white","age.gp3","NoTr","NoTrade","NoGroup",9,2,1,3,3,1,8,0,1,8,2,7,4,5,1
"1017",1423,1424,1424,"white","age.gp2","NoTr","NoTrade","Group",21,1,11,4,5,0,19,2,12,9,0,21,14,7,1
"1018",1861,1862,1862,"white","age.gp3","NoTr","NoTrade","Group",12,0,7,3,2,1,8,3,5,7,1,11,6,6,1
"1019",2062,2063,2063,"white","age.gp3","Tr","NoTrade","Group",17,4,7,4,2,1,14,2,4,13,0,17,8,9,1
"1020",2636,2637,2637,"white","age.gp4","NoTr","NoTrade","NoGroup",1,0,0,1,0,0,1,0,0,1,0,1,0,1,1
"1021",125,126,126,"white","age.gp3","NoTr","NoTrade","NoGroup",7,0,3,3,1,0,5,2,5,2,1,6,2,5,1
"1022",201,202,202,"other","age.gp2","Tr","NoTrade","NoGroup",5,0,2,3,0,0,5,0,3,2,1,4,3,2,1
"1023",855,856,856,"other","age.gp2","Tr","NoTrade","Group",6,0,3,2,1,0,6,0,2,4,0,6,3,3,1
"1024",1432,1433,1433,"white","age.gp3","Tr","NoTrade","NoGroup",14,1,5,6,2,0,13,1,7,7,1,13,9,5,1
"1025",1674,1675,1675,"white","age.gp2","Tr","NoTrade","NoGroup",12,1,7,3,1,0,10,2,2,10,0,12,6,6,1
"1026",126,127,127,"white","age.gp1","NoTr","NoTrade","NoGroup",8,6,0,1,1,1,4,3,2,6,0,8,2,6,1
"1027",1075,1076,1076,"white","age.gp4","NoTr","NoTrade","Group",15,1,7,1,6,2,10,3,6,9,0,15,9,6,1
"1028",1462,1463,1463,"white","age.gp1","NoTr","NoTrade","NoGroup",13,6,5,0,2,0,13,0,2,11,0,13,6,7,1
"1029",1614,1615,1615,"white","age.gp3","Tr","NoTrade","NoGroup",5,2,2,1,0,0,5,0,2,3,0,5,3,2,1
"1030",1623,1624,1624,"white","age.gp1","NoTr","NoTrade","NoGroup",13,8,2,3,0,3,8,2,2,11,0,13,6,7,1
"1031",1894,1895,1895,"other","age.gp1","NoTr","NoTrade","Group",9,5,1,1,2,0,9,0,5,4,1,8,5,4,1
"1032",2539,2540,2540,"other","age.gp1","NoTr","NoTrade","NoGroup",8,3,2,1,2,0,8,0,2,6,1,7,2,6,1
"1033",2907,2908,2908,"other","age.gp1","NoTr","NoTrade","NoGroup",5,2,0,2,1,0,5,0,2,3,1,4,3,2,1
"1034",278,279,279,"white","age.gp4","NoTr","NoTrade","NoGroup",5,1,0,1,3,0,5,0,2,3,0,5,3,2,1
"1035",628,629,629,"other","age.gp1","NoTr","Trade","Group",4,2,2,0,0,0,4,0,2,2,0,4,2,2,1
"1036",787,788,788,"black","age.gp1","Tr","NoTrade","NoGroup",8,3,1,3,1,2,6,0,2,6,1,7,5,3,1
"1037",935,936,936,"white","age.gp3","NoTr","NoTrade","NoGroup",7,1,3,1,2,0,7,0,3,4,0,7,5,2,1
"1038",1895,1896,1896,"other","age.gp1","NoTr","NoTrade","Group",7,6,0,1,0,0,7,0,1,6,1,6,3,4,1
"1039",2380,2381,2381,"white","age.gp1","NoTr","NoTrade","NoGroup",9,6,2,0,1,0,8,1,2,7,2,7,5,4,1
"1040",2473,2474,2474,"white","age.gp2","Tr","NoTrade","Group",27,3,10,6,8,1,22,4,8,19,0,27,17,10,1
"1041",2919,2920,2920,"white","age.gp1","NoTr","NoTrade","NoGroup",11,7,1,3,0,3,6,2,4,7,4,7,5,6,1
"1042",128,129,129,"white","age.gp1","NoTr","NoTrade","NoGroup",17,8,3,1,5,2,12,3,5,12,4,13,9,8,1
"1043",135,136,136,"white","age.gp2","NoTr","NoTrade","NoGroup",6,1,1,2,2,0,5,1,2,4,0,6,3,3,1
"1044",408,409,409,"white","age.gp2","Tr","Trade","Group",24,3,15,3,3,2,19,3,10,14,0,24,14,10,1
"1045",633,634,634,"other","age.gp1","NoTr","Trade","Group",9,3,3,2,1,0,8,1,4,5,0,9,4,5,1
"1046",751,752,752,"white","age.gp4","NoTr","NoTrade","NoGroup",6,1,2,0,3,1,5,0,2,4,0,6,2,4,1
"1047",917,918,918,"white","age.gp1","NoTr","Trade","NoGroup",10,2,1,4,3,1,9,0,4,6,0,10,3,7,1
"1048",1181,1182,1182,"white","age.gp4","Tr","NoTrade","NoGroup",4,1,1,0,2,0,3,1,2,2,0,4,2,2,1
"1049",1668,1669,1669,"black","age.gp1","Tr","Trade","Group",15,7,4,3,1,6,8,1,4,11,1,14,5,10,1
"1050",1742,1743,1743,"black","age.gp4","NoTr","NoTrade","NoGroup",11,1,5,2,3,6,5,0,3,8,0,11,5,6,1
"1051",1883,1884,1884,"other","age.gp1","NoTr","NoTrade","Group",7,3,3,1,0,0,7,0,4,3,2,5,3,4,1
"1052",2070,2071,2071,"white","age.gp3","Tr","NoTrade","Group",22,3,7,8,4,3,18,1,9,13,1,21,10,12,1
"1053",2180,2181,2181,"white","age.gp4","NoTr","NoTrade","NoGroup",3,1,0,0,2,0,3,0,1,2,0,3,1,2,1
"1054",2249,2250,2250,"white","age.gp4","Tr","NoTrade","Group",13,1,0,6,6,0,13,0,4,9,1,12,10,3,1
"1055",2888,2889,2889,"other","age.gp1","NoTr","NoTrade","NoGroup",2,1,1,0,0,0,2,0,0,2,0,2,1,1,1
"1056",129,130,130,"white","age.gp1","NoTr","NoTrade","NoGroup",5,2,2,1,0,0,3,2,3,2,0,5,2,3,1
"1057",853,854,854,"other","age.gp2","Tr","NoTrade","Group",13,2,4,2,5,2,11,0,3,10,1,12,8,5,1
"1058",1618,1619,1619,"white","age.gp2","Tr","NoTrade","Group",23,4,14,4,1,2,19,2,10,13,1,22,12,11,1
"1059",1712,1713,1713,"white","age.gp1","Tr","NoTrade","NoGroup",13,5,1,4,3,2,8,3,1,12,2,11,8,5,1
"1060",2897,2898,2898,"other","age.gp1","NoTr","NoTrade","NoGroup",6,4,1,1,0,0,6,0,2,4,0,6,4,2,1
"1061",460,461,461,"white","age.gp1","NoTr","NoTrade","NoGroup",14,4,2,3,5,1,11,2,5,9,3,11,9,5,1
"1062",1083,1084,1084,"white","age.gp4","NoTr","NoTrade","Group",17,2,4,1,10,0,15,2,6,11,0,17,13,4,1
"1063",1621,1622,1622,"white","age.gp2","Tr","NoTrade","Group",25,3,14,5,3,3,19,3,9,16,2,23,18,7,1
"1064",2700,2701,2701,"white","age.gp4","NoTr","NoTrade","Group",11,2,4,1,4,1,9,1,5,6,2,9,8,3,1
"1065",131,132,132,"white","age.gp2","NoTr","NoTrade","NoGroup",11,0,6,4,1,2,8,1,5,6,0,11,5,6,1
"1066",152,153,153,"white","age.gp3","NoTr","NoTrade","Group",17,2,9,4,2,1,15,1,5,12,2,15,13,4,1
"1067",192,193,193,"white","age.gp2","Tr","NoTrade","NoGroup",14,0,9,1,4,0,11,3,7,7,0,14,7,7,1
"1068",281,282,282,"white","age.gp2","Tr","NoTrade","Group",23,1,14,5,3,3,16,4,9,14,3,20,17,6,1
"1069",1604,1605,1605,"white","age.gp3","Tr","NoTrade","NoGroup",8,1,4,1,2,1,7,0,3,5,1,7,4,4,1
"1070",1767,1768,1768,"black","age.gp4","NoTr","NoTrade","NoGroup",1,0,1,0,0,0,1,0,0,1,0,1,0,1,1
"1071",2111,2112,2112,"white","age.gp2","NoTr","NoTrade","NoGroup",8,2,4,1,1,1,5,2,2,6,0,8,3,5,1
"1072",2342,2343,2343,"white","age.gp2","Tr","NoTrade","Group",20,2,9,8,1,3,14,3,7,13,2,18,13,7,1
"1073",2603,2604,2604,"white","age.gp3","NoTr","NoTrade","Group",20,2,9,5,4,2,17,1,8,12,2,18,13,7,1
"1074",2682,2683,2683,"black","age.gp3","NoTr","NoTrade","NoGroup",6,1,2,2,1,4,2,0,0,6,2,4,2,4,1
"1075",132,133,133,"white","age.gp2","NoTr","NoTrade","NoGroup",11,2,6,2,1,0,8,3,6,5,3,8,8,3,1
"1076",198,199,199,"other","age.gp2","Tr","NoTrade","NoGroup",4,0,3,1,0,1,3,0,2,2,1,3,2,2,1
"1077",880,881,881,"white","age.gp3","NoTr","Trade","Group",14,2,4,5,3,0,14,0,9,5,1,13,9,5,1
"1078",1257,1258,1258,"white","age.gp1","Tr","Trade","Group",18,8,6,1,3,1,16,1,7,11,1,17,10,8,1
"1079",2156,2157,2157,"other","age.gp2","NoTr","NoTrade","NoGroup",5,0,4,1,0,0,5,0,2,3,0,5,2,3,1
"1080",2302,2303,2303,"other","age.gp2","Tr","NoTrade","Group",13,1,7,3,2,4,9,0,2,11,0,13,10,3,1
"1081",2462,2463,2463,"white","age.gp1","Tr","NoTrade","NoGroup",11,4,4,1,2,2,7,2,3,8,1,10,3,8,1
"1082",2571,2572,2572,"white","age.gp4","NoTr","NoTrade","Group",13,2,4,0,7,1,12,0,6,7,2,11,9,4,1
"1083",133,134,134,"white","age.gp2","NoTr","NoTrade","NoGroup",9,0,6,3,0,1,8,0,4,5,1,8,5,4,1
"1084",711,712,712,"white","age.gp2","Tr","NoTrade","Group",25,2,11,5,7,2,21,2,10,15,2,23,17,8,1
"1085",843,844,844,"white","age.gp2","Tr","NoTrade","NoGroup",10,0,5,2,3,0,10,0,5,5,0,10,5,5,1
"1086",1261,1262,1262,"black","age.gp3","NoTr","NoTrade","NoGroup",7,0,4,0,3,1,6,0,2,5,0,7,3,4,1
"1087",2306,2307,2307,"white","age.gp2","NoTr","NoTrade","NoGroup",6,1,4,1,0,0,6,0,4,2,0,6,3,3,1
"1088",2792,2793,2793,"white","age.gp2","Tr","NoTrade","NoGroup",15,1,9,2,3,1,11,3,6,9,2,13,10,5,1
"1089",134,135,135,"white","age.gp2","NoTr","NoTrade","NoGroup",7,1,3,2,1,0,6,1,2,5,1,6,5,2,1
"1090",1339,1340,1340,"white","age.gp3","NoTr","NoTrade","NoGroup",10,0,6,2,2,0,9,1,4,6,0,10,8,2,1
"1091",2550,2551,2551,"other","age.gp1","NoTr","NoTrade","NoGroup",6,1,1,1,3,1,5,0,0,6,0,6,4,2,1
"1092",813,814,814,"white","age.gp4","NoTr","NoTrade","NoGroup",5,0,3,0,2,0,4,1,2,3,0,5,3,2,1
"1093",982,983,983,"white","age.gp4","NoTr","NoTrade","NoGroup",3,0,1,0,2,0,3,0,0,3,0,3,2,1,1
"1094",2300,2301,2301,"other","age.gp2","Tr","NoTrade","Group",9,1,2,3,3,1,8,0,1,8,1,8,5,4,1
"1095",136,137,137,"white","age.gp2","NoTr","NoTrade","NoGroup",9,0,4,3,2,0,9,0,4,5,0,9,6,3,1
"1096",245,246,246,"white","age.gp2","Tr","NoTrade","Group",27,1,12,9,5,4,22,1,9,18,2,25,16,11,1
"1097",310,311,311,"white","age.gp4","NoTr","NoTrade","Group",9,1,3,2,3,1,8,0,3,6,0,9,5,4,1
"1098",703,704,704,"white","age.gp2","NoTr","NoTrade","Group",17,0,10,6,1,1,14,2,8,9,2,15,12,5,1
"1099",1251,1252,1252,"white","age.gp2","Tr","NoTrade","Group",23,4,12,5,2,3,18,2,11,12,0,23,13,10,1
"1100",1605,1606,1606,"white","age.gp3","Tr","NoTrade","NoGroup",6,2,3,0,1,0,5,1,0,6,0,6,3,3,1
"1101",2434,2435,2435,"white","age.gp4","NoTr","NoTrade","NoGroup",4,0,1,0,3,0,4,0,2,2,0,4,2,2,1
"1102",315,316,316,"white","age.gp4","NoTr","NoTrade","Group",10,0,1,3,6,1,9,0,3,7,0,10,5,5,1
"1103",689,690,690,"white","age.gp4","Tr","NoTrade","Group",10,1,3,2,4,0,10,0,3,7,1,9,6,4,1
"1104",1019,1020,1020,"white","age.gp2","NoTr","Trade","Group",19,2,8,7,2,2,16,1,7,12,3,16,14,5,1
"1105",1300,1301,1301,"white","age.gp4","NoTr","NoTrade","Group",8,1,2,2,3,0,7,1,1,7,0,8,3,5,1
"1106",1571,1572,1572,"white","age.gp4","Tr","NoTrade","Group",10,0,3,2,5,1,9,0,4,6,1,9,6,4,1
"1107",1577,1578,1578,"white","age.gp4","Tr","NoTrade","Group",10,1,2,2,5,2,7,1,1,9,1,9,3,7,1
"1108",1581,1582,1582,"white","age.gp4","Tr","NoTrade","Group",9,1,2,1,5,0,9,0,4,5,1,8,5,4,1
"1109",1629,1630,1630,"white","age.gp1","NoTr","NoTrade","NoGroup",18,9,7,2,0,2,12,4,6,12,3,15,11,7,1
"1110",2409,2410,2410,"white","age.gp3","NoTr","NoTrade","NoGroup",11,1,5,2,3,0,10,1,6,5,0,11,9,2,1
"1111",2962,2963,2963,"white","age.gp2","NoTr","NoTrade","Group",15,2,9,2,2,0,13,2,5,10,2,13,13,2,1
"1112",138,139,139,"white","age.gp2","NoTr","NoTrade","NoGroup",6,0,2,4,0,0,6,0,5,1,0,6,3,3,1
"1113",161,162,162,"white","age.gp3","NoTr","NoTrade","NoGroup",7,0,3,1,3,2,4,1,2,5,0,7,2,5,1
"1114",1731,1732,1732,"white","age.gp3","Tr","NoTrade","Group",17,3,6,2,6,2,12,3,3,14,2,15,9,8,1
"1115",2353,2354,2354,"white","age.gp3","Tr","NoTrade","NoGroup",12,0,8,3,1,0,10,2,6,6,0,12,5,7,1
"1116",2361,2362,2362,"white","age.gp3","Tr","NoTrade","NoGroup",9,1,4,2,2,0,7,2,2,7,1,8,6,3,1
"1117",139,140,140,"white","age.gp2","NoTr","NoTrade","NoGroup",8,1,2,4,1,0,7,1,2,6,0,8,5,3,1
"1118",1444,1445,1445,"white","age.gp1","NoTr","NoTrade","NoGroup",10,9,1,0,0,1,6,3,7,3,3,7,5,5,1
"1119",2296,2297,2297,"other","age.gp2","Tr","NoTrade","Group",12,0,8,2,2,1,11,0,4,8,1,11,8,4,1
"1120",2399,2400,2400,"white","age.gp3","NoTr","NoTrade","NoGroup",9,1,1,5,2,1,7,1,3,6,0,9,2,7,1
"1121",654,655,655,"black","age.gp2","NoTr","NoTrade","NoGroup",8,1,3,2,2,6,2,0,1,7,0,8,2,6,1
"1122",1752,1753,1753,"black","age.gp4","NoTr","NoTrade","NoGroup",1,0,1,0,0,0,1,0,0,1,0,1,0,1,1
"1123",149,150,150,"white","age.gp3","NoTr","NoTrade","Group",23,7,6,6,4,0,21,2,8,15,2,21,18,5,1
"1124",324,325,325,"white","age.gp4","NoTr","NoTrade","Group",9,0,1,2,6,2,7,0,1,8,0,9,4,5,1
"1125",877,878,878,"white","age.gp3","NoTr","Trade","Group",13,2,3,6,2,1,10,2,5,8,0,13,7,6,1
"1126",1120,1121,1121,"other","age.gp1","NoTr","NoTrade","NoGroup",5,2,1,1,1,0,5,0,1,4,1,4,4,1,1
"1127",1613,1614,1614,"white","age.gp3","Tr","NoTrade","NoGroup",12,2,3,6,1,1,9,2,2,10,2,10,9,3,1
"1128",2119,2120,2120,"white","age.gp3","NoTr","NoTrade","Group",9,1,1,3,4,0,9,0,3,6,0,9,7,2,1
"1129",2785,2786,2786,"white","age.gp3","NoTr","NoTrade","Group",17,2,5,7,3,1,15,1,8,9,3,14,11,6,1
"1130",153,154,154,"white","age.gp3","NoTr","NoTrade","Group",20,2,4,7,7,4,16,0,5,15,2,18,12,8,1
"1131",667,668,668,"white","age.gp2","Tr","NoTrade","NoGroup",13,1,5,4,3,1,12,0,3,10,0,13,6,7,1
"1132",704,705,705,"white","age.gp2","NoTr","NoTrade","Group",12,2,3,6,1,2,10,0,6,6,0,12,7,5,1
"1133",771,772,772,"white","age.gp4","NoTr","NoTrade","NoGroup",3,0,0,1,2,0,3,0,2,1,0,3,3,0,1
"1134",883,884,884,"white","age.gp3","NoTr","Trade","Group",10,2,2,3,3,1,9,0,3,7,0,10,6,4,1
"1135",1073,1074,1074,"white","age.gp4","NoTr","NoTrade","Group",12,1,1,5,5,3,9,0,2,10,1,11,7,5,1
"1136",1864,1865,1865,"white","age.gp3","NoTr","NoTrade","Group",24,3,4,10,7,1,19,4,8,16,3,21,13,11,1
"1137",1917,1918,1918,"other","age.gp2","NoTr","NoTrade","NoGroup",8,0,3,5,0,0,8,0,4,4,0,8,7,1,1
"1138",2128,2129,2129,"white","age.gp3","NoTr","NoTrade","Group",19,2,7,8,2,1,16,2,12,7,1,18,15,4,1
"1139",2162,2163,2163,"white","age.gp2","Tr","NoTrade","NoGroup",16,4,4,3,5,1,13,2,5,11,1,15,11,5,1
"1140",2343,2344,2344,"white","age.gp2","Tr","NoTrade","Group",27,3,13,7,4,1,18,8,10,17,3,24,19,8,1
"1141",2383,2384,2384,"white","age.gp1","NoTr","NoTrade","NoGroup",8,2,3,3,0,1,5,2,3,5,3,5,6,2,1
"1142",2650,2651,2651,"white","age.gp2","NoTr","NoTrade","Group",23,3,11,4,5,0,20,3,12,11,4,19,16,7,1
"1143",2786,2787,2787,"white","age.gp3","NoTr","NoTrade","Group",14,1,5,4,4,0,12,2,9,5,0,14,12,2,1
"1144",2839,2840,2840,"white","age.gp2","Tr","NoTrade","Group",27,1,11,8,7,1,25,1,12,15,0,27,21,6,1
"1145",235,236,236,"white","age.gp2","Tr","NoTrade","Group",22,2,7,8,5,2,17,3,3,19,1,21,11,11,1
"1146",921,922,922,"white","age.gp2","NoTr","NoTrade","NoGroup",8,0,3,4,1,1,7,0,5,3,0,8,5,3,1
"1147",1559,1560,1560,"white","age.gp3","NoTr","NoTrade","Group",16,3,5,6,2,0,14,2,7,9,2,14,12,4,1
"1148",1584,1585,1585,"white","age.gp4","Tr","NoTrade","Group",13,0,2,2,9,1,12,0,5,8,2,11,12,1,1
"1149",1785,1786,1786,"white","age.gp4","Tr","NoTrade","Group",5,1,0,3,1,1,4,0,3,2,0,5,3,2,1
"1150",2001,2002,2002,"black","age.gp4","NoTr","NoTrade","NoGroup",5,1,0,2,2,2,3,0,0,5,0,5,2,3,1
"1151",2309,2310,2310,"white","age.gp2","NoTr","NoTrade","NoGroup",18,2,10,3,3,1,13,4,10,8,1,17,11,7,1
"1152",2589,2590,2590,"white","age.gp4","NoTr","NoTrade","Group",12,0,4,2,6,2,10,0,5,7,0,12,7,5,1
"1153",144,145,145,"white","age.gp3","NoTr","NoTrade","Group",20,2,7,5,6,2,16,2,6,14,1,19,9,11,1
"1154",427,428,428,"white","age.gp4","NoTr","NoTrade","NoGroup",8,0,5,1,2,0,8,0,6,2,0,8,7,1,1
"1155",490,491,491,"black","age.gp4","NoTr","NoTrade","NoGroup",4,0,1,1,2,1,2,1,0,4,0,4,2,2,1
"1156",792,793,793,"white","age.gp4","NoTr","NoTrade","NoGroup",5,0,2,2,1,0,5,0,2,3,0,5,5,0,1
"1157",850,851,851,"other","age.gp2","Tr","NoTrade","Group",14,2,7,5,0,3,11,0,5,9,0,14,9,5,1
"1158",980,981,981,"white","age.gp4","NoTr","NoTrade","NoGroup",1,0,0,1,0,0,1,0,0,1,0,1,1,0,1
"1159",1599,1600,1600,"white","age.gp2","Tr","NoTrade","NoGroup",15,0,7,7,1,1,13,1,8,7,1,14,10,5,1
"1160",1634,1635,1635,"black","age.gp1","Tr","NoTrade","NoGroup",4,2,1,1,0,3,1,0,0,4,1,3,2,2,1
"1161",1788,1789,1789,"white","age.gp4","Tr","NoTrade","Group",7,0,2,1,4,0,7,0,3,4,0,7,6,1,1
"1162",2308,2309,2309,"white","age.gp2","NoTr","NoTrade","NoGroup",15,3,6,5,1,1,12,2,5,10,0,15,10,5,1
"1163",2316,2317,2317,"white","age.gp2","NoTr","NoTrade","NoGroup",5,0,3,1,1,0,5,0,3,2,0,5,5,0,1
"1164",2494,2495,2495,"other","age.gp1","NoTr","NoTrade","NoGroup",5,1,0,3,1,0,5,0,1,4,1,4,3,2,1
"1165",640,641,641,"other","age.gp1","NoTr","Trade","Group",7,1,3,2,1,1,6,0,4,3,1,6,4,3,1
"1166",1461,1462,1462,"white","age.gp1","NoTr","NoTrade","NoGroup",8,3,1,2,2,0,6,2,2,6,0,8,5,3,1
"1167",1690,1691,1691,"white","age.gp4","NoTr","Trade","NoGroup",9,1,2,2,4,2,7,0,5,4,0,9,4,5,1
"1168",1783,1784,1784,"white","age.gp4","Tr","NoTrade","Group",10,3,0,2,5,0,9,1,4,6,1,9,7,3,1
"1169",2033,2034,2034,"white","age.gp4","Tr","NoTrade","Group",8,0,1,2,5,0,7,1,2,6,2,6,6,2,1
"1170",2293,2294,2294,"other","age.gp2","Tr","NoTrade","Group",12,0,3,5,4,1,11,0,3,9,1,11,8,4,1
"1171",2377,2378,2378,"white","age.gp2","NoTr","NoTrade","NoGroup",12,1,6,4,1,0,12,0,6,6,0,12,9,3,1
"1172",2388,2389,2389,"white","age.gp2","Tr","NoTrade","Group",29,3,14,9,3,6,22,1,9,20,1,28,21,8,1
"1173",2592,2593,2593,"white","age.gp3","NoTr","NoTrade","Group",21,1,9,7,4,0,18,3,11,10,1,20,17,4,1
"1174",2966,2967,2967,"white","age.gp2","NoTr","NoTrade","NoGroup",12,0,7,4,1,0,12,0,4,8,1,11,12,0,1
"1175",242,243,243,"white","age.gp2","Tr","NoTrade","Group",17,1,8,4,4,2,13,2,7,10,4,13,13,4,1
"1176",412,413,413,"white","age.gp4","NoTr","NoTrade","NoGroup",3,0,2,1,0,1,1,1,2,1,1,2,2,1,1
"1177",933,934,934,"white","age.gp3","NoTr","NoTrade","NoGroup",8,0,5,3,0,1,7,0,3,5,2,6,6,2,1
"1178",943,944,944,"white","age.gp3","Tr","NoTrade","Group",24,1,6,9,8,3,19,2,8,16,1,23,15,9,1
"1179",990,991,991,"white","age.gp4","NoTr","NoTrade","NoGroup",1,0,0,1,0,0,1,0,0,1,0,1,1,0,1
"1180",2333,2334,2334,"white","age.gp3","Tr","NoTrade","Group",15,4,4,4,3,0,13,2,4,11,2,13,9,6,1
"1181",2370,2371,2371,"black","age.gp2","NoTr","NoTrade","NoGroup",8,0,1,4,3,5,3,0,1,7,2,6,5,3,1
"1182",2527,2528,2528,"white","age.gp2","NoTr","NoTrade","Group",27,2,12,9,4,1,23,3,13,14,2,25,19,8,1
"1183",2860,2861,2861,"white","age.gp1","Tr","NoTrade","NoGroup",8,3,1,4,0,0,7,1,2,6,1,7,5,3,1
"1184",2908,2909,2909,"other","age.gp1","NoTr","NoTrade","NoGroup",5,1,1,1,2,1,4,0,4,1,0,5,3,2,1
"1185",2957,2958,2958,"white","age.gp2","Tr","NoTrade","Group",36,5,14,8,9,3,24,9,12,24,4,32,24,12,1
"1186",147,148,148,"white","age.gp3","NoTr","NoTrade","Group",25,2,8,8,7,1,22,2,11,14,2,23,14,11,1
"1187",154,155,155,"white","age.gp3","NoTr","NoTrade","Group",18,3,4,6,5,2,13,3,6,12,1,17,10,8,1
"1188",189,190,190,"white","age.gp3","Tr","NoTrade","NoGroup",11,2,5,4,0,0,7,4,6,5,1,10,7,4,1
"1189",331,332,332,"white","age.gp1","NoTr","NoTrade","NoGroup",10,4,2,3,1,0,8,2,5,5,1,9,8,2,1
"1190",668,669,669,"white","age.gp2","Tr","NoTrade","NoGroup",12,0,9,3,0,2,10,0,7,5,1,11,9,3,1
"1191",794,795,795,"white","age.gp4","NoTr","NoTrade","NoGroup",3,1,1,1,0,0,1,2,1,2,0,3,2,1,1
"1192",1054,1055,1055,"white","age.gp4","NoTr","NoTrade","Group",10,2,1,4,3,2,6,2,0,10,1,9,5,5,1
"1193",1191,1192,1192,"white","age.gp4","Tr","NoTrade","NoGroup",3,0,0,2,1,0,3,0,0,3,1,2,2,1,1
"1194",1271,1272,1272,"black","age.gp3","NoTr","NoTrade","NoGroup",7,1,2,3,1,3,4,0,0,7,1,6,4,3,1
"1195",1463,1464,1464,"white","age.gp1","NoTr","NoTrade","NoGroup",14,6,2,4,2,1,12,1,4,10,0,14,6,8,1
"1196",1468,1469,1469,"white","age.gp2","NoTr","Trade","Group",24,1,10,8,5,2,22,0,12,12,1,23,22,2,1
"1197",1602,1603,1603,"white","age.gp2","Tr","NoTrade","NoGroup",16,0,8,5,3,1,14,1,8,8,0,16,10,6,1
"1198",1853,1854,1854,"white","age.gp3","NoTr","NoTrade","Group",24,3,9,5,7,2,22,0,14,10,1,23,16,8,1
"1199",1866,1867,1867,"white","age.gp3","NoTr","NoTrade","Group",21,5,6,8,2,1,14,6,11,10,3,18,14,7,1
"1200",1985,1986,1986,"white","age.gp4","Tr","NoTrade","NoGroup",5,1,1,2,1,0,4,1,1,4,0,5,5,0,1
"1201",2030,2031,2031,"white","age.gp4","Tr","NoTrade","Group",11,1,2,3,5,1,10,0,6,5,0,11,9,2,1
"1202",2125,2126,2126,"white","age.gp3","NoTr","NoTrade","Group",13,0,5,7,1,1,11,1,5,8,0,13,9,4,1
"1203",2188,2189,2189,"white","age.gp4","NoTr","NoTrade","NoGroup",5,0,1,3,1,2,3,0,2,3,0,5,5,0,1
"1204",2793,2794,2794,"white","age.gp2","Tr","NoTrade","NoGroup",10,1,5,2,2,2,7,1,4,6,0,10,6,4,1
"1205",677,678,678,"white","age.gp4","Tr","NoTrade","Group",11,1,2,2,6,0,11,0,2,9,0,11,8,3,1
"1206",861,862,862,"other","age.gp2","Tr","NoTrade","Group",10,0,5,2,3,3,7,0,1,9,2,8,8,2,1
"1207",1797,1798,1798,"white","age.gp4","Tr","NoTrade","Group",12,2,2,3,5,0,10,2,3,9,0,12,9,3,1
"1208",1898,1899,1899,"white","age.gp1","Tr","NoTrade","NoGroup",8,3,0,2,3,0,8,0,4,4,0,8,4,4,1
"1209",1953,1954,1954,"white","age.gp4","NoTr","NoTrade","Group",16,1,3,4,8,2,14,0,5,11,1,15,12,4,1
"1210",2047,2048,2048,"white","age.gp4","Tr","NoTrade","Group",7,2,0,2,3,1,6,0,0,7,0,7,5,2,1
"1211",2440,2441,2441,"white","age.gp4","NoTr","NoTrade","NoGroup",7,0,1,1,5,0,6,1,2,5,0,7,5,2,1
"1212",181,182,182,"white","age.gp3","Tr","NoTrade","NoGroup",7,0,2,3,2,0,6,1,3,4,0,7,5,2,1
"1213",636,637,637,"other","age.gp1","NoTr","Trade","Group",8,2,1,4,1,1,7,0,1,7,0,8,4,4,1
"1214",1301,1302,1302,"white","age.gp4","NoTr","NoTrade","Group",16,0,5,8,3,3,12,1,7,9,1,15,12,4,1
"1215",1304,1305,1305,"white","age.gp4","NoTr","NoTrade","Group",13,0,4,2,7,1,12,0,9,4,0,13,10,3,1
"1216",1308,1309,1309,"white","age.gp2","Tr","NoTrade","NoGroup",14,2,7,4,1,1,11,2,3,11,1,13,12,2,1
"1217",1715,1716,1716,"white","age.gp1","Tr","NoTrade","NoGroup",13,9,1,2,1,0,9,4,2,11,5,8,6,7,1
"1218",1717,1718,1718,"white","age.gp2","NoTr","NoTrade","Group",20,1,9,8,2,1,16,3,8,12,0,20,15,5,1
"1219",1733,1734,1734,"white","age.gp3","Tr","NoTrade","Group",14,1,3,7,3,1,12,1,5,9,1,13,9,5,1
"1220",1860,1861,1861,"white","age.gp3","NoTr","NoTrade","Group",11,1,2,6,2,2,9,0,6,5,0,11,5,6,1
"1221",1893,1894,1894,"other","age.gp1","NoTr","NoTrade","Group",8,3,1,2,2,0,8,0,6,2,0,8,5,3,1
"1222",2645,2646,2646,"white","age.gp1","NoTr","NoTrade","NoGroup",13,5,2,5,1,0,11,2,5,8,1,12,9,4,1
"1223",150,151,151,"white","age.gp3","NoTr","NoTrade","Group",12,0,5,4,3,2,8,2,6,6,0,12,7,5,1
"1224",208,209,209,"other","age.gp2","Tr","NoTrade","NoGroup",4,0,2,1,1,1,3,0,0,4,0,4,2,2,1
"1225",745,746,746,"white","age.gp2","Tr","NoTrade","Group",24,4,11,7,2,2,16,6,7,17,3,21,13,11,1
"1226",2092,2093,2093,"black","age.gp3","NoTr","NoTrade","NoGroup",5,0,2,2,1,3,2,0,1,4,1,4,3,2,1
"1227",2814,2815,2815,"other","age.gp2","NoTr","NoTrade","NoGroup",5,0,1,3,1,1,4,0,1,4,0,5,3,2,1
"1228",151,152,152,"white","age.gp3","NoTr","NoTrade","Group",11,2,6,0,3,1,9,1,5,6,1,10,10,1,1
"1229",693,694,694,"white","age.gp4","Tr","NoTrade","Group",11,0,4,3,4,0,9,2,4,7,0,11,9,2,1
"1230",838,839,839,"white","age.gp2","NoTr","NoTrade","Group",24,0,16,5,3,2,18,4,10,14,1,23,19,5,1
"1231",847,848,848,"other","age.gp2","Tr","NoTrade","Group",7,0,5,2,0,2,5,0,1,6,0,7,5,2,1
"1232",2324,2325,2325,"white","age.gp1","NoTr","NoTrade","NoGroup",17,8,3,3,3,2,12,3,6,11,3,14,10,7,1
"1233",2344,2345,2345,"white","age.gp2","Tr","NoTrade","Group",26,3,9,9,5,3,20,3,7,19,3,23,17,9,1
"1234",311,312,312,"white","age.gp4","NoTr","NoTrade","Group",7,1,0,1,5,1,4,2,1,6,0,7,4,3,1
"1235",664,665,665,"white","age.gp2","NoTr","NoTrade","Group",19,4,7,3,5,0,18,1,5,14,1,18,14,5,1
"1236",669,670,670,"white","age.gp2","Tr","NoTrade","NoGroup",14,1,9,4,0,3,10,1,3,11,1,13,9,5,1
"1237",1275,1276,1276,"white","age.gp4","NoTr","NoTrade","Group",15,2,1,3,9,0,13,2,5,10,1,14,13,2,1
"1238",2422,2423,2423,"white","age.gp3","NoTr","Trade","Group",13,0,7,3,3,2,11,0,3,10,1,12,10,3,1
"1239",391,392,392,"black","age.gp4","NoTr","NoTrade","NoGroup",1,0,0,1,0,0,1,0,0,1,0,1,1,0,1
"1240",728,729,729,"black","age.gp4","NoTr","NoTrade","NoGroup",5,0,0,3,2,1,4,0,0,5,1,4,3,2,1
"1241",979,980,980,"white","age.gp4","NoTr","NoTrade","NoGroup",10,1,2,3,4,0,8,2,2,8,0,10,9,1,1
"1242",994,995,995,"white","age.gp4","NoTr","NoTrade","NoGroup",5,2,0,2,1,0,5,0,3,2,1,4,4,1,1
"1243",1138,1139,1139,"white","age.gp1","NoTr","NoTrade","NoGroup",14,7,5,1,1,2,9,3,4,10,1,13,9,5,1
"1244",2221,2222,2222,"black","age.gp4","NoTr","Trade","Group",12,2,2,3,5,4,7,1,4,8,1,11,8,4,1
"1245",2859,2860,2860,"white","age.gp1","Tr","NoTrade","NoGroup",13,7,1,5,0,3,8,2,1,12,2,11,8,5,1
"1246",2954,2955,2955,"white","age.gp2","Tr","NoTrade","Group",24,2,10,9,3,2,22,0,7,17,0,24,16,8,1
"1247",196,197,197,"other","age.gp2","Tr","NoTrade","NoGroup",2,0,0,2,0,0,2,0,0,2,0,2,1,1,1
"1248",197,198,198,"other","age.gp2","Tr","NoTrade","NoGroup",10,1,4,4,1,1,9,0,3,7,0,10,7,3,1
"1249",1004,1005,1005,"white","age.gp1","Tr","NoTrade","Group",26,14,5,4,3,4,15,7,5,21,1,25,9,17,1
"1250",1211,1212,1212,"white","age.gp4","NoTr","NoTrade","NoGroup",15,0,3,3,9,1,13,1,7,8,1,14,12,3,1
"1251",1399,1400,1400,"white","age.gp3","NoTr","NoTrade","Group",21,3,6,7,5,3,17,1,5,16,3,18,12,9,1
"1252",1543,1544,1544,"white","age.gp2","NoTr","NoTrade","NoGroup",9,3,2,2,2,0,7,2,4,5,0,9,4,5,1
"1253",1546,1547,1547,"white","age.gp3","NoTr","NoTrade","Group",16,0,5,7,4,0,16,0,7,9,0,16,13,3,1
"1254",1684,1685,1685,"white","age.gp4","NoTr","Trade","NoGroup",1,0,0,1,0,0,1,0,0,1,0,1,1,0,1
"1255",2704,2705,2705,"white","age.gp4","NoTr","NoTrade","Group",12,1,2,2,7,2,9,1,5,7,0,12,7,5,1
"1256",2893,2894,2894,"other","age.gp1","NoTr","NoTrade","NoGroup",4,1,1,1,1,1,3,0,1,3,1,3,2,2,1
"1257",155,156,156,"white","age.gp3","NoTr","NoTrade","Group",20,1,9,5,5,2,15,3,9,11,2,18,12,8,1
"1258",1058,1059,1059,"white","age.gp4","NoTr","NoTrade","Group",15,0,4,4,7,0,15,0,5,10,1,14,11,4,1
"1259",1240,1241,1241,"white","age.gp2","Tr","NoTrade","NoGroup",7,1,3,2,1,0,6,1,4,3,0,7,5,2,1
"1260",1441,1442,1442,"white","age.gp3","Tr","NoTrade","NoGroup",10,2,3,3,2,1,9,0,4,6,1,9,5,5,1
"1261",1735,1736,1736,"white","age.gp3","Tr","NoTrade","Group",19,1,5,5,8,5,13,1,3,16,2,17,13,6,1
"1262",1965,1966,1966,"white","age.gp4","Tr","NoTrade","NoGroup",4,0,1,2,1,0,3,1,1,3,1,3,3,1,1
"1263",2016,2017,2017,"black","age.gp4","NoTr","NoTrade","NoGroup",3,0,1,1,1,1,2,0,2,1,0,3,2,1,1
"1264",2071,2072,2072,"white","age.gp3","Tr","NoTrade","Group",21,4,10,4,3,4,13,4,8,13,0,21,12,9,1
"1265",2230,2231,2231,"black","age.gp4","NoTr","Trade","Group",11,0,5,1,5,7,4,0,2,9,2,9,7,4,1
"1266",2350,2351,2351,"white","age.gp3","Tr","NoTrade","NoGroup",13,0,3,3,7,3,9,1,4,9,0,13,8,5,1
"1267",2803,2804,2804,"other","age.gp2","NoTr","NoTrade","NoGroup",3,1,1,1,0,0,3,0,0,3,0,3,2,1,1
"1268",2811,2812,2812,"other","age.gp2","NoTr","NoTrade","NoGroup",9,0,5,3,1,1,8,0,4,5,1,8,7,2,1
"1269",916,917,917,"white","age.gp1","NoTr","Trade","NoGroup",7,5,1,1,0,1,3,3,1,6,2,5,6,1,1
"1270",1077,1078,1078,"white","age.gp4","NoTr","NoTrade","Group",10,2,2,1,5,2,8,0,4,6,0,10,8,2,1
"1271",1213,1214,1214,"white","age.gp4","NoTr","NoTrade","NoGroup",1,1,0,0,0,0,1,0,0,1,0,1,1,0,1
"1272",1288,1289,1289,"white","age.gp4","NoTr","NoTrade","Group",13,2,3,2,6,0,10,3,7,6,0,13,8,5,1
"1273",1384,1385,1385,"white","age.gp1","NoTr","NoTrade","NoGroup",11,6,3,1,1,0,9,2,2,9,2,9,6,5,1
"1274",1728,1729,1729,"white","age.gp3","Tr","NoTrade","Group",17,2,6,3,6,1,14,2,7,10,1,16,12,5,1
"1275",1739,1740,1740,"white","age.gp3","Tr","NoTrade","Group",17,4,5,4,4,2,14,1,3,14,2,15,10,7,1
"1276",1855,1856,1856,"white","age.gp3","NoTr","NoTrade","Group",21,3,9,8,1,3,15,3,10,11,2,19,15,6,1
"1277",1906,1907,1907,"other","age.gp2","NoTr","NoTrade","NoGroup",3,1,1,1,0,0,3,0,1,2,0,3,3,0,1
"1278",2469,2470,2470,"white","age.gp1","NoTr","NoTrade","NoGroup",8,3,1,2,2,0,7,1,4,4,0,8,4,4,1
"1279",2900,2901,2901,"other","age.gp1","NoTr","NoTrade","NoGroup",3,2,0,1,0,0,3,0,0,3,1,2,3,0,1
"1280",158,159,159,"white","age.gp1","NoTr","NoTrade","Group",26,16,4,2,4,2,16,8,9,17,1,25,10,16,1
"1281",168,169,169,"white","age.gp3","NoTr","NoTrade","NoGroup",10,1,5,1,3,1,9,0,6,4,1,9,9,1,1
"1282",283,284,284,"white","age.gp2","Tr","NoTrade","Group",20,2,6,9,3,1,15,4,7,13,2,18,12,8,1
"1283",458,459,459,"white","age.gp1","NoTr","NoTrade","NoGroup",7,6,1,0,0,0,5,2,0,7,1,6,3,4,1
"1284",645,646,646,"other","age.gp1","NoTr","Trade","Group",7,3,2,2,0,0,7,0,4,3,0,7,4,3,1
"1285",744,745,745,"white","age.gp2","Tr","NoTrade","Group",18,4,7,4,3,1,16,1,5,13,0,18,12,6,1
"1286",1247,1248,1248,"white","age.gp1","NoTr","NoTrade","NoGroup",15,7,5,2,1,1,11,3,3,12,1,14,8,7,1
"1287",1885,1886,1886,"other","age.gp1","NoTr","NoTrade","Group",16,9,6,0,1,1,15,0,6,10,2,14,10,6,1
"1288",2437,2438,2438,"white","age.gp4","NoTr","NoTrade","NoGroup",5,1,2,1,1,0,5,0,1,4,0,5,5,0,1
"1289",2533,2534,2534,"other","age.gp1","NoTr","NoTrade","NoGroup",4,3,1,0,0,1,3,0,2,2,2,2,4,0,1
"1290",2875,2876,2876,"white","age.gp1","NoTr","NoTrade","NoGroup",6,3,2,1,0,0,6,0,3,3,2,4,4,2,1
"1291",2895,2896,2896,"other","age.gp1","NoTr","NoTrade","NoGroup",4,1,2,1,0,1,3,0,0,4,0,4,3,1,1
"1292",2903,2904,2904,"other","age.gp1","NoTr","NoTrade","NoGroup",2,1,1,0,0,0,2,0,1,1,0,2,2,0,1
"1293",2976,2977,2977,"white","age.gp1","NoTr","NoTrade","Group",23,9,5,4,5,2,19,2,10,13,4,19,17,6,1
"1294",638,639,639,"other","age.gp1","NoTr","Trade","Group",4,2,1,1,0,1,3,0,0,4,0,4,2,2,1
"1295",1003,1004,1004,"white","age.gp1","Tr","NoTrade","Group",26,14,5,4,3,2,19,5,7,19,6,20,17,9,1
"1296",1016,1017,1017,"white","age.gp1","NoTr","NoTrade","NoGroup",4,3,1,0,0,0,3,1,0,4,0,4,2,2,1
"1297",1312,1313,1313,"white","age.gp1","NoTr","NoTrade","NoGroup",16,11,2,1,2,1,12,3,5,11,0,16,5,11,1
"1298",1343,1344,1344,"white","age.gp1","Tr","NoTrade","NoGroup",1,1,0,0,0,0,1,0,0,1,0,1,1,0,1
"1299",1521,1522,1522,"black","age.gp4","NoTr","NoTrade","NoGroup",1,1,0,0,0,0,1,0,0,1,0,1,1,0,1
"1300",1642,1643,1643,"other","age.gp2","NoTr","NoTrade","NoGroup",8,2,2,2,2,0,7,1,3,5,1,7,3,5,1
"1301",2046,2047,2047,"white","age.gp4","Tr","NoTrade","Group",7,1,0,2,4,0,7,0,2,5,0,7,6,1,1
"1302",2493,2494,2494,"other","age.gp1","NoTr","NoTrade","NoGroup",6,1,3,2,0,0,6,0,3,3,0,6,6,0,1
"1303",2532,2533,2533,"other","age.gp1","NoTr","NoTrade","NoGroup",3,1,1,1,0,1,2,0,1,2,0,3,2,1,1
"1304",2767,2768,2768,"white","age.gp1","NoTr","NoTrade","NoGroup",7,5,0,1,1,1,4,2,1,6,0,7,4,3,1
"1305",2858,2859,2859,"white","age.gp1","Tr","NoTrade","NoGroup",12,7,2,0,3,0,9,3,2,10,2,10,8,4,1
"1306",2861,2862,2862,"white","age.gp1","Tr","NoTrade","NoGroup",11,10,0,0,1,0,6,5,1,10,0,11,6,5,1
"1307",2886,2887,2887,"white","age.gp1","NoTr","NoTrade","Group",21,13,0,3,5,1,16,4,7,14,1,20,8,13,1
"1308",2896,2897,2897,"other","age.gp1","NoTr","NoTrade","NoGroup",5,2,1,0,2,1,4,0,4,1,1,4,5,0,1
"1309",2910,2911,2911,"other","age.gp1","NoTr","NoTrade","NoGroup",5,3,1,0,1,1,4,0,2,3,1,4,2,3,1
"1310",159,160,160,"white","age.gp1","NoTr","NoTrade","Group",25,15,4,2,4,1,19,5,9,16,4,21,15,10,1
"1311",459,460,460,"white","age.gp1","NoTr","NoTrade","NoGroup",11,5,1,2,3,0,9,2,8,3,0,11,8,3,1
"1312",1064,1065,1065,"white","age.gp4","NoTr","NoTrade","Group",12,2,2,1,7,0,12,0,4,8,1,11,8,4,1
"1313",1141,1142,1142,"white","age.gp1","NoTr","NoTrade","NoGroup",15,6,5,2,2,1,13,1,8,7,1,14,10,5,1
"1314",1255,1256,1256,"white","age.gp1","Tr","Trade","Group",18,14,1,2,1,1,13,4,3,15,2,16,9,9,1
"1315",1596,1597,1597,"black","age.gp1","Tr","Trade","NoGroup",10,8,1,1,0,5,3,2,4,6,1,9,3,7,1
"1316",1725,1726,1726,"white","age.gp1","Tr","NoTrade","NoGroup",14,6,1,5,2,0,13,1,5,9,1,13,9,5,1
"1317",1881,1882,1882,"other","age.gp1","NoTr","NoTrade","Group",11,3,3,3,2,2,9,0,2,9,0,11,8,3,1
"1318",2497,2498,2498,"other","age.gp1","NoTr","NoTrade","NoGroup",4,2,1,1,0,0,4,0,1,3,0,4,3,1,1
"1319",2784,2785,2785,"white","age.gp3","NoTr","NoTrade","Group",17,5,4,4,4,1,14,2,6,11,1,16,8,9,1
"1320",160,161,161,"white","age.gp1","NoTr","NoTrade","Group",23,6,5,5,7,0,18,5,14,9,3,20,16,7,1
"1321",266,267,267,"white","age.gp4","NoTr","NoTrade","NoGroup",4,1,0,1,2,0,4,0,1,3,0,4,2,2,1
"1322",895,896,896,"other","age.gp1","Tr","NoTrade","NoGroup",7,4,0,3,0,1,6,0,1,6,1,6,4,3,1
"1323",1254,1255,1255,"white","age.gp1","Tr","Trade","Group",25,13,3,6,3,2,22,1,3,22,2,23,15,10,1
"1324",1585,1586,1586,"white","age.gp4","Tr","NoTrade","Group",15,4,0,1,10,0,13,2,6,9,2,13,13,2,1
"1325",1590,1591,1591,"white","age.gp4","Tr","NoTrade","Group",8,2,2,2,2,0,7,1,2,6,0,8,4,4,1
"1326",2256,2257,2257,"white","age.gp4","Tr","NoTrade","Group",9,2,2,2,3,1,7,1,6,3,1,8,8,1,1
"1327",2298,2299,2299,"other","age.gp2","Tr","NoTrade","Group",7,1,3,2,1,1,6,0,0,7,0,7,6,1,1
"1328",2483,2484,2484,"other","age.gp1","NoTr","NoTrade","NoGroup",4,2,0,1,1,1,3,0,0,4,0,4,2,2,1
"1329",2547,2548,2548,"other","age.gp1","NoTr","NoTrade","NoGroup",5,2,1,1,1,0,5,0,2,3,0,5,4,1,1
"1330",657,658,658,"white","age.gp2","Tr","NoTrade","NoGroup",15,1,4,8,2,3,11,1,7,8,1,14,10,5,1
"1331",1738,1739,1739,"white","age.gp3","Tr","NoTrade","Group",20,4,7,6,3,4,13,3,9,11,1,19,8,12,1
"1332",1818,1819,1819,"black","age.gp4","NoTr","NoTrade","NoGroup",5,1,0,1,3,3,2,0,1,4,0,5,1,4,1
"1333",1997,1998,1998,"black","age.gp4","NoTr","NoTrade","NoGroup",4,0,1,2,1,2,2,0,0,4,0,4,3,1,1
"1334",2141,2142,2142,"other","age.gp2","NoTr","NoTrade","NoGroup",2,0,0,2,0,0,2,0,0,2,0,2,1,1,1
"1335",684,685,685,"white","age.gp4","Tr","NoTrade","Group",5,0,2,1,2,0,5,0,4,1,0,5,3,2,1
"1336",1647,1648,1648,"other","age.gp2","NoTr","NoTrade","NoGroup",4,0,3,1,0,0,4,0,0,4,0,4,3,1,1
"1337",2323,2324,2324,"white","age.gp1","NoTr","NoTrade","NoGroup",6,2,0,4,0,0,5,1,3,3,0,6,3,3,1
"1338",163,164,164,"white","age.gp3","NoTr","NoTrade","NoGroup",10,0,4,3,3,1,8,1,6,4,0,10,8,2,1
"1339",280,281,281,"white","age.gp2","Tr","NoTrade","Group",17,1,8,6,2,1,15,1,9,8,0,17,13,4,1
"1340",672,673,673,"white","age.gp4","Tr","NoTrade","Group",13,2,3,6,2,2,8,3,3,10,1,12,6,7,1
"1341",2924,2925,2925,"white","age.gp4","NoTr","NoTrade","Group",12,2,3,2,5,0,10,2,7,5,1,11,8,4,1
"1342",1353,1354,1354,"black","age.gp4","NoTr","NoTrade","Group",7,0,0,3,4,5,2,0,1,6,0,7,4,3,1
"1343",1610,1611,1611,"white","age.gp3","Tr","NoTrade","NoGroup",5,1,3,1,0,0,3,2,2,3,0,5,2,3,1
"1344",1782,1783,1783,"white","age.gp4","Tr","NoTrade","Group",10,2,0,2,6,2,7,1,1,9,2,8,6,4,1
"1345",2039,2040,2040,"white","age.gp4","Tr","NoTrade","Group",7,0,0,2,5,1,6,0,1,6,0,7,5,2,1
"1346",2482,2483,2483,"other","age.gp1","NoTr","NoTrade","NoGroup",7,4,1,2,0,1,6,0,0,7,1,6,2,5,1
"1347",2622,2623,2623,"white","age.gp4","NoTr","NoTrade","NoGroup",6,0,3,1,2,0,5,1,3,3,0,6,1,5,1
"1348",165,166,166,"white","age.gp3","NoTr","NoTrade","NoGroup",6,1,3,0,2,0,6,0,3,3,1,5,5,1,1
"1349",2925,2926,2926,"white","age.gp4","NoTr","NoTrade","Group",11,1,1,5,4,1,9,1,5,6,0,11,5,6,1
"1350",473,474,474,"black","age.gp3","NoTr","Trade","Group",9,0,5,3,1,6,2,1,1,8,0,9,3,6,1
"1351",623,624,624,"other","age.gp1","NoTr","Trade","Group",9,4,1,4,0,1,8,0,5,4,0,9,4,5,1
"1352",969,970,970,"white","age.gp2","Tr","NoTrade","Group",17,1,8,5,3,0,14,3,3,14,1,16,13,4,1
"1353",1553,1554,1554,"white","age.gp3","NoTr","NoTrade","Group",24,1,11,5,7,4,18,2,11,13,2,22,14,10,1
"1354",2351,2352,2352,"white","age.gp3","Tr","NoTrade","NoGroup",11,1,3,4,3,1,10,0,6,5,0,11,8,3,1
"1355",2471,2472,2472,"white","age.gp1","NoTr","NoTrade","NoGroup",10,5,2,2,1,0,7,3,6,4,1,9,2,8,1
"1356",167,168,168,"white","age.gp3","NoTr","NoTrade","NoGroup",7,2,4,1,0,1,5,1,3,4,0,7,6,1,1
"1357",234,235,235,"white","age.gp2","Tr","NoTrade","Group",15,0,5,6,4,1,13,1,6,9,1,14,10,5,1
"1358",965,966,966,"black","age.gp2","NoTr","NoTrade","Group",10,0,7,3,0,6,4,0,2,8,0,10,5,5,1
"1359",1877,1878,1878,"other","age.gp1","NoTr","NoTrade","Group",6,1,4,1,0,1,5,0,4,2,0,6,4,2,1
"1360",2327,2328,2328,"white","age.gp3","Tr","NoTrade","Group",21,2,8,4,7,1,18,2,5,16,0,21,11,10,1
"1361",1297,1298,1298,"white","age.gp4","NoTr","NoTrade","Group",15,1,1,6,7,0,14,1,6,9,0,15,10,5,1
"1362",2273,2274,2274,"black","age.gp2","Tr","Trade","Group",15,2,5,6,2,8,6,1,4,11,3,12,7,8,1
"1363",2830,2831,2831,"white","age.gp2","Tr","NoTrade","NoGroup",11,0,6,4,1,2,7,2,3,8,0,11,6,5,1
"1364",169,170,170,"white","age.gp3","NoTr","NoTrade","NoGroup",5,0,4,1,0,0,4,1,3,2,1,4,5,0,1
"1365",869,870,870,"other","age.gp2","Tr","NoTrade","Group",12,0,6,4,2,1,11,0,5,7,0,12,8,4,1
"1366",1413,1414,1414,"white","age.gp3","NoTr","NoTrade","Group",11,1,3,3,4,0,10,1,6,5,0,11,8,3,1
"1367",170,171,171,"white","age.gp3","NoTr","NoTrade","NoGroup",7,0,4,3,0,0,4,3,1,6,0,7,4,3,1
"1368",662,663,663,"white","age.gp2","NoTr","NoTrade","Group",26,3,13,6,4,3,21,2,7,19,2,24,17,9,1
"1369",824,825,825,"white","age.gp3","NoTr","NoTrade","NoGroup",11,0,3,5,3,2,9,0,4,7,1,10,8,3,1
"1370",1552,1553,1553,"white","age.gp3","NoTr","NoTrade","Group",14,1,5,7,1,0,14,0,5,9,2,12,12,2,1
"1371",2136,2137,2137,"other","age.gp2","NoTr","NoTrade","NoGroup",6,1,2,2,1,2,4,0,2,4,3,3,5,1,1
"1372",171,172,172,"white","age.gp3","NoTr","NoTrade","NoGroup",2,0,2,0,0,0,2,0,0,2,0,2,2,0,1
"1373",172,173,173,"white","age.gp3","NoTr","NoTrade","NoGroup",9,2,4,1,2,2,6,1,4,5,2,7,6,3,1
"1374",1703,1704,1704,"white","age.gp4","NoTr","Trade","NoGroup",1,0,0,1,0,0,1,0,0,1,0,1,0,1,1
"1375",1804,1805,1805,"white","age.gp2","Tr","NoTrade","Group",25,1,15,5,4,3,18,4,10,15,4,21,18,7,1
"1376",2223,2224,2224,"black","age.gp4","NoTr","Trade","Group",9,1,2,2,4,3,5,1,2,7,0,9,6,3,1
"1377",2544,2545,2545,"other","age.gp1","NoTr","NoTrade","NoGroup",3,1,1,1,0,0,3,0,0,3,0,3,1,2,1
"1378",173,174,174,"white","age.gp3","NoTr","NoTrade","NoGroup",10,3,2,3,2,0,9,1,2,8,1,9,5,5,1
"1379",194,195,195,"white","age.gp2","Tr","NoTrade","NoGroup",10,1,4,3,2,0,9,1,4,6,1,9,5,5,1
"1380",1470,1471,1471,"white","age.gp1","NoTr","NoTrade","NoGroup",12,5,4,2,1,0,9,3,6,6,2,10,7,5,1
"1381",1473,1474,1474,"white","age.gp1","NoTr","NoTrade","NoGroup",7,2,2,3,0,0,4,3,2,5,0,7,3,4,1
"1382",1884,1885,1885,"other","age.gp1","NoTr","NoTrade","Group",13,7,1,1,4,2,11,0,6,7,1,12,8,5,1
"1383",2953,2954,2954,"white","age.gp2","Tr","NoTrade","Group",24,2,12,4,6,2,22,0,7,17,2,22,17,7,1
"1384",2878,2879,2879,"white","age.gp2","NoTr","NoTrade","NoGroup",10,2,1,3,4,1,8,1,4,6,1,9,6,4,1
"1385",175,176,176,"white","age.gp3","NoTr","NoTrade","NoGroup",8,1,5,1,1,0,7,1,6,2,2,6,7,1,1
"1386",176,177,177,"white","age.gp3","Tr","NoTrade","NoGroup",10,1,5,2,2,2,7,1,4,6,2,8,5,5,1
"1387",2419,2420,2420,"white","age.gp3","NoTr","Trade","Group",15,2,9,2,2,1,10,4,8,7,1,14,10,5,1
"1388",2826,2827,2827,"other","age.gp2","NoTr","NoTrade","NoGroup",5,0,2,2,1,0,5,0,3,2,0,5,3,2,1
"1389",177,178,178,"white","age.gp3","Tr","NoTrade","NoGroup",11,1,6,2,2,0,9,2,4,7,0,11,6,5,1
"1390",1654,1655,1655,"other","age.gp2","NoTr","NoTrade","NoGroup",5,0,1,3,1,1,4,0,1,4,0,5,2,3,1
"1391",2749,2750,2750,"white","age.gp3","NoTr","NoTrade","NoGroup",5,0,2,3,0,0,5,0,1,4,1,4,4,1,1
"1392",2783,2784,2784,"white","age.gp3","NoTr","NoTrade","Group",17,2,4,6,5,3,13,1,5,12,3,14,11,6,1
"1393",2797,2798,2798,"white","age.gp2","NoTr","NoTrade","NoGroup",13,2,5,5,1,1,10,2,5,8,0,13,6,7,1
"1394",2831,2832,2832,"white","age.gp2","Tr","NoTrade","NoGroup",9,1,3,4,1,1,7,1,4,5,0,9,5,4,1
"1395",2911,2912,2912,"other","age.gp1","NoTr","NoTrade","NoGroup",4,2,1,1,0,0,4,0,2,2,0,4,2,2,1
"1396",554,555,555,"white","age.gp4","NoTr","NoTrade","NoGroup",1,0,0,1,0,0,1,0,1,0,0,1,0,1,1
"1397",1640,1641,1641,"other","age.gp2","NoTr","NoTrade","NoGroup",6,0,4,2,0,0,6,0,4,2,1,5,4,2,1
"1398",2144,2145,2145,"other","age.gp2","NoTr","NoTrade","NoGroup",4,0,3,1,0,1,3,0,4,0,0,4,2,2,1
"1399",179,180,180,"white","age.gp3","Tr","NoTrade","NoGroup",5,0,3,1,1,0,4,1,3,2,1,4,4,1,1
"1400",2161,2162,2162,"white","age.gp2","Tr","NoTrade","NoGroup",6,0,1,3,2,0,6,0,4,2,0,6,4,2,1
"1401",2294,2295,2295,"other","age.gp2","Tr","NoTrade","Group",13,0,4,6,3,1,12,0,11,2,0,13,8,5,1
"1402",180,181,181,"white","age.gp3","Tr","NoTrade","NoGroup",6,0,2,2,2,0,4,2,2,4,0,6,4,2,1
"1403",673,674,674,"white","age.gp4","Tr","NoTrade","Group",11,1,2,3,5,2,8,1,1,10,1,10,5,6,1
"1404",1650,1651,1651,"other","age.gp2","NoTr","NoTrade","NoGroup",6,0,3,1,2,2,4,0,3,3,0,6,3,3,1
"1405",268,269,269,"white","age.gp4","NoTr","NoTrade","NoGroup",1,0,0,1,0,0,1,0,1,0,0,1,0,1,1
"1406",867,868,868,"other","age.gp2","Tr","NoTrade","Group",10,1,5,2,2,1,9,0,5,5,1,9,7,3,1
"1407",2591,2592,2592,"white","age.gp3","NoTr","NoTrade","Group",20,0,12,6,2,2,16,2,12,8,1,19,14,6,1
"1408",182,183,183,"white","age.gp3","Tr","NoTrade","NoGroup",6,1,1,3,1,0,6,0,3,3,1,5,4,2,1
"1409",2265,2266,2266,"white","age.gp4","Tr","NoTrade","Group",14,3,2,5,4,2,10,2,4,10,0,14,7,7,1
"1410",183,184,184,"white","age.gp3","Tr","NoTrade","NoGroup",9,1,2,1,5,0,8,1,3,6,1,8,7,2,1
"1411",1082,1083,1083,"white","age.gp4","NoTr","NoTrade","Group",16,1,1,3,11,2,13,1,5,11,1,15,9,7,1
"1412",1234,1235,1235,"white","age.gp4","NoTr","NoTrade","NoGroup",3,0,1,1,1,0,3,0,1,2,0,3,2,1,1
"1413",1507,1508,1508,"white","age.gp4","NoTr","NoTrade","NoGroup",4,0,0,3,1,0,4,0,2,2,0,4,3,1,1
"1414",2472,2473,2473,"white","age.gp2","Tr","NoTrade","Group",18,2,6,5,5,2,14,2,9,9,2,16,10,8,1
"1415",2564,2565,2565,"white","age.gp4","NoTr","NoTrade","Group",6,0,1,3,2,1,5,0,2,4,0,6,2,4,1
"1416",2777,2778,2778,"white","age.gp3","NoTr","NoTrade","Group",14,1,5,5,3,0,13,1,7,7,2,12,9,5,1
"1417",1311,1312,1312,"white","age.gp1","NoTr","NoTrade","NoGroup",14,5,3,3,3,2,12,0,5,9,1,13,6,8,1
"1418",1574,1575,1575,"white","age.gp4","Tr","NoTrade","Group",10,0,2,3,5,1,9,0,3,7,1,9,8,2,1
"1419",1606,1607,1607,"white","age.gp3","Tr","NoTrade","NoGroup",4,2,0,2,0,0,4,0,3,1,2,2,2,2,1
"1420",1992,1993,1993,"white","age.gp4","Tr","NoTrade","NoGroup",8,0,3,2,3,0,8,0,3,5,0,8,7,1,1
"1421",2089,2090,2090,"black","age.gp3","NoTr","NoTrade","NoGroup",7,1,2,2,2,6,1,0,1,6,0,7,2,5,1
"1422",2502,2503,2503,"other","age.gp1","NoTr","NoTrade","NoGroup",6,1,0,3,2,0,6,0,3,3,0,6,5,1,1
"1423",2965,2966,2966,"white","age.gp2","NoTr","NoTrade","NoGroup",6,1,3,1,1,0,6,0,4,2,0,6,4,2,1
"1424",185,186,186,"white","age.gp3","Tr","NoTrade","NoGroup",5,1,1,1,2,0,5,0,2,3,2,3,3,2,1
"1425",307,308,308,"white","age.gp4","NoTr","NoTrade","Group",10,2,0,4,4,1,9,0,5,5,1,9,6,4,1
"1426",335,336,336,"white","age.gp2","Tr","NoTrade","NoGroup",13,1,3,5,4,0,11,2,4,9,2,11,8,5,1
"1427",1686,1687,1687,"white","age.gp4","NoTr","Trade","NoGroup",3,0,1,1,1,0,3,0,2,1,0,3,2,1,1
"1428",1305,1306,1306,"white","age.gp2","Tr","NoTrade","NoGroup",10,0,6,1,3,1,9,0,8,2,0,10,6,4,1
"1429",1908,1909,1909,"other","age.gp2","NoTr","NoTrade","NoGroup",7,0,3,2,2,0,7,0,6,1,0,7,6,1,1
"1430",2110,2111,2111,"white","age.gp2","NoTr","NoTrade","NoGroup",18,2,11,3,2,1,15,2,10,8,1,17,12,6,1
"1431",1067,1068,1068,"white","age.gp4","NoTr","NoTrade","Group",14,2,4,3,5,1,11,2,4,10,1,13,4,10,1
"1432",1095,1096,1096,"white","age.gp2","NoTr","NoTrade","Group",21,2,12,4,3,4,16,1,7,14,1,20,14,7,1
"1433",1558,1559,1559,"white","age.gp3","NoTr","NoTrade","Group",15,1,7,4,3,1,12,2,11,4,0,15,9,6,1
"1434",1630,1631,1631,"white","age.gp1","NoTr","NoTrade","NoGroup",12,6,3,2,1,1,9,2,5,7,2,10,6,6,1
"1435",1635,1636,1636,"black","age.gp1","Tr","NoTrade","NoGroup",10,6,1,2,1,6,3,1,3,7,1,9,4,6,1
"1436",2751,2752,2752,"white","age.gp3","NoTr","NoTrade","NoGroup",16,3,6,5,2,1,15,0,6,10,0,16,12,4,1
"1437",188,189,189,"white","age.gp3","Tr","NoTrade","NoGroup",6,1,1,0,4,0,5,1,3,3,0,6,4,2,1
"1438",671,672,672,"white","age.gp4","Tr","NoTrade","Group",13,1,3,2,7,3,9,1,5,8,1,12,8,5,1
"1439",1282,1283,1283,"white","age.gp4","NoTr","NoTrade","Group",8,0,1,3,4,1,6,1,3,5,0,8,3,5,1
"1440",2918,2919,2919,"white","age.gp1","NoTr","NoTrade","NoGroup",13,6,2,3,2,1,10,2,6,7,1,12,6,7,1
"1441",904,905,905,"other","age.gp1","Tr","NoTrade","NoGroup",3,2,0,1,0,0,3,0,1,2,0,3,0,3,1
"1442",2673,2674,2674,"white","age.gp3","NoTr","NoTrade","NoGroup",9,1,3,2,3,0,9,0,4,5,0,9,7,2,1
"1443",2821,2822,2822,"other","age.gp2","NoTr","NoTrade","NoGroup",5,0,4,1,0,1,4,0,2,3,0,5,3,2,1
"1444",190,191,191,"white","age.gp3","Tr","NoTrade","NoGroup",10,1,3,3,3,1,7,2,1,9,0,10,4,6,1
"1445",730,731,731,"black","age.gp4","NoTr","NoTrade","NoGroup",5,0,2,3,0,2,3,0,2,3,0,5,4,1,1
"1446",1207,1208,1208,"white","age.gp4","NoTr","NoTrade","NoGroup",4,1,1,1,1,0,4,0,3,1,0,4,2,2,1
"1447",1639,1640,1640,"other","age.gp2","NoTr","NoTrade","NoGroup",3,0,2,1,0,0,3,0,1,2,0,3,2,1,1
"1448",1940,1941,1941,"white","age.gp4","NoTr","NoTrade","Group",7,0,2,2,3,2,4,1,2,5,0,7,3,4,1
"1449",2112,2113,2113,"white","age.gp2","NoTr","NoTrade","NoGroup",12,2,6,2,2,2,9,1,5,7,1,11,7,5,1
"1450",2122,2123,2123,"white","age.gp3","NoTr","NoTrade","Group",23,2,9,5,7,1,17,5,8,15,1,22,12,11,1
"1451",2126,2127,2127,"white","age.gp3","NoTr","NoTrade","Group",14,1,6,3,4,2,11,1,8,6,0,14,8,6,1
"1452",2325,2326,2326,"white","age.gp3","Tr","NoTrade","Group",22,1,4,12,5,3,18,1,7,15,2,20,15,7,1
"1453",2810,2811,2811,"other","age.gp2","NoTr","NoTrade","NoGroup",2,0,0,1,1,0,2,0,1,1,0,2,1,1,1
"1454",191,192,192,"white","age.gp2","Tr","NoTrade","NoGroup",8,0,7,0,1,1,6,1,1,7,0,8,4,4,1
"1455",2435,2436,2436,"white","age.gp4","NoTr","NoTrade","NoGroup",3,1,1,0,1,0,3,0,3,0,1,2,2,1,1
"1456",864,865,865,"other","age.gp2","Tr","NoTrade","Group",6,0,4,2,0,0,6,0,2,4,1,5,4,2,1
"1457",1203,1204,1204,"white","age.gp4","Tr","NoTrade","NoGroup",7,0,3,0,4,0,7,0,1,6,0,7,4,3,1
"1458",1648,1649,1649,"other","age.gp2","NoTr","NoTrade","NoGroup",6,0,3,0,3,0,6,0,2,4,0,6,4,2,1
"1459",2246,2247,2247,"white","age.gp4","Tr","NoTrade","Group",11,0,4,4,3,0,11,0,5,6,0,11,9,2,1
"1460",2319,2320,2320,"white","age.gp2","NoTr","NoTrade","NoGroup",10,1,5,3,1,2,8,0,4,6,0,10,3,7,1
"1461",193,194,194,"white","age.gp2","Tr","NoTrade","NoGroup",14,1,8,2,3,3,11,0,2,12,3,11,8,6,1
"1462",652,653,653,"black","age.gp2","NoTr","NoTrade","NoGroup",7,0,4,3,0,3,4,0,1,6,0,7,3,4,1
"1463",1231,1232,1232,"white","age.gp4","NoTr","NoTrade","NoGroup",7,0,3,3,1,0,7,0,4,3,0,7,6,1,1
"1464",2215,2216,2216,"black","age.gp4","NoTr","Trade","Group",7,1,1,2,3,3,3,1,1,6,0,7,2,5,1
"1465",2393,2394,2394,"black","age.gp2","NoTr","NoTrade","NoGroup",8,1,3,2,2,6,2,0,2,6,2,6,4,4,1
"1466",2599,2600,2600,"white","age.gp3","NoTr","NoTrade","Group",17,1,8,4,4,0,16,1,9,8,0,17,12,5,1
"1467",2646,2647,2647,"white","age.gp1","NoTr","NoTrade","NoGroup",7,4,2,0,1,0,4,3,3,4,2,5,3,4,1
"1468",1273,1274,1274,"white","age.gp4","NoTr","NoTrade","Group",14,2,5,3,4,1,12,1,4,10,0,14,9,5,1
"1469",1279,1280,1280,"white","age.gp4","NoTr","NoTrade","Group",10,0,5,1,4,1,9,0,8,2,1,9,7,3,1
"1470",2146,2147,2147,"other","age.gp2","NoTr","NoTrade","NoGroup",6,0,2,4,0,2,4,0,4,2,2,4,4,2,1
"1471",2313,2314,2314,"white","age.gp2","Tr","NoTrade","NoGroup",9,0,4,2,3,1,8,0,4,5,0,9,5,4,1
"1472",2414,2415,2415,"white","age.gp3","NoTr","Trade","Group",13,2,5,4,2,2,10,1,6,7,0,13,5,8,1
"1473",2833,2834,2834,"white","age.gp2","Tr","NoTrade","NoGroup",10,0,5,2,3,1,8,1,3,7,0,10,5,5,1
"1474",832,833,833,"white","age.gp3","NoTr","NoTrade","NoGroup",8,2,3,3,0,1,6,1,3,5,1,7,2,6,1
"1475",1448,1449,1449,"white","age.gp1","NoTr","NoTrade","NoGroup",14,5,4,3,2,4,8,2,4,10,1,13,7,7,1
"1476",2526,2527,2527,"white","age.gp2","NoTr","NoTrade","Group",18,2,8,3,5,0,17,1,10,8,1,17,10,8,1
"1477",2702,2703,2703,"white","age.gp4","NoTr","NoTrade","Group",7,0,2,0,5,1,5,1,3,4,0,7,3,4,1
"1478",2714,2715,2715,"white","age.gp4","NoTr","NoTrade","Group",10,0,4,2,4,0,8,2,6,4,0,10,5,5,1
"1479",2771,2772,2772,"white","age.gp1","NoTr","NoTrade","NoGroup",15,5,4,4,2,2,13,0,14,1,0,15,7,8,1
"1480",1672,1673,1673,"white","age.gp2","Tr","NoTrade","NoGroup",6,0,2,1,3,1,4,1,3,3,0,6,4,2,1
"1481",199,200,200,"other","age.gp2","Tr","NoTrade","NoGroup",4,1,0,1,2,0,3,1,0,4,1,3,4,0,1
"1482",2699,2700,2700,"white","age.gp4","NoTr","NoTrade","Group",8,0,3,3,2,2,5,1,3,5,0,8,3,5,1
"1483",200,201,201,"other","age.gp2","Tr","NoTrade","NoGroup",6,0,0,3,3,1,5,0,2,4,1,5,5,1,1
"1484",1734,1735,1735,"white","age.gp3","Tr","NoTrade","Group",18,4,7,3,4,4,12,2,6,12,3,15,10,8,1
"1485",2593,2594,2594,"white","age.gp3","NoTr","NoTrade","Group",21,0,9,6,6,3,15,3,8,13,1,20,14,7,1
"1486",2945,2946,2946,"white","age.gp4","NoTr","NoTrade","Group",8,0,3,1,4,1,6,1,4,4,1,7,6,2,1
"1487",202,203,203,"other","age.gp2","Tr","NoTrade","NoGroup",3,0,0,2,1,1,2,0,0,3,0,3,2,1,1
"1488",2590,2591,2591,"white","age.gp3","NoTr","NoTrade","Group",13,2,6,3,2,2,8,3,6,7,1,12,8,5,1
"1489",2688,2689,2689,"black","age.gp3","NoTr","NoTrade","NoGroup",5,0,2,2,1,2,1,2,2,3,1,4,2,3,1
"1490",1229,1230,1230,"white","age.gp4","NoTr","NoTrade","NoGroup",9,0,2,2,5,0,8,1,5,4,0,9,4,5,1
"1491",2104,2105,2105,"white","age.gp2","Tr","NoTrade","Group",14,0,7,3,4,1,11,2,8,6,0,14,8,6,1
"1492",204,205,205,"other","age.gp2","Tr","NoTrade","NoGroup",7,1,1,3,2,1,6,0,2,5,0,7,3,4,1
"1493",1011,1012,1012,"white","age.gp1","Tr","NoTrade","NoGroup",16,14,1,0,1,1,10,5,5,11,0,16,1,15,1
"1494",2679,2680,2680,"black","age.gp3","NoTr","NoTrade","NoGroup",6,1,3,2,0,2,1,3,3,3,0,6,2,4,1
"1495",2752,2753,2753,"white","age.gp3","NoTr","NoTrade","NoGroup",9,2,3,2,2,0,8,1,3,6,0,9,4,5,1
"1496",205,206,206,"other","age.gp2","Tr","NoTrade","NoGroup",3,0,1,1,1,0,3,0,1,2,0,3,1,2,1
"1497",1317,1318,1318,"white","age.gp2","NoTr","NoTrade","NoGroup",6,0,1,2,3,1,4,1,1,5,0,6,2,4,1
"1498",2614,2615,2615,"white","age.gp4","NoTr","NoTrade","NoGroup",1,0,1,0,0,0,0,1,1,0,0,1,0,1,1
"1499",206,207,207,"other","age.gp2","Tr","NoTrade","NoGroup",3,0,3,0,0,0,3,0,2,1,0,3,2,1,1
"1500",1718,1719,1719,"white","age.gp2","NoTr","NoTrade","Group",21,2,12,4,3,1,14,6,4,17,1,20,12,9,1
"1501",2829,2830,2830,"white","age.gp2","Tr","NoTrade","NoGroup",17,0,12,1,4,1,13,3,7,10,0,17,10,7,1
"1502",2955,2956,2956,"white","age.gp2","Tr","NoTrade","Group",13,0,6,4,3,0,9,4,5,8,0,13,12,1,1
"1503",207,208,208,"other","age.gp2","Tr","NoTrade","NoGroup",4,0,2,1,1,1,3,0,2,2,0,4,4,0,1
"1504",2266,2267,2267,"white","age.gp4","Tr","NoTrade","Group",5,1,2,2,0,0,4,1,3,2,0,5,1,4,1
"1505",2867,2868,2868,"white","age.gp2","Tr","NoTrade","Group",32,4,15,7,6,3,23,6,10,22,2,30,18,14,1
"1506",209,210,210,"other","age.gp2","Tr","NoTrade","NoGroup",8,1,3,2,2,0,8,0,2,6,0,8,3,5,1
"1507",2708,2709,2709,"white","age.gp4","NoTr","NoTrade","Group",6,0,1,1,4,0,5,1,2,4,0,6,4,2,1
"1508",210,211,211,"other","age.gp2","Tr","NoTrade","NoGroup",3,0,0,1,2,1,2,0,0,3,0,3,0,3,1
"1509",1236,1237,1237,"white","age.gp4","NoTr","NoTrade","NoGroup",5,0,4,0,1,0,4,1,2,3,0,5,3,2,1
"1510",1390,1391,1391,"black","age.gp3","NoTr","NoTrade","NoGroup",7,1,2,4,0,6,0,1,2,5,1,6,2,5,1
"1511",211,212,212,"other","age.gp2","Tr","NoTrade","NoGroup",6,1,2,3,0,0,6,0,4,2,1,5,5,1,1
"1512",1607,1608,1608,"white","age.gp3","Tr","NoTrade","NoGroup",12,1,5,2,4,0,8,4,4,8,1,11,8,4,1
"1513",1010,1011,1011,"white","age.gp1","Tr","NoTrade","NoGroup",6,2,4,0,0,0,4,2,2,4,1,5,4,2,1
"1514",2877,2878,2878,"white","age.gp1","NoTr","NoTrade","NoGroup",14,8,4,2,0,0,10,4,6,8,1,13,7,7,1
"1515",213,214,214,"other","age.gp2","Tr","NoTrade","NoGroup",2,0,1,1,0,0,2,0,1,1,0,2,2,0,1
"1516",2066,2067,2067,"white","age.gp3","Tr","NoTrade","Group",18,3,7,4,4,1,15,2,7,11,0,18,10,8,1
"1517",215,216,216,"other","age.gp2","Tr","NoTrade","NoGroup",2,0,0,2,0,0,2,0,0,2,1,1,2,0,1
"1518",216,217,217,"other","age.gp2","Tr","NoTrade","NoGroup",3,1,1,1,0,0,3,0,3,0,0,3,2,1,1
"1519",2312,2313,2313,"white","age.gp2","Tr","NoTrade","NoGroup",13,1,9,0,3,2,9,2,6,7,0,13,9,4,1
"1520",217,218,218,"other","age.gp2","Tr","NoTrade","NoGroup",4,0,1,3,0,1,3,0,1,3,1,3,2,2,1
"1521",823,824,824,"white","age.gp3","NoTr","NoTrade","NoGroup",6,1,3,2,0,0,5,1,4,2,0,6,4,2,1
"1522",218,219,219,"other","age.gp2","Tr","NoTrade","NoGroup",2,0,0,1,1,0,2,0,2,0,0,2,2,0,1
"1523",1793,1794,1794,"white","age.gp4","Tr","NoTrade","Group",15,1,4,2,8,0,12,3,6,9,1,14,8,7,1
"1524",220,221,221,"other","age.gp2","Tr","NoTrade","NoGroup",5,0,2,1,2,1,4,0,0,5,1,4,4,1,1
"1525",840,841,841,"white","age.gp2","NoTr","NoTrade","Group",24,0,15,6,3,3,19,2,12,12,1,23,13,11,1
"1526",1465,1466,1466,"white","age.gp2","NoTr","Trade","Group",19,2,9,4,4,2,16,1,10,9,0,19,13,6,1
"1527",2090,2091,2091,"black","age.gp3","NoTr","NoTrade","NoGroup",1,0,1,0,0,0,0,1,1,0,0,1,0,1,1
"1528",221,222,222,"other","age.gp2","Tr","NoTrade","NoGroup",4,0,3,0,1,0,4,0,2,2,0,4,1,3,1
"1529",332,333,333,"white","age.gp2","Tr","NoTrade","NoGroup",11,0,6,3,2,1,7,3,5,6,1,10,5,6,1
"1530",1499,1500,1500,"white","age.gp4","NoTr","NoTrade","NoGroup",3,0,1,0,2,0,2,1,2,1,0,3,1,2,1
"1531",222,223,223,"other","age.gp2","Tr","NoTrade","NoGroup",4,0,2,1,1,0,4,0,2,2,0,4,3,1,1
"1532",1040,1041,1041,"black","age.gp4","NoTr","NoTrade","NoGroup",4,0,1,2,1,3,1,0,1,3,0,4,2,2,1
"1533",2218,2219,2219,"black","age.gp4","NoTr","Trade","Group",12,0,5,3,4,7,5,0,2,10,1,11,5,7,1
"1534",2371,2372,2372,"black","age.gp2","NoTr","NoTrade","NoGroup",11,1,5,3,2,6,4,1,3,8,1,10,6,5,1
"1535",224,225,225,"black","age.gp2","NoTr","NoTrade","NoGroup",3,1,1,1,0,1,1,1,1,2,0,3,3,0,1
"1536",225,226,226,"black","age.gp2","NoTr","NoTrade","NoGroup",13,1,7,3,2,7,6,0,3,10,3,10,6,7,1
"1537",334,335,335,"white","age.gp2","Tr","NoTrade","NoGroup",17,3,6,0,8,1,13,3,4,13,1,16,13,4,1
"1538",1307,1308,1308,"white","age.gp2","Tr","NoTrade","NoGroup",9,1,6,0,2,3,6,0,1,8,0,9,5,4,1
"1539",1453,1454,1454,"black","age.gp1","NoTr","NoTrade","NoGroup",9,6,1,2,0,7,1,1,4,5,4,5,5,4,1
"1540",2107,2108,2108,"white","age.gp2","NoTr","NoTrade","NoGroup",9,1,3,2,3,2,6,1,3,6,0,9,4,5,1
"1541",2231,2232,2232,"black","age.gp4","NoTr","Trade","Group",7,0,1,3,3,3,4,0,3,4,0,7,3,4,1
"1542",2837,2838,2838,"black","age.gp2","NoTr","NoTrade","NoGroup",7,0,5,0,2,3,4,0,3,4,0,7,3,4,1
"1543",1066,1067,1067,"white","age.gp4","NoTr","NoTrade","Group",11,1,4,2,4,2,7,2,3,8,2,9,5,6,1
"1544",1840,1841,1841,"black","age.gp3","NoTr","NoTrade","NoGroup",11,0,4,4,3,5,5,1,4,7,2,9,4,7,1
"1545",1267,1268,1268,"black","age.gp3","NoTr","NoTrade","NoGroup",8,1,4,2,1,4,4,0,3,5,1,7,4,4,1
"1546",1876,1877,1877,"other","age.gp1","NoTr","NoTrade","Group",9,4,1,0,4,2,7,0,1,8,1,8,3,6,1
"1547",1962,1963,1963,"white","age.gp4","NoTr","NoTrade","Group",10,0,4,3,3,1,8,1,3,7,0,10,5,5,1
"1548",2753,2754,2754,"white","age.gp3","NoTr","NoTrade","NoGroup",10,2,5,2,1,1,8,1,5,5,1,9,5,5,1
"1549",1302,1303,1303,"white","age.gp4","NoTr","NoTrade","Group",13,0,6,1,6,0,12,1,5,8,0,13,9,4,1
"1550",1846,1847,1847,"black","age.gp3","NoTr","NoTrade","NoGroup",4,0,3,1,0,3,1,0,1,3,0,4,1,3,1
"1551",2396,2397,2397,"white","age.gp3","NoTr","NoTrade","NoGroup",10,1,3,2,4,0,10,0,4,6,0,10,8,2,1
"1552",2426,2427,2427,"white","age.gp4","NoTr","NoTrade","NoGroup",6,1,1,0,4,0,6,0,3,3,0,6,5,1,1
"1553",2651,2652,2652,"white","age.gp2","NoTr","NoTrade","Group",21,0,14,5,2,2,18,1,10,11,1,20,13,8,1
"1554",2732,2733,2733,"black","age.gp3","NoTr","NoTrade","NoGroup",7,1,3,1,2,1,6,0,4,3,0,7,6,1,1
"1555",2795,2796,2796,"white","age.gp2","Tr","NoTrade","NoGroup",7,0,6,0,1,0,6,1,4,3,0,7,5,2,1
"1556",2844,2845,2845,"black","age.gp3","NoTr","NoTrade","Group",14,2,6,2,4,8,5,1,4,10,4,10,7,7,1
"1557",2961,2962,2962,"white","age.gp2","NoTr","NoTrade","Group",25,3,12,5,5,2,20,3,9,16,2,23,17,8,1
"1558",648,649,649,"other","age.gp1","NoTr","Trade","Group",4,1,1,1,1,1,3,0,2,2,0,4,2,2,1
"1559",870,871,871,"other","age.gp2","Tr","NoTrade","Group",4,0,3,1,0,1,3,0,2,2,0,4,2,2,1
"1560",875,876,876,"white","age.gp3","NoTr","Trade","Group",15,3,7,4,1,1,13,1,11,4,1,14,10,5,1
"1561",939,940,940,"white","age.gp3","NoTr","NoTrade","NoGroup",10,3,5,0,2,2,6,2,5,5,3,7,6,4,1
"1562",1873,1874,1874,"other","age.gp1","NoTr","NoTrade","Group",7,1,3,2,1,0,7,0,2,5,0,7,7,0,1
"1563",1927,1928,1928,"other","age.gp2","NoTr","NoTrade","NoGroup",2,0,2,0,0,0,2,0,2,0,0,2,1,1,1
"1564",2647,2648,2648,"white","age.gp2","NoTr","NoTrade","Group",17,0,8,5,4,1,14,2,8,9,1,16,14,3,1
"1565",2701,2702,2702,"white","age.gp4","NoTr","NoTrade","Group",9,1,3,1,4,0,8,1,2,7,1,8,7,2,1
"1566",2741,2742,2742,"white","age.gp2","Tr","NoTrade","Group",22,2,7,7,6,2,18,2,10,12,0,22,15,7,1
"1567",2820,2821,2821,"other","age.gp2","NoTr","NoTrade","NoGroup",6,0,3,2,1,1,5,0,4,2,2,4,4,2,1
"1568",827,828,828,"white","age.gp3","NoTr","NoTrade","NoGroup",6,2,1,1,2,1,4,1,2,4,0,6,2,4,1
"1569",863,864,864,"other","age.gp2","Tr","NoTrade","Group",7,0,2,2,3,2,5,0,3,4,1,6,6,1,1
"1570",891,892,892,"other","age.gp1","Tr","NoTrade","NoGroup",3,0,3,0,0,1,2,0,3,0,1,2,3,0,1
"1571",1196,1197,1197,"white","age.gp4","Tr","NoTrade","NoGroup",9,1,3,0,5,2,7,0,3,6,0,9,6,3,1
"1572",1241,1242,1242,"white","age.gp2","Tr","NoTrade","NoGroup",14,2,7,2,3,1,11,2,3,11,0,14,9,5,1
"1573",1721,1722,1722,"white","age.gp2","NoTr","NoTrade","Group",18,0,9,8,1,2,16,0,7,11,2,16,12,6,1
"1574",2866,2867,2867,"white","age.gp2","Tr","NoTrade","Group",17,1,10,4,2,3,13,1,8,9,2,15,12,5,1
"1575",2880,2881,2881,"white","age.gp2","NoTr","NoTrade","NoGroup",11,0,5,5,1,1,9,1,5,6,0,11,6,5,1
"1576",2929,2930,2930,"white","age.gp4","NoTr","NoTrade","Group",11,1,5,1,4,0,10,1,6,5,0,11,9,2,1
"1577",1085,1086,1086,"black","age.gp2","Tr","NoTrade","NoGroup",8,1,4,2,1,2,5,1,5,3,1,7,5,3,1
"1578",1727,1728,1728,"white","age.gp3","Tr","NoTrade","Group",19,1,10,2,6,0,18,1,7,12,3,16,14,5,1
"1579",1943,1944,1944,"white","age.gp4","NoTr","NoTrade","Group",14,0,8,1,5,1,12,1,8,6,0,14,11,3,1
"1580",2255,2256,2256,"white","age.gp4","Tr","NoTrade","Group",12,0,3,3,6,0,12,0,4,8,0,12,7,5,1
"1581",2750,2751,2751,"white","age.gp3","NoTr","NoTrade","NoGroup",9,2,5,0,2,2,6,1,4,5,0,9,7,2,1
"1582",2809,2810,2810,"other","age.gp2","NoTr","NoTrade","NoGroup",5,0,2,1,2,1,4,0,2,3,0,5,4,1,1
"1583",1427,1428,1428,"white","age.gp2","Tr","NoTrade","Group",22,1,15,2,4,2,18,2,11,11,0,22,13,9,1
"1584",2815,2816,2816,"other","age.gp2","NoTr","NoTrade","NoGroup",4,0,4,0,0,0,4,0,3,1,0,4,3,1,1
"1585",2869,2870,2870,"white","age.gp1","NoTr","NoTrade","Group",22,12,8,0,2,4,14,4,10,12,1,21,9,13,1
"1586",2943,2944,2944,"white","age.gp4","NoTr","NoTrade","Group",7,0,3,4,0,0,7,0,3,4,0,7,5,2,1
"1587",233,234,234,"white","age.gp2","Tr","NoTrade","Group",22,1,13,5,3,4,17,1,7,15,3,19,14,8,1
"1588",469,470,470,"black","age.gp3","NoTr","Trade","Group",14,1,4,5,4,4,10,0,4,10,3,11,6,8,1
"1589",887,888,888,"white","age.gp3","NoTr","Trade","Group",15,1,12,2,0,3,11,1,10,5,2,13,13,2,1
"1590",2009,2010,2010,"black","age.gp4","NoTr","NoTrade","NoGroup",6,0,3,3,0,1,5,0,4,2,0,6,4,2,1
"1591",2394,2395,2395,"black","age.gp2","NoTr","NoTrade","NoGroup",6,0,2,2,2,2,4,0,2,4,1,5,5,1,1
"1592",2480,2481,2481,"other","age.gp1","NoTr","NoTrade","NoGroup",5,2,2,0,1,0,5,0,4,1,1,4,3,2,1
"1593",2672,2673,2673,"white","age.gp3","NoTr","NoTrade","NoGroup",13,3,6,3,1,0,11,2,7,6,1,12,10,3,1
"1594",2713,2714,2714,"white","age.gp4","NoTr","NoTrade","Group",12,1,3,2,6,1,9,2,5,7,2,10,9,3,1
"1595",1736,1737,1737,"white","age.gp3","Tr","NoTrade","Group",19,6,4,3,6,0,17,2,4,15,1,18,11,8,1
"1596",1799,1800,1800,"white","age.gp4","Tr","NoTrade","Group",19,0,4,5,10,1,17,1,10,9,1,18,15,4,1
"1597",2423,2424,2424,"white","age.gp3","NoTr","Trade","Group",16,3,5,5,3,2,12,2,3,13,2,14,10,6,1
"1598",254,255,255,"white","age.gp4","NoTr","NoTrade","NoGroup",13,2,4,1,6,2,9,2,3,10,0,13,9,4,1
"1599",277,278,278,"white","age.gp4","NoTr","NoTrade","NoGroup",3,0,1,2,0,0,3,0,2,1,0,3,3,0,1
"1600",525,526,526,"black","age.gp3","NoTr","NoTrade","NoGroup",10,2,3,3,2,3,6,1,4,6,2,8,5,5,1
"1601",526,527,527,"white","age.gp4","NoTr","NoTrade","NoGroup",8,0,3,2,3,0,8,0,4,4,1,7,6,2,1
"1602",555,556,556,"white","age.gp4","NoTr","NoTrade","NoGroup",5,0,2,0,3,0,5,0,1,4,0,5,3,2,1
"1603",1195,1196,1196,"white","age.gp4","Tr","NoTrade","NoGroup",3,0,1,0,2,1,2,0,2,1,0,3,2,1,1
"1604",1656,1657,1657,"other","age.gp2","NoTr","NoTrade","NoGroup",7,0,4,2,1,2,5,0,3,4,1,6,6,1,1
"1605",2963,2964,2964,"white","age.gp2","NoTr","NoTrade","NoGroup",10,0,6,2,2,0,10,0,7,3,0,10,7,3,1
"1606",336,337,337,"white","age.gp2","Tr","NoTrade","NoGroup",8,1,5,1,1,1,7,0,4,4,0,8,5,3,1
"1607",831,832,832,"white","age.gp3","NoTr","NoTrade","NoGroup",9,3,4,1,1,2,7,0,2,7,3,6,5,4,1
"1608",1919,1920,1920,"other","age.gp2","NoTr","NoTrade","NoGroup",5,0,4,1,0,0,5,0,3,2,0,5,5,0,1
"1609",2029,2030,2030,"white","age.gp4","Tr","NoTrade","Group",14,0,4,1,9,1,13,0,10,4,1,13,10,4,1
"1610",2159,2160,2160,"white","age.gp2","Tr","NoTrade","NoGroup",11,1,7,3,0,2,8,1,6,5,2,9,4,7,1
"1611",2250,2251,2251,"white","age.gp4","Tr","NoTrade","Group",10,0,4,0,6,1,8,1,4,6,1,9,8,2,1
"1612",2275,2276,2276,"black","age.gp2","Tr","Trade","Group",13,0,5,4,4,8,5,0,3,10,1,12,7,6,1
"1613",2291,2292,2292,"other","age.gp2","Tr","NoTrade","Group",9,0,4,3,2,2,7,0,5,4,0,9,6,3,1
"1614",2335,2336,2336,"white","age.gp3","Tr","NoTrade","Group",16,6,5,1,4,2,12,2,6,10,3,13,9,7,1
"1615",2657,2658,2658,"white","age.gp2","NoTr","NoTrade","Group",22,2,12,6,2,2,18,2,7,15,1,21,17,5,1
"1616",237,238,238,"white","age.gp2","Tr","NoTrade","Group",24,2,11,7,4,4,18,2,3,21,3,21,15,9,1
"1617",508,509,509,"white","age.gp2","Tr","NoTrade","NoGroup",9,1,5,2,1,0,6,3,5,4,1,8,8,1,1
"1618",610,611,611,"other","age.gp4","NoTr","NoTrade","NoGroup",3,0,1,1,1,0,3,0,1,2,0,3,3,0,1
"1619",781,782,782,"white","age.gp2","NoTr","NoTrade","NoGroup",11,0,8,3,0,3,5,3,4,7,1,10,6,5,1
"1620",1142,1143,1143,"white","age.gp1","NoTr","NoTrade","NoGroup",8,6,1,1,0,1,5,2,6,2,0,8,3,5,1
"1621",1551,1552,1552,"white","age.gp3","NoTr","NoTrade","Group",18,0,5,9,4,3,15,0,10,8,1,17,14,4,1
"1622",1955,1956,1956,"white","age.gp4","NoTr","NoTrade","Group",15,2,3,2,8,1,12,2,7,8,1,14,14,1,1
"1623",2124,2125,2125,"white","age.gp3","NoTr","NoTrade","Group",17,3,5,5,4,2,12,3,7,10,1,16,13,4,1
"1624",2134,2135,2135,"other","age.gp2","NoTr","NoTrade","NoGroup",6,1,3,2,0,1,5,0,2,4,0,6,5,1,1
"1625",2613,2614,2614,"white","age.gp4","NoTr","NoTrade","NoGroup",5,0,4,1,0,0,5,0,2,3,0,5,5,0,1
"1626",2974,2975,2975,"white","age.gp1","NoTr","NoTrade","Group",21,10,4,1,6,2,15,4,11,10,3,18,14,7,1
"1627",655,656,656,"white","age.gp2","Tr","NoTrade","NoGroup",14,0,5,5,4,3,10,1,4,10,3,11,10,4,1
"1628",1206,1207,1207,"white","age.gp4","Tr","NoTrade","NoGroup",5,0,2,0,3,1,4,0,3,2,1,4,5,0,1
"1629",1544,1545,1545,"white","age.gp2","NoTr","NoTrade","NoGroup",10,0,6,3,1,0,10,0,5,5,1,9,9,1,1
"1630",1601,1602,1602,"white","age.gp2","Tr","NoTrade","NoGroup",10,2,4,1,3,0,9,1,4,6,1,9,6,4,1
"1631",1670,1671,1671,"white","age.gp2","Tr","NoTrade","NoGroup",8,0,6,0,2,0,6,2,2,6,1,7,4,4,1
"1632",2185,2186,2186,"white","age.gp4","NoTr","NoTrade","NoGroup",8,1,2,1,4,1,7,0,3,5,0,8,6,2,1
"1633",579,580,580,"other","age.gp4","NoTr","NoTrade","NoGroup",5,0,1,1,3,0,5,0,4,1,0,5,5,0,1
"1634",2148,2149,2149,"other","age.gp2","NoTr","NoTrade","NoGroup",4,0,2,0,2,1,3,0,2,2,0,4,3,1,1
"1635",2481,2482,2482,"other","age.gp1","NoTr","NoTrade","NoGroup",12,3,5,2,2,0,12,0,7,5,0,12,8,4,1
"1636",240,241,241,"white","age.gp2","Tr","NoTrade","Group",24,3,10,7,4,1,23,0,10,14,4,20,19,5,1
"1637",844,845,845,"white","age.gp2","Tr","NoTrade","NoGroup",11,0,7,2,2,0,11,0,5,6,1,10,7,4,1
"1638",1338,1339,1339,"white","age.gp3","NoTr","NoTrade","NoGroup",9,0,3,4,2,0,8,1,7,2,0,9,8,1,1
"1639",2214,2215,2215,"black","age.gp4","NoTr","Trade","Group",8,0,3,2,3,6,2,0,3,5,1,7,3,5,1
"1640",2588,2589,2589,"white","age.gp4","NoTr","NoTrade","Group",9,0,3,2,4,1,8,0,5,4,1,8,6,3,1
"1641",2696,2697,2697,"white","age.gp4","NoTr","NoTrade","Group",18,2,6,1,9,1,17,0,8,10,4,14,13,5,1
"1642",698,699,699,"white","age.gp4","Tr","NoTrade","Group",8,2,2,1,3,0,8,0,4,4,0,8,5,3,1
"1643",879,880,880,"white","age.gp3","NoTr","Trade","Group",15,3,5,3,4,0,12,3,8,7,1,14,8,7,1
"1644",1026,1027,1027,"black","age.gp4","NoTr","NoTrade","NoGroup",1,0,1,0,0,0,1,0,1,0,0,1,1,0,1
"1645",1420,1421,1421,"white","age.gp2","NoTr","NoTrade","Group",22,0,13,5,4,2,17,3,10,12,1,21,12,10,1
"1646",1807,1808,1808,"white","age.gp2","Tr","NoTrade","Group",25,2,13,8,2,3,21,1,12,13,1,24,17,8,1
"1647",1865,1866,1866,"white","age.gp3","NoTr","NoTrade","Group",17,1,7,5,4,1,13,3,6,11,3,14,10,7,1
"1648",2151,2152,2152,"other","age.gp2","NoTr","NoTrade","NoGroup",6,0,3,2,1,0,6,0,3,3,0,6,3,3,1
"1649",2369,2370,2370,"black","age.gp2","Tr","NoTrade","Group",12,0,7,3,2,6,5,1,3,9,2,10,7,5,1
"1650",2648,2649,2649,"white","age.gp2","NoTr","NoTrade","Group",17,2,11,3,1,2,14,1,6,11,1,16,11,6,1
"1651",2692,2693,2693,"white","age.gp4","NoTr","NoTrade","Group",12,2,4,0,6,3,9,0,6,6,0,12,7,5,1
"1652",2703,2704,2704,"white","age.gp4","NoTr","NoTrade","Group",7,0,2,3,2,0,7,0,3,4,0,7,7,0,1
"1653",2835,2836,2836,"black","age.gp2","NoTr","NoTrade","NoGroup",12,0,5,5,2,9,3,0,4,8,2,10,6,6,1
"1654",2920,2921,2921,"white","age.gp1","NoTr","NoTrade","NoGroup",8,5,2,0,1,0,5,3,2,6,1,7,5,3,1
"1655",503,504,504,"black","age.gp4","NoTr","NoTrade","NoGroup",1,0,1,0,0,0,1,0,1,0,0,1,1,0,1
"1656",985,986,986,"white","age.gp4","NoTr","NoTrade","NoGroup",4,0,1,0,3,1,3,0,1,3,0,4,2,2,1
"1657",1295,1296,1296,"white","age.gp4","NoTr","NoTrade","Group",11,0,5,2,4,1,9,1,6,5,1,10,8,3,1
"1658",1591,1592,1592,"white","age.gp4","Tr","NoTrade","Group",11,0,4,0,7,0,11,0,6,5,0,11,6,5,1
"1659",243,244,244,"white","age.gp2","Tr","NoTrade","Group",25,4,11,7,3,3,19,3,11,14,0,25,13,12,1
"1660",902,903,903,"other","age.gp1","Tr","NoTrade","NoGroup",6,0,1,3,2,1,5,0,1,5,1,5,4,2,1
"1661",948,949,949,"white","age.gp3","Tr","NoTrade","Group",18,2,10,2,4,2,15,1,5,13,1,17,15,3,1
"1662",1114,1115,1115,"other","age.gp1","NoTr","NoTrade","NoGroup",2,0,1,0,1,0,2,0,1,1,0,2,1,1,1
"1663",1268,1269,1269,"black","age.gp3","NoTr","NoTrade","NoGroup",3,0,1,2,0,2,1,0,1,2,1,2,2,1,1
"1664",1486,1487,1487,"white","age.gp4","NoTr","NoTrade","NoGroup",5,1,2,0,2,0,4,1,2,3,1,4,3,2,1
"1665",2099,2100,2100,"black","age.gp3","NoTr","NoTrade","NoGroup",6,0,3,2,1,2,4,0,5,1,0,6,5,1,1
"1666",323,324,324,"white","age.gp4","NoTr","NoTrade","Group",14,1,4,2,7,2,10,2,5,9,0,14,7,7,1
"1667",574,575,575,"other","age.gp4","NoTr","NoTrade","NoGroup",3,0,2,1,0,0,3,0,3,0,0,3,3,0,1
"1668",1106,1107,1107,"other","age.gp1","NoTr","NoTrade","NoGroup",7,3,1,2,1,0,7,0,5,2,1,6,5,2,1
"1669",1986,1987,1987,"white","age.gp4","Tr","NoTrade","NoGroup",1,0,1,0,0,0,1,0,1,0,0,1,1,0,1
"1670",2557,2558,2558,"other","age.gp1","NoTr","NoTrade","NoGroup",2,1,1,0,0,0,2,0,1,1,0,2,1,1,1
"1671",2580,2581,2581,"white","age.gp4","NoTr","NoTrade","Group",3,0,1,1,1,1,2,0,2,1,1,2,2,1,1
"1672",2868,2869,2869,"white","age.gp1","NoTr","NoTrade","Group",26,12,6,6,2,1,18,7,8,18,4,22,15,11,1
"1673",882,883,883,"white","age.gp3","NoTr","Trade","Group",9,1,3,1,4,1,5,3,4,5,2,7,6,3,1
"1674",947,948,948,"white","age.gp3","Tr","NoTrade","Group",15,1,5,2,7,1,13,1,5,10,2,13,11,4,1
"1675",2035,2036,2036,"white","age.gp4","Tr","NoTrade","Group",10,0,4,0,6,1,9,0,3,7,1,9,5,5,1
"1676",2157,2158,2158,"other","age.gp2","NoTr","NoTrade","NoGroup",6,0,4,2,0,0,6,0,2,4,0,6,3,3,1
"1677",2559,2560,2560,"white","age.gp4","NoTr","NoTrade","Group",10,0,6,1,3,1,9,0,6,4,2,8,8,2,1
"1678",2789,2790,2790,"white","age.gp2","NoTr","NoTrade","Group",15,1,7,3,4,0,14,1,8,7,2,13,7,8,1
"1679",589,590,590,"other","age.gp4","NoTr","NoTrade","NoGroup",2,1,1,0,0,1,1,0,1,1,0,2,1,1,1
"1680",1122,1123,1123,"other","age.gp1","NoTr","NoTrade","NoGroup",4,2,1,1,0,0,4,0,1,3,0,4,2,2,1
"1681",1434,1435,1435,"white","age.gp3","Tr","NoTrade","NoGroup",5,1,3,1,0,0,4,1,2,3,1,4,4,1,1
"1682",1658,1659,1659,"other","age.gp2","NoTr","NoTrade","NoGroup",3,0,3,0,0,0,3,0,2,1,0,3,1,2,1
"1683",2248,2249,2249,"white","age.gp4","Tr","NoTrade","Group",11,2,2,3,4,1,9,1,1,10,1,10,7,4,1
"1684",320,321,321,"white","age.gp4","NoTr","NoTrade","Group",13,0,5,0,8,2,10,1,4,9,1,12,7,6,1
"1685",1111,1112,1112,"other","age.gp1","NoTr","NoTrade","NoGroup",6,4,1,1,0,0,6,0,4,2,0,6,3,3,1
"1686",1859,1860,1860,"white","age.gp3","NoTr","NoTrade","Group",10,3,6,1,0,1,9,0,3,7,0,10,7,3,1
"1687",1863,1864,1864,"white","age.gp3","NoTr","NoTrade","Group",17,0,8,6,3,5,12,0,6,11,1,16,11,6,1
"1688",2518,2519,2519,"black","age.gp2","NoTr","NoTrade","Group",11,1,4,2,4,5,5,1,5,6,1,10,6,5,1
"1689",2856,2857,2857,"black","age.gp3","NoTr","NoTrade","Group",11,0,5,4,2,3,8,0,3,8,2,9,9,2,1
"1690",248,249,249,"white","age.gp4","NoTr","NoTrade","NoGroup",6,0,2,0,4,0,5,1,1,5,0,6,5,1,1
"1691",297,298,298,"white","age.gp4","NoTr","NoTrade","Group",7,1,0,1,5,3,3,1,2,5,2,5,3,4,1
"1692",249,250,250,"white","age.gp4","NoTr","NoTrade","NoGroup",1,0,0,0,1,0,1,0,0,1,0,1,1,0,1
"1693",1286,1287,1287,"white","age.gp4","NoTr","NoTrade","Group",11,2,1,1,7,2,9,0,3,8,1,10,7,4,1
"1694",250,251,251,"white","age.gp4","NoTr","NoTrade","NoGroup",1,0,0,1,0,0,1,0,0,1,1,0,1,0,1
"1695",251,252,252,"white","age.gp4","NoTr","NoTrade","NoGroup",3,0,2,0,1,0,3,0,2,1,0,3,3,0,1
"1696",343,344,344,"white","age.gp2","NoTr","NoTrade","Group",23,1,10,4,8,4,17,2,4,19,5,18,15,8,1
"1697",679,680,680,"white","age.gp4","Tr","NoTrade","Group",11,0,1,1,9,2,9,0,5,6,1,10,8,3,1
"1698",252,253,253,"white","age.gp4","NoTr","NoTrade","NoGroup",4,1,1,0,2,0,3,1,1,3,0,4,3,1,1
"1699",1882,1883,1883,"other","age.gp1","NoTr","NoTrade","Group",12,5,2,4,1,0,12,0,5,7,1,11,5,7,1
"1700",2711,2712,2712,"white","age.gp4","NoTr","NoTrade","Group",10,0,3,3,4,0,9,1,4,6,0,10,4,6,1
"1701",691,692,692,"white","age.gp4","Tr","NoTrade","Group",13,2,2,1,8,1,9,3,6,7,1,12,8,5,1
"1702",1646,1647,1647,"other","age.gp2","NoTr","NoTrade","NoGroup",3,0,1,0,2,0,3,0,1,2,0,3,2,1,1
"1703",1775,1776,1776,"white","age.gp4","Tr","NoTrade","Group",13,1,1,1,10,0,13,0,4,9,1,12,10,3,1
"1704",2372,2373,2373,"black","age.gp2","NoTr","NoTrade","NoGroup",7,1,2,2,2,1,6,0,2,5,2,5,4,3,1
"1705",2649,2650,2650,"white","age.gp2","NoTr","NoTrade","Group",14,0,8,1,5,2,12,0,6,8,1,13,9,5,1
"1706",256,257,257,"white","age.gp4","NoTr","NoTrade","NoGroup",1,0,0,0,1,0,1,0,0,1,0,1,1,0,1
"1707",2574,2575,2575,"white","age.gp4","NoTr","NoTrade","Group",7,0,1,2,4,0,7,0,2,5,0,7,3,4,1
"1708",257,258,258,"white","age.gp4","NoTr","NoTrade","NoGroup",3,0,1,1,1,1,2,0,1,2,0,3,2,1,1
"1709",1072,1073,1073,"white","age.gp4","NoTr","NoTrade","Group",6,0,2,0,4,1,4,1,3,3,1,5,3,3,1
"1710",258,259,259,"white","age.gp4","NoTr","NoTrade","NoGroup",7,0,0,0,7,0,7,0,4,3,0,7,5,2,1
"1711",415,416,416,"white","age.gp4","NoTr","NoTrade","NoGroup",7,1,0,1,5,0,7,0,2,5,0,7,2,5,1
"1712",1200,1201,1201,"white","age.gp4","Tr","NoTrade","NoGroup",10,1,3,3,3,0,10,0,4,6,2,8,6,4,1
"1713",2947,2948,2948,"white","age.gp4","NoTr","NoTrade","Group",12,1,0,2,9,1,11,0,4,8,0,12,9,3,1
"1714",259,260,260,"white","age.gp4","NoTr","NoTrade","NoGroup",6,0,3,0,3,1,5,0,0,6,0,6,5,1,1
"1715",1059,1060,1060,"white","age.gp4","NoTr","NoTrade","Group",8,0,2,0,6,1,7,0,5,3,0,8,6,2,1
"1716",1812,1813,1813,"black","age.gp4","NoTr","NoTrade","NoGroup",4,1,0,2,1,2,2,0,2,2,1,3,1,3,1
"1717",2171,2172,2172,"white","age.gp2","NoTr","NoTrade","Group",17,3,6,3,5,4,12,1,7,10,1,16,11,6,1
"1718",1042,1043,1043,"black","age.gp4","NoTr","NoTrade","NoGroup",3,0,1,0,2,1,2,0,0,3,0,3,2,1,1
"1719",1079,1080,1080,"white","age.gp4","NoTr","NoTrade","Group",15,0,6,1,8,0,14,1,5,10,1,14,5,10,1
"1720",2937,2938,2938,"white","age.gp4","NoTr","NoTrade","Group",15,0,3,3,9,1,14,0,3,12,0,15,7,8,1
"1721",261,262,262,"white","age.gp4","NoTr","NoTrade","NoGroup",4,0,0,0,4,1,3,0,0,4,0,4,2,2,1
"1722",439,440,440,"white","age.gp4","NoTr","NoTrade","NoGroup",5,0,0,0,5,0,5,0,1,4,0,5,2,3,1
"1723",1294,1295,1295,"white","age.gp4","NoTr","NoTrade","Group",13,1,2,3,7,2,11,0,5,8,1,12,9,4,1
"1724",1520,1521,1521,"black","age.gp4","NoTr","NoTrade","NoGroup",1,0,0,0,1,0,1,0,0,1,0,1,0,1,1
"1725",262,263,263,"white","age.gp4","NoTr","NoTrade","NoGroup",9,1,0,0,8,1,7,1,2,7,0,9,6,3,1
"1726",269,270,270,"white","age.gp4","NoTr","NoTrade","NoGroup",1,0,0,0,1,0,1,0,0,1,0,1,0,1,1
"1727",1889,1890,1890,"other","age.gp1","NoTr","NoTrade","Group",7,2,2,2,1,0,7,0,4,3,0,7,2,5,1
"1728",2178,2179,2179,"white","age.gp4","NoTr","NoTrade","NoGroup",9,0,2,4,3,1,8,0,1,8,0,9,6,3,1
"1729",263,264,264,"white","age.gp4","NoTr","NoTrade","NoGroup",5,0,1,0,4,0,5,0,2,3,0,5,4,1,1
"1730",1280,1281,1281,"white","age.gp4","NoTr","NoTrade","Group",12,1,3,4,4,1,8,3,5,7,0,12,8,4,1
"1731",1485,1486,1486,"white","age.gp4","NoTr","NoTrade","NoGroup",8,0,3,2,3,0,7,1,2,6,0,8,4,4,1
"1732",2038,2039,2039,"white","age.gp4","Tr","NoTrade","Group",14,1,3,2,8,1,11,2,3,11,1,13,10,4,1
"1733",265,266,266,"white","age.gp4","NoTr","NoTrade","NoGroup",6,0,1,0,5,0,6,0,3,3,0,6,5,1,1
"1734",432,433,433,"white","age.gp4","NoTr","NoTrade","NoGroup",1,0,0,0,1,0,1,0,0,1,0,1,0,1,1
"1735",1796,1797,1797,"white","age.gp4","Tr","NoTrade","Group",13,3,2,0,8,1,11,1,4,9,1,12,8,5,1
"1736",1336,1337,1337,"white","age.gp3","NoTr","NoTrade","NoGroup",10,1,5,2,2,1,8,1,4,6,1,9,4,6,1
"1737",270,271,271,"white","age.gp4","NoTr","NoTrade","NoGroup",6,1,1,0,4,1,4,1,2,4,1,5,4,2,1
"1738",566,567,567,"other","age.gp4","NoTr","NoTrade","NoGroup",2,0,0,1,1,0,2,0,0,2,0,2,1,1,1
"1739",1204,1205,1205,"white","age.gp4","Tr","NoTrade","NoGroup",5,1,1,0,3,0,4,1,0,5,1,4,2,3,1
"1740",2517,2518,2518,"black","age.gp2","NoTr","NoTrade","Group",18,3,5,3,7,7,11,0,5,13,2,16,10,8,1
"1741",271,272,272,"white","age.gp4","NoTr","NoTrade","NoGroup",3,0,1,2,0,0,3,0,1,2,0,3,2,1,1
"1742",273,274,274,"white","age.gp4","NoTr","NoTrade","NoGroup",3,0,0,1,2,1,2,0,0,3,0,3,1,2,1
"1743",400,401,401,"black","age.gp4","NoTr","NoTrade","NoGroup",6,0,0,2,4,3,3,0,1,5,0,6,2,4,1
"1744",791,792,792,"white","age.gp4","NoTr","NoTrade","NoGroup",7,1,2,0,4,1,5,1,1,6,0,7,3,4,1
"1745",274,275,275,"white","age.gp4","NoTr","NoTrade","NoGroup",1,0,0,0,1,0,1,0,1,0,0,1,1,0,1
"1746",275,276,276,"white","age.gp4","NoTr","NoTrade","NoGroup",3,0,0,0,3,0,3,0,1,2,0,3,3,0,1
"1747",276,277,277,"white","age.gp4","NoTr","NoTrade","NoGroup",1,0,0,0,1,0,1,0,0,1,0,1,1,0,1
"1748",1573,1574,1574,"white","age.gp4","Tr","NoTrade","Group",16,1,2,3,10,3,13,0,4,12,1,15,9,7,1
"1749",279,280,280,"white","age.gp4","NoTr","NoTrade","NoGroup",1,0,0,0,1,0,1,0,1,0,0,1,1,0,1
"1750",1563,1564,1564,"white","age.gp4","Tr","NoTrade","Group",15,0,3,2,10,2,12,1,4,11,0,15,9,6,1
"1751",1484,1485,1485,"white","age.gp4","NoTr","NoTrade","NoGroup",6,1,3,1,1,2,4,0,2,4,1,5,5,1,1
"1752",1858,1859,1859,"white","age.gp3","NoTr","NoTrade","Group",21,0,12,2,7,0,18,3,9,12,1,20,12,9,1
"1753",2884,2885,2885,"white","age.gp1","NoTr","NoTrade","Group",21,11,5,3,2,2,15,4,9,12,2,19,8,13,1
"1754",585,586,586,"other","age.gp4","NoTr","NoTrade","NoGroup",3,0,1,0,2,0,3,0,3,0,0,3,1,2,1
"1755",1638,1639,1639,"other","age.gp2","NoTr","NoTrade","NoGroup",8,1,3,3,1,1,7,0,2,6,0,8,3,5,1
"1756",1776,1777,1777,"white","age.gp4","Tr","NoTrade","Group",19,0,7,3,9,2,17,0,7,12,3,16,13,6,1
"1757",2274,2275,2275,"black","age.gp2","Tr","Trade","Group",17,1,9,6,1,8,7,2,5,12,2,15,8,9,1
"1758",2331,2332,2332,"white","age.gp3","Tr","NoTrade","Group",23,2,9,8,4,0,22,1,11,12,2,21,18,5,1
"1759",2421,2422,2422,"white","age.gp3","NoTr","Trade","Group",15,3,3,6,3,3,11,1,4,11,1,14,9,6,1
"1760",743,744,744,"white","age.gp2","Tr","NoTrade","Group",20,5,5,5,5,1,16,3,10,10,1,19,16,4,1
"1761",1135,1136,1136,"white","age.gp2","Tr","NoTrade","Group",31,3,17,4,7,3,23,5,15,16,1,30,25,6,1
"1762",2794,2795,2795,"white","age.gp2","Tr","NoTrade","NoGroup",9,1,5,2,1,1,8,0,4,5,1,8,6,3,1
"1763",884,885,885,"white","age.gp3","NoTr","Trade","Group",10,1,4,5,0,1,8,1,3,7,0,10,6,4,1
"1764",888,889,889,"other","age.gp1","Tr","NoTrade","NoGroup",5,0,2,1,2,1,4,0,2,3,1,4,4,1,1
"1765",1318,1319,1319,"white","age.gp2","NoTr","NoTrade","NoGroup",12,1,6,2,3,1,10,1,5,7,0,12,7,5,1
"1766",1389,1390,1390,"black","age.gp3","NoTr","NoTrade","NoGroup",6,1,4,0,1,0,3,3,1,5,0,6,2,4,1
"1767",2424,2425,2425,"white","age.gp3","NoTr","Trade","Group",13,3,3,2,5,2,11,0,5,8,1,12,9,4,1
"1768",359,360,360,"black","age.gp4","NoTr","NoTrade","NoGroup",6,0,2,1,3,3,3,0,2,4,1,5,3,3,1
"1769",957,958,958,"black","age.gp2","Tr","NoTrade","NoGroup",11,0,7,2,2,5,4,2,4,7,1,10,5,6,1
"1770",1798,1799,1799,"white","age.gp4","Tr","NoTrade","Group",12,2,3,2,5,1,9,2,2,10,1,11,7,5,1
"1771",2755,2756,2756,"white","age.gp3","NoTr","NoTrade","NoGroup",9,1,6,1,1,2,6,1,3,6,1,8,5,4,1
"1772",285,286,286,"white","age.gp1","NoTr","NoTrade","NoGroup",11,3,1,3,4,0,11,0,5,6,2,9,8,3,1
"1773",984,985,985,"white","age.gp4","NoTr","NoTrade","NoGroup",7,1,1,3,2,1,6,0,3,4,1,6,4,3,1
"1774",1053,1054,1054,"white","age.gp4","NoTr","NoTrade","Group",13,2,3,1,7,1,11,1,5,8,0,13,8,5,1
"1775",286,287,287,"white","age.gp1","NoTr","NoTrade","NoGroup",12,8,1,2,1,1,7,4,4,8,1,11,4,8,1
"1776",627,628,628,"other","age.gp1","NoTr","Trade","Group",6,2,0,2,2,0,6,0,1,5,0,6,4,2,1
"1777",1005,1006,1006,"white","age.gp1","Tr","NoTrade","Group",29,14,4,5,6,3,20,6,5,24,1,28,10,19,1
"1778",1084,1085,1085,"white","age.gp4","NoTr","NoTrade","Group",7,1,1,1,4,0,6,1,3,4,0,7,4,3,1
"1779",1126,1127,1127,"other","age.gp1","NoTr","NoTrade","NoGroup",7,5,0,1,1,1,6,0,2,5,1,6,3,4,1
"1780",1310,1311,1311,"white","age.gp1","NoTr","NoTrade","NoGroup",11,7,1,1,2,1,9,1,1,10,0,11,2,9,1
"1781",931,932,932,"white","age.gp3","NoTr","NoTrade","NoGroup",12,2,5,3,2,3,7,2,6,6,2,10,8,4,1
"1782",1454,1455,1455,"white","age.gp1","NoTr","NoTrade","NoGroup",12,6,2,4,0,1,9,2,4,8,3,9,7,5,1
"1783",288,289,289,"white","age.gp1","NoTr","NoTrade","NoGroup",8,7,0,1,0,3,2,3,0,8,1,7,2,6,1
"1784",463,464,464,"black","age.gp3","NoTr","Trade","Group",11,2,4,2,3,7,3,1,1,10,2,9,5,6,1
"1785",1091,1092,1092,"black","age.gp1","NoTr","NoTrade","NoGroup",9,6,0,2,1,4,4,1,4,5,2,7,4,5,1
"1786",1140,1141,1141,"white","age.gp1","NoTr","NoTrade","NoGroup",11,9,0,2,0,1,8,2,2,9,1,10,3,8,1
"1787",1450,1451,1451,"black","age.gp1","NoTr","NoTrade","NoGroup",5,3,1,1,0,2,2,1,0,5,0,5,2,3,1
"1788",2504,2505,2505,"other","age.gp1","NoTr","NoTrade","NoGroup",4,4,0,0,0,0,4,0,0,4,0,4,0,4,1
"1789",2556,2557,2557,"other","age.gp1","NoTr","NoTrade","NoGroup",6,3,2,1,0,0,5,1,1,5,2,4,3,3,1
"1790",2873,2874,2874,"white","age.gp1","NoTr","NoTrade","NoGroup",10,6,0,2,2,0,6,4,2,8,2,8,4,6,1
"1791",289,290,290,"white","age.gp1","NoTr","NoTrade","NoGroup",6,2,1,1,2,0,6,0,3,3,0,6,3,3,1
"1792",1787,1788,1788,"white","age.gp4","Tr","NoTrade","Group",5,3,0,0,2,0,2,3,1,4,0,5,2,3,1
"1793",1975,1976,1976,"white","age.gp4","Tr","NoTrade","NoGroup",3,1,0,1,1,0,3,0,1,2,0,3,1,2,1
"1794",2326,2327,2327,"white","age.gp3","Tr","NoTrade","Group",9,2,4,2,1,1,6,2,3,6,1,8,7,2,1
"1795",2917,2918,2918,"white","age.gp1","NoTr","NoTrade","NoGroup",11,5,4,1,1,0,8,3,4,7,0,11,5,6,1
"1796",375,376,376,"black","age.gp4","NoTr","NoTrade","NoGroup",2,0,1,0,1,2,0,0,0,2,0,2,1,1,1
"1797",480,481,481,"black","age.gp4","NoTr","NoTrade","NoGroup",6,0,3,0,3,1,5,0,2,4,0,6,6,0,1
"1798",501,502,502,"black","age.gp4","NoTr","NoTrade","NoGroup",4,0,3,0,1,2,2,0,0,4,1,3,3,1,1
"1799",291,292,292,"black","age.gp2","NoTr","NoTrade","Group",11,0,6,2,3,7,2,2,3,8,2,9,7,4,1
"1800",2168,2169,2169,"black","age.gp2","NoTr","NoTrade","NoGroup",6,2,4,0,0,4,2,0,3,3,0,6,5,1,1
"1801",510,511,511,"white","age.gp2","Tr","NoTrade","NoGroup",4,0,3,0,1,1,3,0,1,3,0,4,2,2,1
"1802",1356,1357,1357,"black","age.gp4","NoTr","NoTrade","Group",11,0,4,0,7,7,4,0,4,7,1,10,4,7,1
"1803",2805,2806,2806,"other","age.gp2","NoTr","NoTrade","NoGroup",1,0,1,0,0,1,0,0,0,1,0,1,1,0,1
"1804",997,998,998,"white","age.gp4","NoTr","NoTrade","NoGroup",6,0,2,0,4,1,5,0,2,4,0,6,6,0,1
"1805",2276,2277,2277,"black","age.gp2","Tr","Trade","Group",21,3,8,4,6,12,7,2,4,17,1,20,9,12,1
"1806",2345,2346,2346,"black","age.gp2","NoTr","NoTrade","Group",21,1,12,4,4,16,3,2,5,16,3,18,11,10,1
"1807",2804,2805,2805,"other","age.gp2","NoTr","NoTrade","NoGroup",5,0,3,1,1,3,2,0,1,4,1,4,2,3,1
"1808",518,519,519,"black","age.gp3","NoTr","NoTrade","NoGroup",7,0,5,1,1,4,2,1,2,5,0,7,4,3,1
"1809",650,651,651,"black","age.gp2","NoTr","NoTrade","NoGroup",10,1,5,3,1,5,2,3,1,9,2,8,6,4,1
"1810",1259,1260,1260,"black","age.gp3","NoTr","NoTrade","NoGroup",11,2,5,1,3,8,3,0,2,9,3,8,6,5,1
"1811",1315,1316,1316,"white","age.gp2","NoTr","NoTrade","NoGroup",8,0,4,3,1,2,4,2,4,4,1,7,6,2,1
"1812",1467,1468,1468,"white","age.gp2","NoTr","Trade","Group",26,3,11,6,6,4,18,4,6,20,3,23,19,7,1
"1813",2718,2719,2719,"white","age.gp4","NoTr","NoTrade","Group",16,1,5,2,8,2,13,1,5,11,1,15,10,6,1
"1814",1199,1200,1200,"white","age.gp4","Tr","NoTrade","NoGroup",4,0,0,0,4,0,4,0,1,3,0,4,3,1,1
"1815",1410,1411,1411,"white","age.gp3","NoTr","NoTrade","Group",11,0,6,0,5,0,8,3,5,6,0,11,8,3,1
"1816",2403,2404,2404,"white","age.gp3","NoTr","NoTrade","NoGroup",9,0,6,1,2,0,8,1,5,4,0,9,8,1,1
"1817",1539,1540,1540,"black","age.gp4","NoTr","NoTrade","NoGroup",4,0,1,1,2,1,3,0,1,3,0,4,2,2,1
"1818",2902,2903,2903,"other","age.gp1","NoTr","NoTrade","NoGroup",3,1,0,1,1,0,3,0,1,2,0,3,2,1,1
"1819",2949,2950,2950,"white","age.gp4","NoTr","NoTrade","Group",10,1,1,1,7,0,10,0,3,7,0,10,8,2,1
"1820",544,545,545,"white","age.gp4","NoTr","NoTrade","NoGroup",8,1,3,2,2,1,5,2,1,7,0,8,3,5,1
"1821",901,902,902,"other","age.gp1","Tr","NoTrade","NoGroup",2,1,0,0,1,1,1,0,0,2,0,2,1,1,1
"1822",1365,1366,1366,"black","age.gp4","NoTr","NoTrade","Group",9,0,1,1,7,4,5,0,1,8,0,9,6,3,1
"1823",2216,2217,2217,"black","age.gp4","NoTr","Trade","Group",7,2,0,0,5,1,4,2,2,5,1,6,4,3,1
"1824",2240,2241,2241,"black","age.gp4","NoTr","Trade","Group",4,0,0,1,3,2,2,0,0,4,0,4,2,2,1
"1825",534,535,535,"white","age.gp4","NoTr","NoTrade","NoGroup",3,0,0,1,2,1,2,0,0,3,0,3,1,2,1
"1826",912,913,913,"other","age.gp1","Tr","NoTrade","NoGroup",5,3,1,0,1,0,5,0,1,4,0,5,2,3,1
"1827",300,301,301,"white","age.gp4","NoTr","NoTrade","Group",4,0,0,1,3,0,4,0,1,3,0,4,3,1,1
"1828",537,538,538,"white","age.gp4","NoTr","NoTrade","NoGroup",1,0,0,0,1,0,1,0,0,1,0,1,1,0,1
"1829",2565,2566,2566,"white","age.gp4","NoTr","NoTrade","Group",9,1,3,1,4,3,6,0,2,7,0,9,5,4,1
"1830",301,302,302,"white","age.gp4","NoTr","NoTrade","Group",11,0,3,0,8,2,8,1,5,6,0,11,6,5,1
"1831",313,314,314,"white","age.gp4","NoTr","NoTrade","Group",7,0,1,0,6,0,7,0,2,5,0,7,6,1,1
"1832",1180,1181,1181,"white","age.gp4","Tr","NoTrade","NoGroup",9,1,1,3,4,0,8,1,3,6,0,9,6,3,1
"1833",1298,1299,1299,"white","age.gp4","NoTr","NoTrade","Group",10,2,2,1,5,0,10,0,1,9,0,10,7,3,1
"1834",1587,1588,1588,"white","age.gp4","Tr","NoTrade","Group",11,1,1,3,6,1,9,1,2,9,2,9,8,3,1
"1835",2015,2016,2016,"black","age.gp4","NoTr","NoTrade","NoGroup",3,0,1,0,2,2,1,0,0,3,0,3,1,2,1
"1836",2150,2151,2151,"other","age.gp2","NoTr","NoTrade","NoGroup",4,2,0,1,1,0,4,0,0,4,1,3,3,1,1
"1837",2641,2642,2642,"white","age.gp4","NoTr","NoTrade","NoGroup",7,0,2,1,4,0,6,1,4,3,0,7,6,1,1
"1838",760,761,761,"white","age.gp4","NoTr","NoTrade","NoGroup",2,0,0,1,1,0,2,0,0,2,0,2,1,1,1
"1839",777,778,778,"white","age.gp4","NoTr","NoTrade","NoGroup",6,1,0,3,2,1,4,1,2,4,0,6,4,2,1
"1840",1038,1039,1039,"black","age.gp4","NoTr","NoTrade","NoGroup",5,0,0,1,4,4,1,0,0,5,1,4,3,2,1
"1841",317,318,318,"white","age.gp4","NoTr","NoTrade","Group",14,2,3,4,5,0,13,1,6,8,0,14,8,6,1
"1842",1570,1571,1571,"white","age.gp4","Tr","NoTrade","Group",15,1,5,2,7,1,13,1,5,10,1,14,8,7,1
"1843",304,305,305,"white","age.gp4","NoTr","NoTrade","Group",9,4,2,2,1,1,5,3,2,7,0,9,5,4,1
"1844",1887,1888,1888,"other","age.gp1","NoTr","NoTrade","Group",11,5,3,1,2,0,11,0,5,6,0,11,6,5,1
"1845",2901,2902,2902,"other","age.gp1","NoTr","NoTrade","NoGroup",3,0,0,0,3,0,3,0,1,2,0,3,3,0,1
"1846",2913,2914,2914,"other","age.gp1","NoTr","NoTrade","NoGroup",6,2,2,1,1,0,6,0,2,4,0,6,3,3,1
"1847",305,306,306,"white","age.gp4","NoTr","NoTrade","Group",12,0,3,1,8,0,11,1,9,3,0,12,7,5,1
"1848",440,441,441,"white","age.gp4","NoTr","NoTrade","NoGroup",4,0,1,1,2,1,3,0,0,4,0,4,3,1,1
"1849",845,846,846,"white","age.gp2","Tr","NoTrade","NoGroup",6,0,3,1,2,2,4,0,2,4,1,5,5,1,1
"1850",1137,1138,1138,"white","age.gp2","Tr","NoTrade","Group",19,4,6,4,5,2,14,3,3,16,1,18,14,5,1
"1851",1481,1482,1482,"white","age.gp4","NoTr","NoTrade","NoGroup",1,0,0,0,1,0,1,0,0,1,0,1,1,0,1
"1852",472,473,473,"black","age.gp3","NoTr","Trade","Group",10,0,4,2,4,6,4,0,3,7,1,9,6,4,1
"1853",1694,1695,1695,"white","age.gp4","NoTr","Trade","NoGroup",2,0,0,0,2,0,2,0,0,2,0,2,2,0,1
"1854",2942,2943,2943,"white","age.gp4","NoTr","NoTrade","Group",12,1,1,0,10,0,11,1,5,7,1,11,8,4,1
"1855",1173,1174,1174,"white","age.gp4","NoTr","NoTrade","NoGroup",1,0,0,0,1,0,1,0,0,1,0,1,1,0,1
"1856",1666,1667,1667,"black","age.gp1","Tr","Trade","Group",16,3,2,9,2,6,8,2,4,12,4,12,10,6,1
"1857",1786,1787,1787,"white","age.gp4","Tr","NoTrade","Group",9,0,2,1,6,1,8,0,3,6,0,9,6,3,1
"1858",2352,2353,2353,"white","age.gp3","Tr","NoTrade","NoGroup",7,3,1,1,2,1,6,0,3,4,0,7,4,3,1
"1859",308,309,309,"white","age.gp4","NoTr","NoTrade","Group",11,2,3,0,6,0,10,1,4,7,0,11,8,3,1
"1860",1017,1018,1018,"white","age.gp1","NoTr","NoTrade","NoGroup",11,5,4,1,1,0,9,2,3,8,0,11,4,7,1
"1861",2546,2547,2547,"other","age.gp1","NoTr","NoTrade","NoGroup",2,1,0,0,1,1,1,0,1,1,0,2,1,1,1
"1862",309,310,310,"white","age.gp4","NoTr","NoTrade","Group",11,1,1,4,5,1,10,0,7,4,2,9,10,1,1
"1863",1201,1202,1202,"white","age.gp4","Tr","NoTrade","NoGroup",7,1,1,2,3,0,6,1,2,5,0,7,5,2,1
"1864",2228,2229,2229,"black","age.gp4","NoTr","Trade","Group",9,0,2,2,5,5,4,0,2,7,1,8,5,4,1
"1865",821,822,822,"white","age.gp3","NoTr","NoTrade","NoGroup",9,2,3,1,3,0,7,2,3,6,0,9,7,2,1
"1866",1625,1626,1626,"white","age.gp1","NoTr","NoTrade","NoGroup",6,2,2,1,1,1,5,0,0,6,1,5,3,3,1
"1867",564,565,565,"other","age.gp4","NoTr","NoTrade","NoGroup",2,0,1,0,1,0,2,0,1,1,0,2,2,0,1
"1868",892,893,893,"other","age.gp1","Tr","NoTrade","NoGroup",4,1,0,1,2,0,4,0,0,4,0,4,2,2,1
"1869",1517,1518,1518,"black","age.gp4","NoTr","NoTrade","NoGroup",9,1,0,2,6,4,5,0,2,7,0,9,6,3,1
"1870",2619,2620,2620,"white","age.gp4","NoTr","NoTrade","NoGroup",1,0,0,0,1,0,1,0,0,1,0,1,1,0,1
"1871",1508,1509,1509,"white","age.gp4","NoTr","NoTrade","NoGroup",7,1,1,0,5,1,5,1,1,6,0,7,4,3,1
"1872",2585,2586,2586,"white","age.gp4","NoTr","NoTrade","Group",12,0,2,3,7,1,11,0,7,5,0,12,8,4,1
"1873",1361,1362,1362,"black","age.gp4","NoTr","NoTrade","Group",8,0,1,2,5,5,3,0,3,5,1,7,5,3,1
"1874",2264,2265,2265,"white","age.gp4","Tr","NoTrade","Group",7,1,0,3,3,0,7,0,4,3,0,7,6,1,1
"1875",1160,1161,1161,"white","age.gp4","NoTr","NoTrade","NoGroup",4,0,2,0,2,0,4,0,1,3,0,4,3,1,1
"1876",1988,1989,1989,"white","age.gp4","Tr","NoTrade","NoGroup",6,0,2,0,4,0,6,0,1,5,0,6,5,1,1
"1877",425,426,426,"white","age.gp4","NoTr","NoTrade","NoGroup",1,0,0,0,1,0,1,0,0,1,0,1,1,0,1
"1878",1404,1405,1405,"white","age.gp3","NoTr","NoTrade","Group",17,3,5,3,6,1,14,2,7,10,0,17,7,10,1
"1879",1628,1629,1629,"white","age.gp1","NoTr","NoTrade","NoGroup",8,3,1,2,2,1,7,0,2,6,1,7,4,4,1
"1880",1935,1936,1936,"white","age.gp4","NoTr","NoTrade","Group",10,0,2,0,8,0,10,0,7,3,0,10,7,3,1
"1881",2251,2252,2252,"white","age.gp4","Tr","NoTrade","Group",12,1,2,3,6,2,9,1,2,10,1,11,8,4,1
"1882",630,631,631,"other","age.gp1","NoTr","Trade","Group",7,3,0,2,2,0,7,0,2,5,2,5,4,3,1
"1883",938,939,939,"white","age.gp3","NoTr","NoTrade","NoGroup",6,2,0,1,3,0,5,1,0,6,1,5,5,1,1
"1884",2670,2671,2671,"white","age.gp3","NoTr","NoTrade","NoGroup",11,0,4,3,4,0,10,1,5,6,0,11,6,5,1
"1885",1103,1104,1104,"black","age.gp2","NoTr","NoTrade","NoGroup",4,0,1,1,2,1,2,1,1,3,0,4,4,0,1
"1886",1501,1502,1502,"white","age.gp4","NoTr","NoTrade","NoGroup",5,1,2,1,1,1,3,1,0,5,0,5,1,4,1
"1887",2790,2791,2791,"white","age.gp2","NoTr","NoTrade","Group",19,3,7,2,7,0,15,4,5,14,1,18,11,8,1
"1888",1691,1692,1692,"white","age.gp4","NoTr","Trade","NoGroup",6,0,3,0,3,1,5,0,1,5,0,6,4,2,1
"1889",2000,2001,2001,"black","age.gp4","NoTr","NoTrade","NoGroup",7,0,2,0,5,5,2,0,1,6,0,7,4,3,1
"1890",2587,2588,2588,"white","age.gp4","NoTr","NoTrade","Group",11,1,2,2,6,2,9,0,3,8,2,9,8,3,1
"1891",2612,2613,2613,"white","age.gp4","NoTr","NoTrade","NoGroup",4,0,1,0,3,0,4,0,0,4,0,4,3,1,1
"1892",321,322,322,"white","age.gp4","NoTr","NoTrade","Group",10,0,2,2,6,1,9,0,4,6,0,10,6,4,1
"1893",533,534,534,"white","age.gp4","NoTr","NoTrade","NoGroup",3,0,1,0,2,0,3,0,2,1,0,3,3,0,1
"1894",1219,1220,1220,"white","age.gp4","NoTr","NoTrade","NoGroup",6,1,1,1,3,0,5,1,0,6,0,6,4,2,1
"1895",1530,1531,1531,"black","age.gp4","NoTr","NoTrade","NoGroup",7,0,2,1,4,4,3,0,2,5,0,7,5,2,1
"1896",442,443,443,"white","age.gp4","NoTr","NoTrade","NoGroup",6,1,3,0,2,0,5,1,5,1,0,6,4,2,1
"1897",580,581,581,"other","age.gp4","NoTr","NoTrade","NoGroup",2,0,0,0,2,0,2,0,0,2,0,2,2,0,1
"1898",1177,1178,1178,"white","age.gp4","Tr","NoTrade","NoGroup",3,1,0,0,2,0,3,0,1,2,0,3,1,2,1
"1899",1209,1210,1210,"white","age.gp4","NoTr","NoTrade","NoGroup",6,0,1,1,4,0,6,0,3,3,0,6,6,0,1
"1900",989,990,990,"white","age.gp4","NoTr","NoTrade","NoGroup",1,0,0,0,1,0,1,0,0,1,0,1,1,0,1
"1901",1052,1053,1053,"black","age.gp4","NoTr","NoTrade","NoGroup",5,0,1,1,3,1,3,1,2,3,0,5,4,1,1
"1902",1276,1277,1277,"white","age.gp4","NoTr","NoTrade","Group",13,0,4,1,8,1,12,0,3,10,2,11,7,6,1
"1903",1841,1842,1842,"black","age.gp3","NoTr","NoTrade","NoGroup",7,1,1,4,1,3,4,0,4,3,1,6,4,3,1
"1904",532,533,533,"white","age.gp4","NoTr","NoTrade","NoGroup",7,0,2,0,5,0,7,0,3,4,0,7,7,0,1
"1905",1479,1480,1480,"white","age.gp4","NoTr","NoTrade","NoGroup",6,0,2,0,4,0,6,0,4,2,0,6,5,1,1
"1906",549,550,550,"white","age.gp4","NoTr","NoTrade","NoGroup",5,0,1,1,3,0,5,0,2,3,1,4,5,0,1
"1907",1108,1109,1109,"other","age.gp1","NoTr","NoTrade","NoGroup",2,1,0,0,1,1,1,0,1,1,1,1,1,1,1
"1908",1993,1994,1994,"white","age.gp4","Tr","NoTrade","NoGroup",5,0,0,2,3,0,5,0,0,5,0,5,2,3,1
"1909",2922,2923,2923,"white","age.gp4","NoTr","NoTrade","Group",11,1,0,6,4,1,10,0,7,4,0,11,8,3,1
"1910",327,328,328,"white","age.gp1","NoTr","NoTrade","NoGroup",9,3,3,2,1,1,5,3,4,5,0,9,4,5,1
"1911",1244,1245,1245,"white","age.gp1","NoTr","NoTrade","NoGroup",17,8,3,3,3,0,14,3,5,12,0,17,9,8,1
"1912",1452,1453,1453,"black","age.gp1","NoTr","NoTrade","NoGroup",5,4,1,0,0,2,2,1,2,3,0,5,1,4,1
"1913",2891,2892,2892,"other","age.gp1","NoTr","NoTrade","NoGroup",3,2,0,0,1,1,2,0,1,2,0,3,0,3,1
"1914",594,595,595,"other","age.gp4","NoTr","NoTrade","NoGroup",5,1,0,0,4,0,5,0,2,3,0,5,4,1,1
"1915",1331,1332,1332,"white","age.gp3","NoTr","NoTrade","NoGroup",8,1,1,0,6,0,7,1,4,4,0,8,5,3,1
"1916",1615,1616,1616,"white","age.gp3","Tr","NoTrade","NoGroup",11,4,4,2,1,1,8,2,3,8,0,11,3,8,1
"1917",2320,2321,2321,"white","age.gp1","NoTr","NoTrade","NoGroup",9,4,2,2,1,4,5,0,5,4,0,9,3,6,1
"1918",330,331,331,"white","age.gp1","NoTr","NoTrade","NoGroup",10,8,0,2,0,1,5,4,2,8,2,8,6,4,1
"1919",909,910,910,"other","age.gp1","Tr","NoTrade","NoGroup",4,2,0,1,1,0,4,0,0,4,0,4,2,2,1
"1920",913,914,914,"other","age.gp1","Tr","NoTrade","NoGroup",4,3,0,0,1,0,4,0,3,1,0,4,1,3,1
"1921",1182,1183,1183,"white","age.gp4","Tr","NoTrade","NoGroup",6,2,0,2,2,0,6,0,1,5,2,4,2,4,1
"1922",507,508,508,"white","age.gp2","Tr","NoTrade","NoGroup",12,2,3,2,5,0,12,0,6,6,1,11,4,8,1
"1923",2667,2668,2668,"white","age.gp3","NoTr","NoTrade","NoGroup",12,1,6,3,2,3,8,1,1,11,1,11,7,5,1
"1924",333,334,334,"white","age.gp2","Tr","NoTrade","NoGroup",11,1,5,4,1,1,8,2,4,7,0,11,3,8,1
"1925",519,520,520,"black","age.gp3","NoTr","NoTrade","NoGroup",7,1,2,3,1,5,2,0,4,3,1,6,2,5,1
"1926",665,666,666,"white","age.gp2","Tr","NoTrade","NoGroup",9,1,6,0,2,0,9,0,5,4,0,9,7,2,1
"1927",1306,1307,1307,"white","age.gp2","Tr","NoTrade","NoGroup",1,0,1,0,0,0,1,0,1,0,0,1,0,1,1
"1928",707,708,708,"white","age.gp2","Tr","NoTrade","Group",26,4,14,6,2,1,21,4,15,11,2,24,20,6,1
"1929",793,794,794,"white","age.gp4","NoTr","NoTrade","NoGroup",8,1,2,1,4,0,8,0,3,5,0,8,7,1,1
"1930",1117,1118,1118,"other","age.gp1","NoTr","NoTrade","NoGroup",5,2,2,1,0,2,2,1,2,3,2,3,1,4,1
"1931",2153,2154,2154,"other","age.gp2","NoTr","NoTrade","NoGroup",5,0,3,0,2,0,5,0,2,3,0,5,2,3,1
"1932",596,597,597,"other","age.gp4","NoTr","NoTrade","NoGroup",3,0,1,1,1,0,3,0,3,0,0,3,2,1,1
"1933",2410,2411,2411,"white","age.gp3","NoTr","Trade","Group",17,1,7,3,6,2,13,2,8,9,1,16,10,7,1
"1934",337,338,338,"white","age.gp1","NoTr","Trade","Group",20,10,3,4,3,2,14,4,5,15,2,18,11,9,1
"1935",1105,1106,1106,"other","age.gp1","NoTr","NoTrade","NoGroup",4,3,1,0,0,0,4,0,2,2,2,2,3,1,1
"1936",2484,2485,2485,"other","age.gp1","NoTr","NoTrade","NoGroup",3,2,0,1,0,0,2,1,1,2,1,2,3,0,1
"1937",2643,2644,2644,"white","age.gp1","NoTr","NoTrade","NoGroup",14,9,4,0,1,1,7,6,4,10,1,13,4,10,1
"1938",2915,2916,2916,"other","age.gp1","NoTr","NoTrade","NoGroup",2,1,1,0,0,1,1,0,1,1,1,1,2,0,1
"1939",1342,1343,1343,"white","age.gp1","Tr","NoTrade","NoGroup",6,5,1,0,0,1,3,2,0,6,2,4,3,3,1
"1940",1382,1383,1383,"white","age.gp1","NoTr","NoTrade","NoGroup",7,3,1,1,2,0,6,1,2,5,1,6,5,2,1
"1941",2977,2978,2978,"white","age.gp1","NoTr","NoTrade","Group",16,11,2,1,2,0,10,6,6,10,4,12,10,6,1
"1942",339,340,340,"white","age.gp1","NoTr","Trade","Group",17,12,2,1,2,3,12,2,9,8,1,16,5,12,1
"1943",1636,1637,1637,"black","age.gp1","Tr","NoTrade","NoGroup",15,8,1,3,3,8,6,1,2,13,3,12,7,8,1
"1944",2114,2115,2115,"white","age.gp2","NoTr","NoTrade","NoGroup",11,2,5,3,1,1,10,0,4,7,2,9,6,5,1
"1945",2184,2185,2185,"white","age.gp4","NoTr","NoTrade","NoGroup",6,1,2,1,2,1,5,0,2,4,1,5,3,3,1
"1946",894,895,895,"other","age.gp1","Tr","NoTrade","NoGroup",3,2,0,1,0,0,3,0,1,2,2,1,2,1,1
"1947",1009,1010,1010,"white","age.gp1","Tr","NoTrade","NoGroup",18,11,1,3,3,3,8,7,3,15,5,13,10,8,1
"1948",1344,1345,1345,"white","age.gp1","Tr","NoTrade","NoGroup",9,5,2,2,0,0,8,1,3,6,2,7,3,6,1
"1949",476,477,477,"black","age.gp3","NoTr","Trade","Group",15,1,4,6,4,7,8,0,2,13,2,13,9,6,1
"1950",625,626,626,"other","age.gp1","NoTr","Trade","Group",12,8,3,1,0,2,9,1,5,7,1,11,6,6,1
"1951",1179,1180,1180,"white","age.gp4","Tr","NoTrade","NoGroup",1,1,0,0,0,0,1,0,0,1,1,0,1,0,1
"1952",1327,1328,1328,"white","age.gp3","NoTr","NoTrade","NoGroup",10,1,7,1,1,1,8,1,5,5,3,7,9,1,1
"1953",2340,2341,2341,"white","age.gp2","Tr","NoTrade","Group",25,4,11,5,5,2,20,3,7,18,3,22,18,7,1
"1954",2478,2479,2479,"other","age.gp1","NoTr","NoTrade","NoGroup",5,3,0,0,2,0,5,0,2,3,1,4,2,3,1
"1955",2904,2905,2905,"other","age.gp1","NoTr","NoTrade","NoGroup",8,5,0,2,1,3,5,0,0,8,1,7,1,7,1
"1956",1435,1436,1436,"white","age.gp3","Tr","NoTrade","NoGroup",8,2,3,0,3,1,6,1,0,8,0,8,4,4,1
"1957",2286,2287,2287,"other","age.gp2","Tr","NoTrade","Group",12,0,6,2,4,2,10,0,4,8,0,12,10,2,1
"1958",2310,2311,2311,"white","age.gp2","Tr","NoTrade","NoGroup",19,2,7,6,4,1,17,1,6,13,1,18,15,4,1
"1959",1386,1387,1387,"black","age.gp3","NoTr","NoTrade","NoGroup",10,1,4,2,3,3,5,2,3,7,0,10,5,5,1
"1960",1490,1491,1491,"white","age.gp4","NoTr","NoTrade","NoGroup",5,0,1,0,4,0,5,0,0,5,0,5,3,2,1
"1961",2203,2204,2204,"white","age.gp4","NoTr","NoTrade","NoGroup",1,0,1,0,0,0,1,0,0,1,0,1,1,0,1
"1962",2239,2240,2240,"black","age.gp4","NoTr","Trade","Group",7,0,1,3,3,3,4,0,0,7,2,5,4,3,1
"1963",2285,2286,2286,"other","age.gp2","Tr","NoTrade","Group",7,2,1,2,2,1,6,0,1,6,0,7,5,2,1
"1964",2317,2318,2318,"white","age.gp2","NoTr","NoTrade","NoGroup",13,0,6,2,5,5,5,3,4,9,3,10,7,6,1
"1965",420,421,421,"white","age.gp4","NoTr","NoTrade","NoGroup",1,0,1,0,0,0,1,0,0,1,0,1,1,0,1
"1966",780,781,781,"white","age.gp2","NoTr","NoTrade","NoGroup",7,0,3,2,2,1,5,1,3,4,1,6,5,2,1
"1967",1415,1416,1416,"black","age.gp2","NoTr","NoTrade","NoGroup",10,1,7,1,1,9,1,0,1,9,1,9,3,7,1
"1968",1012,1013,1013,"white","age.gp1","Tr","NoTrade","NoGroup",8,6,1,0,1,0,6,2,2,6,1,7,4,4,1
"1969",2267,2268,2268,"white","age.gp4","Tr","NoTrade","Group",11,2,2,2,5,3,8,0,3,8,2,9,7,4,1
"1970",2710,2711,2711,"white","age.gp4","NoTr","NoTrade","Group",12,2,2,0,8,2,10,0,3,9,0,12,7,5,1
"1971",729,730,730,"black","age.gp4","NoTr","NoTrade","NoGroup",5,0,1,2,2,2,3,0,0,5,1,4,3,2,1
"1972",1350,1351,1351,"black","age.gp4","NoTr","NoTrade","Group",10,2,1,0,7,5,5,0,4,6,2,8,8,2,1
"1973",1750,1751,1751,"black","age.gp4","NoTr","NoTrade","NoGroup",4,0,1,1,2,3,1,0,0,4,0,4,2,2,1
"1974",347,348,348,"black","age.gp4","NoTr","NoTrade","NoGroup",3,0,0,0,3,0,3,0,2,1,0,3,3,0,1
"1975",348,349,349,"black","age.gp4","NoTr","NoTrade","NoGroup",6,0,2,1,3,1,4,1,2,4,1,5,5,1,1
"1976",871,872,872,"other","age.gp2","Tr","NoTrade","Group",11,0,4,3,4,3,8,0,1,10,1,10,6,5,1
"1977",2359,2360,2360,"white","age.gp3","Tr","NoTrade","NoGroup",11,2,4,1,4,1,8,2,2,9,1,10,8,3,1
"1978",384,385,385,"black","age.gp4","NoTr","NoTrade","NoGroup",3,0,0,0,3,1,2,0,2,1,0,3,2,1,1
"1979",1372,1373,1373,"black","age.gp4","NoTr","NoTrade","Group",7,0,1,3,3,4,2,1,1,6,1,6,5,2,1
"1980",1523,1524,1524,"black","age.gp4","NoTr","NoTrade","NoGroup",5,0,1,0,4,5,0,0,1,4,1,4,3,2,1
"1981",2850,2851,2851,"black","age.gp3","NoTr","NoTrade","Group",10,1,3,3,3,7,3,0,2,8,2,8,5,5,1
"1982",350,351,351,"black","age.gp4","NoTr","NoTrade","NoGroup",4,0,1,0,3,3,1,0,0,4,0,4,1,3,1
"1983",497,498,498,"black","age.gp4","NoTr","NoTrade","NoGroup",5,0,1,0,4,3,2,0,0,5,0,5,2,3,1
"1984",1518,1519,1519,"black","age.gp4","NoTr","NoTrade","NoGroup",1,0,0,0,1,1,0,0,0,1,0,1,0,1,1
"1985",351,352,352,"black","age.gp4","NoTr","NoTrade","NoGroup",6,1,0,0,5,3,3,0,1,5,0,6,3,3,1
"1986",541,542,542,"white","age.gp4","NoTr","NoTrade","NoGroup",4,1,0,0,3,1,2,1,2,2,0,4,2,2,1
"1987",1047,1048,1048,"black","age.gp4","NoTr","NoTrade","NoGroup",5,0,1,2,2,5,0,0,0,5,1,4,2,3,1
"1988",1355,1356,1356,"black","age.gp4","NoTr","NoTrade","Group",11,0,1,3,7,7,3,1,1,10,3,8,7,4,1
"1989",1359,1360,1360,"black","age.gp4","NoTr","NoTrade","Group",6,1,1,0,4,6,0,0,1,5,1,5,1,5,1
"1990",352,353,353,"black","age.gp4","NoTr","NoTrade","NoGroup",4,0,0,2,2,3,1,0,0,4,1,3,3,1,1
"1991",1845,1846,1846,"black","age.gp3","NoTr","NoTrade","NoGroup",2,0,1,0,1,1,1,0,1,1,0,2,0,2,1
"1992",353,354,354,"black","age.gp4","NoTr","NoTrade","NoGroup",8,0,1,1,6,3,5,0,0,8,2,6,7,1,1
"1993",775,776,776,"white","age.gp4","NoTr","NoTrade","NoGroup",6,2,2,1,1,1,5,0,2,4,0,6,3,3,1
"1994",2938,2939,2939,"white","age.gp4","NoTr","NoTrade","Group",10,0,1,1,8,1,9,0,2,8,0,10,5,5,1
"1995",2951,2952,2952,"white","age.gp4","NoTr","NoTrade","Group",8,0,0,2,6,3,5,0,1,7,0,8,5,3,1
"1996",354,355,355,"black","age.gp4","NoTr","NoTrade","NoGroup",3,0,0,0,3,2,1,0,0,3,0,3,0,3,1
"1997",2436,2437,2437,"white","age.gp4","NoTr","NoTrade","NoGroup",1,0,0,0,1,1,0,0,0,1,0,1,0,1,1
"1998",355,356,356,"black","age.gp4","NoTr","NoTrade","NoGroup",2,0,0,1,1,2,0,0,0,2,1,1,2,0,1
"1999",2237,2238,2238,"black","age.gp4","NoTr","Trade","Group",6,0,0,1,5,2,4,0,3,3,1,5,3,3,1
"2000",356,357,357,"black","age.gp4","NoTr","NoTrade","NoGroup",1,0,1,0,0,0,1,0,0,1,0,1,1,0,1
"2001",357,358,358,"black","age.gp4","NoTr","NoTrade","NoGroup",1,0,0,1,0,1,0,0,0,1,1,0,1,0,1
"2002",358,359,359,"black","age.gp4","NoTr","NoTrade","NoGroup",1,1,0,0,0,1,0,0,1,0,1,0,1,0,1
"2003",1146,1147,1147,"white","age.gp4","NoTr","NoTrade","NoGroup",5,1,0,2,2,1,4,0,2,3,1,4,2,3,1
"2004",2080,2081,2081,"black","age.gp3","NoTr","NoTrade","NoGroup",7,0,1,0,6,4,3,0,1,6,0,7,2,5,1
"2005",360,361,361,"black","age.gp4","NoTr","NoTrade","NoGroup",1,0,1,0,0,1,0,0,0,1,0,1,1,0,1
"2006",361,362,362,"black","age.gp4","NoTr","NoTrade","NoGroup",1,0,0,0,1,0,1,0,0,1,0,1,0,1,1
"2007",2430,2431,2431,"white","age.gp4","NoTr","NoTrade","NoGroup",8,0,2,2,4,2,6,0,4,4,0,8,5,3,1
"2008",362,363,363,"black","age.gp4","NoTr","NoTrade","NoGroup",3,0,2,0,1,2,0,1,1,2,0,3,1,2,1
"2009",1511,1512,1512,"black","age.gp4","NoTr","NoTrade","NoGroup",11,1,3,4,3,8,2,1,2,9,2,9,5,6,1
"2010",2762,2763,2763,"black","age.gp2","NoTr","NoTrade","NoGroup",9,0,5,2,2,6,2,1,0,9,1,8,4,5,1
"2011",722,723,723,"black","age.gp4","NoTr","NoTrade","NoGroup",4,2,1,0,1,4,0,0,1,3,1,3,1,3,1
"2012",364,365,365,"black","age.gp4","NoTr","NoTrade","NoGroup",1,0,0,0,1,1,0,0,0,1,0,1,0,1,1
"2013",393,394,394,"black","age.gp4","NoTr","NoTrade","NoGroup",5,0,2,2,1,3,1,1,2,3,0,5,2,3,1
"2014",1265,1266,1266,"black","age.gp3","NoTr","NoTrade","NoGroup",6,0,2,0,4,3,3,0,2,4,0,6,3,3,1
"2015",366,367,367,"black","age.gp4","NoTr","NoTrade","NoGroup",1,0,0,1,0,0,1,0,1,0,0,1,1,0,1
"2016",367,368,368,"black","age.gp4","NoTr","NoTrade","NoGroup",4,0,0,2,2,1,3,0,1,3,1,3,3,1,1
"2017",368,369,369,"black","age.gp4","NoTr","NoTrade","NoGroup",1,0,0,0,1,0,1,0,1,0,0,1,1,0,1
"2018",369,370,370,"black","age.gp4","NoTr","NoTrade","NoGroup",2,1,0,0,1,1,1,0,0,2,0,2,1,1,1
"2019",479,480,480,"black","age.gp4","NoTr","NoTrade","NoGroup",1,0,0,0,1,1,0,0,0,1,0,1,0,1,1
"2020",370,371,371,"black","age.gp4","NoTr","NoTrade","NoGroup",4,1,0,0,3,1,3,0,1,3,1,3,3,1,1
"2021",2177,2178,2178,"white","age.gp4","NoTr","NoTrade","NoGroup",5,0,0,0,5,2,3,0,2,3,0,5,2,3,1
"2022",371,372,372,"black","age.gp4","NoTr","NoTrade","NoGroup",4,0,1,0,3,1,3,0,2,2,0,4,2,2,1
"2023",981,982,982,"white","age.gp4","NoTr","NoTrade","NoGroup",2,0,0,1,1,1,1,0,1,1,0,2,1,1,1
"2024",2455,2456,2456,"white","age.gp4","NoTr","NoTrade","NoGroup",3,0,0,0,3,2,1,0,0,3,0,3,2,1,1
"2025",372,373,373,"black","age.gp4","NoTr","NoTrade","NoGroup",2,0,0,1,1,2,0,0,0,2,1,1,1,1,1
"2026",723,724,724,"black","age.gp4","NoTr","NoTrade","NoGroup",4,0,0,1,3,2,2,0,1,3,0,4,2,2,1
"2027",373,374,374,"black","age.gp4","NoTr","NoTrade","NoGroup",1,0,1,0,0,1,0,0,1,0,0,1,1,0,1
"2028",374,375,375,"black","age.gp4","NoTr","NoTrade","NoGroup",1,0,0,1,0,0,1,0,0,1,0,1,1,0,1
"2029",376,377,377,"black","age.gp4","NoTr","NoTrade","NoGroup",1,0,0,0,1,0,1,0,1,0,0,1,1,0,1
"2030",377,378,378,"black","age.gp4","NoTr","NoTrade","NoGroup",4,0,0,2,2,1,3,0,2,2,0,4,3,1,1
"2031",2683,2684,2684,"black","age.gp3","NoTr","NoTrade","NoGroup",11,3,1,2,5,7,2,2,2,9,3,8,6,5,1
"2032",378,379,379,"black","age.gp4","NoTr","NoTrade","NoGroup",1,0,0,1,0,1,0,0,0,1,0,1,0,1,1
"2033",379,380,380,"black","age.gp4","NoTr","NoTrade","NoGroup",1,0,0,1,0,1,0,0,0,1,0,1,0,1,1
"2034",380,381,381,"black","age.gp4","NoTr","NoTrade","NoGroup",1,0,0,0,1,0,1,0,0,1,0,1,1,0,1
"2035",551,552,552,"white","age.gp4","NoTr","NoTrade","NoGroup",1,0,0,0,1,1,0,0,0,1,0,1,0,1,1
"2036",2222,2223,2223,"black","age.gp4","NoTr","Trade","Group",2,0,1,0,1,2,0,0,1,1,0,2,1,1,1
"2037",2336,2337,2337,"white","age.gp3","Tr","NoTrade","Group",15,2,6,3,4,1,12,2,6,9,3,12,9,6,1
"2038",2553,2554,2554,"other","age.gp1","NoTr","NoTrade","NoGroup",5,1,2,1,1,1,4,0,2,3,0,5,2,3,1
"2039",383,384,384,"black","age.gp4","NoTr","NoTrade","NoGroup",4,0,0,2,2,3,1,0,0,4,0,4,1,3,1
"2040",385,386,386,"black","age.gp4","NoTr","NoTrade","NoGroup",1,0,0,1,0,0,1,0,0,1,0,1,0,1,1
"2041",386,387,387,"black","age.gp4","NoTr","NoTrade","NoGroup",1,0,0,0,1,1,0,0,0,1,0,1,0,1,1
"2042",1811,1812,1812,"black","age.gp4","NoTr","NoTrade","NoGroup",5,0,2,1,2,5,0,0,0,5,0,5,1,4,1
"2043",387,388,388,"black","age.gp4","NoTr","NoTrade","NoGroup",3,0,1,0,2,2,1,0,1,2,0,3,1,2,1
"2044",1747,1748,1748,"black","age.gp4","NoTr","NoTrade","NoGroup",5,0,0,0,5,4,1,0,0,5,0,5,1,4,1
"2045",388,389,389,"black","age.gp4","NoTr","NoTrade","NoGroup",5,1,2,0,2,2,3,0,0,5,1,4,3,2,1
"2046",390,391,391,"black","age.gp4","NoTr","NoTrade","NoGroup",2,0,0,1,1,1,1,0,1,1,0,2,1,1,1
"2047",392,393,393,"black","age.gp4","NoTr","NoTrade","NoGroup",1,0,0,0,1,0,1,0,1,0,0,1,1,0,1
"2048",1264,1265,1265,"black","age.gp3","NoTr","NoTrade","NoGroup",6,0,5,0,1,3,2,1,2,4,1,5,3,3,1
"2049",1392,1393,1393,"black","age.gp3","NoTr","NoTrade","NoGroup",7,0,3,1,3,3,4,0,1,6,1,6,4,3,1
"2050",2284,2285,2285,"other","age.gp2","Tr","NoTrade","Group",12,0,7,3,2,3,9,0,7,5,0,12,9,3,1
"2051",1393,1394,1394,"black","age.gp3","NoTr","NoTrade","NoGroup",11,0,5,2,4,6,5,0,1,10,0,11,6,5,1
"2052",395,396,396,"black","age.gp4","NoTr","NoTrade","NoGroup",5,0,1,1,3,3,2,0,0,5,3,2,4,1,1
"2053",2213,2214,2214,"black","age.gp4","NoTr","Trade","Group",5,1,1,1,2,2,3,0,1,4,0,5,3,2,1
"2054",396,397,397,"black","age.gp4","NoTr","NoTrade","NoGroup",1,0,0,0,1,1,0,0,0,1,0,1,1,0,1
"2055",1352,1353,1353,"black","age.gp4","NoTr","NoTrade","Group",8,1,1,2,4,4,4,0,2,6,0,8,4,4,1
"2056",397,398,398,"black","age.gp4","NoTr","NoTrade","NoGroup",1,0,0,0,1,1,0,0,0,1,0,1,0,1,1
"2057",2022,2023,2023,"black","age.gp4","NoTr","NoTrade","NoGroup",1,0,0,0,1,1,0,0,0,1,0,1,0,1,1
"2058",399,400,400,"black","age.gp4","NoTr","NoTrade","NoGroup",1,0,0,0,1,0,1,0,0,1,0,1,1,0,1
"2059",1592,1593,1593,"white","age.gp4","Tr","NoTrade","Group",11,1,0,4,6,3,8,0,1,10,1,10,7,4,1
"2060",2019,2020,2020,"black","age.gp4","NoTr","NoTrade","NoGroup",6,0,0,0,6,5,1,0,1,5,1,5,2,4,1
"2061",2758,2759,2759,"white","age.gp3","NoTr","NoTrade","NoGroup",6,0,3,0,3,1,4,1,2,4,0,6,3,3,1
"2062",401,402,402,"black","age.gp4","NoTr","NoTrade","NoGroup",3,0,0,1,2,2,1,0,1,2,0,3,2,1,1
"2063",1537,1538,1538,"black","age.gp4","NoTr","NoTrade","NoGroup",9,0,4,2,3,2,7,0,1,8,0,9,4,5,1
"2064",402,403,403,"black","age.gp4","NoTr","NoTrade","NoGroup",1,0,0,1,0,1,0,0,0,1,0,1,0,1,1
"2065",403,404,404,"black","age.gp4","NoTr","NoTrade","NoGroup",1,0,0,0,1,1,0,0,0,1,0,1,0,1,1
"2066",2013,2014,2014,"black","age.gp4","NoTr","NoTrade","NoGroup",8,0,2,2,4,1,7,0,4,4,0,8,5,3,1
"2067",404,405,405,"black","age.gp4","NoTr","NoTrade","NoGroup",8,2,2,0,4,6,1,1,3,5,3,5,6,2,1
"2068",1357,1358,1358,"black","age.gp4","NoTr","NoTrade","Group",6,1,2,1,2,5,0,1,1,5,2,4,3,3,1
"2069",2948,2949,2949,"white","age.gp4","NoTr","NoTrade","Group",9,0,5,1,3,2,7,0,2,7,1,8,4,5,1
"2070",405,406,406,"black","age.gp4","NoTr","NoTrade","NoGroup",2,1,1,0,0,1,1,0,0,2,0,2,2,0,1
"2071",1418,1419,1419,"black","age.gp2","NoTr","NoTrade","NoGroup",4,0,1,1,2,3,1,0,1,3,0,4,2,2,1
"2072",548,549,549,"white","age.gp4","NoTr","NoTrade","NoGroup",5,0,2,2,1,1,3,1,3,2,1,4,3,2,1
"2073",653,654,654,"black","age.gp2","NoTr","NoTrade","NoGroup",7,1,3,1,2,4,1,2,2,5,1,6,5,2,1
"2074",946,947,947,"white","age.gp3","Tr","NoTrade","Group",19,4,7,5,3,0,16,3,7,12,3,16,13,6,1
"2075",1323,1324,1324,"white","age.gp2","Tr","NoTrade","Group",25,2,16,6,1,3,19,3,10,15,5,20,19,6,1
"2076",1892,1893,1893,"other","age.gp1","NoTr","NoTrade","Group",10,4,3,1,2,0,10,0,4,6,1,9,7,3,1
"2077",2115,2116,2116,"white","age.gp2","NoTr","NoTrade","NoGroup",6,1,5,0,0,1,4,1,5,1,2,4,4,2,1
"2078",409,410,410,"white","age.gp2","Tr","Trade","Group",20,3,8,3,6,2,16,2,7,13,0,20,15,5,1
"2079",1148,1149,1149,"white","age.gp4","NoTr","NoTrade","NoGroup",6,1,2,0,3,0,6,0,1,5,1,5,2,4,1
"2080",1345,1346,1346,"black","age.gp4","NoTr","NoTrade","Group",13,2,3,3,5,9,3,1,3,10,3,10,10,3,1
"2081",2049,2050,2050,"white","age.gp4","Tr","NoTrade","Group",7,1,1,2,3,2,3,2,1,6,1,6,5,2,1
"2082",2142,2143,2143,"other","age.gp2","NoTr","NoTrade","NoGroup",7,0,5,2,0,1,6,0,3,4,1,6,7,0,1
"2083",586,587,587,"other","age.gp4","NoTr","NoTrade","NoGroup",1,0,1,0,0,0,1,0,1,0,1,0,1,0,1
"2084",605,606,606,"other","age.gp4","NoTr","NoTrade","NoGroup",4,0,1,1,2,0,4,0,2,2,1,3,3,1,1
"2085",924,925,925,"white","age.gp2","NoTr","NoTrade","NoGroup",13,3,5,3,2,0,10,3,8,5,2,11,9,4,1
"2086",2800,2801,2801,"white","age.gp2","NoTr","NoTrade","NoGroup",12,3,6,1,2,2,8,2,5,7,1,11,7,5,1
"2087",2379,2380,2380,"white","age.gp2","NoTr","NoTrade","NoGroup",7,0,5,0,2,2,3,2,4,3,1,6,5,2,1
"2088",413,414,414,"white","age.gp4","NoTr","NoTrade","NoGroup",1,0,1,0,0,0,0,1,1,0,0,1,1,0,1
"2089",414,415,415,"white","age.gp4","NoTr","NoTrade","NoGroup",2,0,1,0,1,0,2,0,2,0,0,2,1,1,1
"2090",1154,1155,1155,"white","age.gp4","NoTr","NoTrade","NoGroup",5,0,1,1,3,0,5,0,0,5,0,5,2,3,1
"2091",2174,2175,2175,"white","age.gp4","NoTr","NoTrade","NoGroup",7,0,0,3,4,0,7,0,4,3,0,7,5,2,1
"2092",416,417,417,"white","age.gp4","NoTr","NoTrade","NoGroup",4,0,0,2,2,1,3,0,1,3,1,3,4,0,1
"2093",418,419,419,"white","age.gp4","NoTr","NoTrade","NoGroup",1,0,0,0,1,0,1,0,1,0,0,1,1,0,1
"2094",419,420,420,"white","age.gp4","NoTr","NoTrade","NoGroup",1,0,1,0,0,0,1,0,0,1,0,1,1,0,1
"2095",421,422,422,"white","age.gp4","NoTr","NoTrade","NoGroup",5,0,1,2,2,2,3,0,1,4,0,5,3,2,1
"2096",422,423,423,"white","age.gp4","NoTr","NoTrade","NoGroup",2,0,1,1,0,0,2,0,0,2,0,2,0,2,1
"2097",1319,1320,1320,"white","age.gp2","NoTr","NoTrade","NoGroup",7,0,3,1,3,0,6,1,4,3,0,7,5,2,1
"2098",424,425,425,"white","age.gp4","NoTr","NoTrade","NoGroup",4,0,2,2,0,0,3,1,1,3,1,3,3,1,1
"2099",2133,2134,2134,"other","age.gp2","NoTr","NoTrade","NoGroup",9,0,3,1,5,0,9,0,5,4,0,9,6,3,1
"2100",426,427,427,"white","age.gp4","NoTr","NoTrade","NoGroup",1,0,0,1,0,0,1,0,1,0,0,1,1,0,1
"2101",428,429,429,"white","age.gp4","NoTr","NoTrade","NoGroup",1,0,0,0,1,0,1,0,1,0,0,1,1,0,1
"2102",694,695,695,"white","age.gp4","Tr","NoTrade","Group",12,3,1,2,6,2,9,1,4,8,2,10,8,4,1
"2103",429,430,430,"white","age.gp4","NoTr","NoTrade","NoGroup",1,0,0,0,1,0,1,0,0,1,0,1,0,1,1
"2104",2761,2762,2762,"white","age.gp3","NoTr","NoTrade","NoGroup",4,0,2,1,1,1,2,1,2,2,0,4,2,2,1
"2105",431,432,432,"white","age.gp4","NoTr","NoTrade","NoGroup",3,0,2,1,0,0,3,0,3,0,0,3,3,0,1
"2106",433,434,434,"white","age.gp4","NoTr","NoTrade","NoGroup",1,0,0,0,1,0,1,0,0,1,0,1,1,0,1
"2107",1289,1290,1290,"white","age.gp4","NoTr","NoTrade","Group",14,1,2,4,7,1,13,0,5,9,1,13,8,6,1
"2108",434,435,435,"white","age.gp4","NoTr","NoTrade","NoGroup",1,0,0,0,1,0,1,0,1,0,0,1,1,0,1
"2109",2052,2053,2053,"white","age.gp4","Tr","NoTrade","Group",15,0,4,1,10,0,14,1,5,10,0,15,10,5,1
"2110",435,436,436,"white","age.gp4","NoTr","NoTrade","NoGroup",4,0,0,1,3,1,3,0,3,1,0,4,4,0,1
"2111",436,437,437,"white","age.gp4","NoTr","NoTrade","NoGroup",1,0,0,0,1,0,1,0,0,1,1,0,0,1,1
"2112",437,438,438,"white","age.gp4","NoTr","NoTrade","NoGroup",1,0,0,0,1,0,1,0,0,1,0,1,1,0,1
"2113",438,439,439,"white","age.gp4","NoTr","NoTrade","NoGroup",3,2,0,0,1,0,2,1,0,3,0,3,1,2,1
"2114",2195,2196,2196,"white","age.gp4","NoTr","NoTrade","NoGroup",3,0,1,0,2,0,3,0,1,2,0,3,2,1,1
"2115",1388,1389,1389,"black","age.gp3","NoTr","NoTrade","NoGroup",3,0,0,2,1,0,3,0,0,3,0,3,0,3,1
"2116",1958,1959,1959,"white","age.gp4","NoTr","NoTrade","Group",15,1,3,2,9,0,14,1,6,9,1,14,9,6,1
"2117",569,570,570,"other","age.gp4","NoTr","NoTrade","NoGroup",5,0,1,1,3,0,5,0,3,2,0,5,3,2,1
"2118",1186,1187,1187,"white","age.gp4","Tr","NoTrade","NoGroup",1,0,0,0,1,0,1,0,0,1,0,1,0,1,1
"2119",444,445,445,"black","age.gp3","NoTr","NoTrade","NoGroup",3,0,1,2,0,1,2,0,1,2,1,2,2,1,1
"2120",445,446,446,"black","age.gp3","NoTr","NoTrade","NoGroup",9,2,4,1,2,4,5,0,5,4,3,6,5,4,1
"2121",1044,1045,1045,"black","age.gp4","NoTr","NoTrade","NoGroup",3,1,1,1,0,2,1,0,0,3,0,3,1,2,1
"2122",1542,1543,1543,"white","age.gp2","NoTr","NoTrade","NoGroup",10,1,5,2,2,2,6,2,5,5,0,10,8,2,1
"2123",1903,1904,1904,"black","age.gp1","NoTr","NoTrade","NoGroup",13,6,2,3,2,7,4,2,4,9,1,12,5,8,1
"2124",2011,2012,2012,"black","age.gp4","NoTr","NoTrade","NoGroup",6,1,2,2,1,4,2,0,2,4,0,6,3,3,1
"2125",731,732,732,"black","age.gp4","NoTr","NoTrade","NoGroup",7,0,0,2,5,5,2,0,0,7,3,4,6,1,1
"2126",2540,2541,2541,"other","age.gp1","NoTr","NoTrade","NoGroup",3,2,0,1,0,1,2,0,1,2,0,3,0,3,1
"2127",448,449,449,"black","age.gp3","NoTr","NoTrade","NoGroup",7,0,1,4,2,4,3,0,2,5,1,6,5,2,1
"2128",1832,1833,1833,"black","age.gp4","NoTr","NoTrade","NoGroup",5,0,0,4,1,4,1,0,0,5,1,4,2,3,1
"2129",2234,2235,2235,"black","age.gp4","NoTr","Trade","Group",6,0,0,4,2,4,2,0,2,4,2,4,4,2,1
"2130",449,450,450,"black","age.gp3","NoTr","NoTrade","NoGroup",7,3,2,1,1,2,5,0,3,4,1,6,4,3,1
"2131",450,451,451,"black","age.gp3","NoTr","NoTrade","NoGroup",8,0,5,1,2,3,5,0,1,7,0,8,7,1,1
"2132",1364,1365,1365,"black","age.gp4","NoTr","NoTrade","Group",9,1,3,4,1,7,2,0,1,8,0,9,2,7,1
"2133",451,452,452,"black","age.gp3","NoTr","NoTrade","NoGroup",6,0,2,4,0,4,2,0,2,4,0,6,5,1,1
"2134",453,454,454,"black","age.gp3","NoTr","NoTrade","NoGroup",4,1,2,0,1,3,1,0,1,3,2,2,2,2,1
"2135",2224,2225,2225,"black","age.gp4","NoTr","Trade","Group",9,1,2,2,4,7,2,0,1,8,0,9,5,4,1
"2136",454,455,455,"black","age.gp3","NoTr","NoTrade","NoGroup",3,0,1,1,1,3,0,0,1,2,1,2,2,1,1
"2137",2727,2728,2728,"black","age.gp3","NoTr","NoTrade","NoGroup",8,1,3,3,1,6,1,1,1,7,0,8,3,5,1
"2138",455,456,456,"black","age.gp3","NoTr","NoTrade","NoGroup",7,1,1,4,1,5,2,0,2,5,3,4,3,4,1
"2139",466,467,467,"black","age.gp3","NoTr","Trade","Group",10,1,2,2,5,4,4,2,3,7,0,10,3,7,1
"2140",712,713,713,"black","age.gp4","NoTr","NoTrade","NoGroup",4,0,1,1,2,1,2,1,0,4,0,4,1,3,1
"2141",1595,1596,1596,"black","age.gp1","Tr","Trade","NoGroup",11,2,2,4,3,7,4,0,2,9,1,10,6,5,1
"2142",456,457,457,"black","age.gp3","NoTr","NoTrade","NoGroup",5,2,2,0,1,2,3,0,2,3,1,4,3,2,1
"2143",639,640,640,"other","age.gp1","NoTr","Trade","Group",8,4,2,1,1,1,7,0,3,5,1,7,5,3,1
"2144",890,891,891,"other","age.gp1","Tr","NoTrade","NoGroup",6,5,1,0,0,0,6,0,0,6,1,5,2,4,1
"2145",896,897,897,"other","age.gp1","Tr","NoTrade","NoGroup",6,2,0,3,1,1,5,0,1,5,0,6,1,5,1
"2146",2048,2049,2049,"white","age.gp4","Tr","NoTrade","Group",12,4,1,1,6,1,10,1,4,8,0,12,7,5,1
"2147",1227,1228,1228,"white","age.gp4","NoTr","NoTrade","NoGroup",1,1,0,0,0,0,1,0,0,1,0,1,0,1,1
"2148",1878,1879,1879,"other","age.gp1","NoTr","NoTrade","Group",10,3,4,3,0,1,9,0,5,5,0,10,3,7,1
"2149",2078,2079,2079,"black","age.gp3","NoTr","NoTrade","NoGroup",5,1,2,2,0,1,4,0,2,3,1,4,3,2,1
"2150",2261,2262,2262,"white","age.gp4","Tr","NoTrade","Group",17,1,6,2,8,2,15,0,5,12,4,13,12,5,1
"2151",2417,2418,2418,"white","age.gp3","NoTr","Trade","Group",24,8,8,4,4,0,21,3,4,20,6,18,18,6,1
"2152",1340,1341,1341,"white","age.gp1","Tr","NoTrade","NoGroup",14,5,4,3,2,2,10,2,3,11,0,14,5,9,1
"2153",2780,2781,2781,"white","age.gp3","NoTr","NoTrade","Group",15,2,5,4,4,3,12,0,5,10,0,15,8,7,1
"2154",462,463,463,"white","age.gp1","NoTr","NoTrade","NoGroup",8,2,5,1,0,1,5,2,2,6,0,8,5,3,1
"2155",1378,1379,1379,"black","age.gp2","NoTr","NoTrade","NoGroup",11,1,4,6,0,5,5,1,3,8,2,9,5,6,1
"2156",505,506,506,"black","age.gp4","NoTr","NoTrade","NoGroup",4,1,0,3,0,4,0,0,0,4,1,3,1,3,1
"2157",1645,1646,1646,"other","age.gp2","NoTr","NoTrade","NoGroup",3,0,1,2,0,1,2,0,1,2,1,2,3,0,1
"2158",1862,1863,1863,"white","age.gp3","NoTr","NoTrade","Group",17,2,4,7,4,2,13,2,4,13,3,14,14,3,1
"2159",2074,2075,2075,"black","age.gp3","NoTr","NoTrade","NoGroup",3,0,0,1,2,3,0,0,0,3,1,2,2,1,1
"2160",2834,2835,2835,"black","age.gp2","NoTr","NoTrade","NoGroup",14,1,5,4,4,7,7,0,5,9,2,12,9,5,1
"2161",465,466,466,"black","age.gp3","NoTr","Trade","Group",12,2,3,1,6,3,7,2,3,9,1,11,8,4,1
"2162",2534,2535,2535,"other","age.gp1","NoTr","NoTrade","NoGroup",4,1,0,1,2,1,3,0,0,4,1,3,2,2,1
"2163",2931,2932,2932,"white","age.gp4","NoTr","NoTrade","Group",5,0,2,1,2,1,4,0,2,3,2,3,4,1,1
"2164",498,499,499,"black","age.gp4","NoTr","NoTrade","NoGroup",1,0,0,1,0,1,0,0,0,1,1,0,1,0,1
"2165",500,501,501,"black","age.gp4","NoTr","NoTrade","NoGroup",2,0,0,2,0,1,1,0,0,2,2,0,2,0,1
"2166",561,562,562,"other","age.gp4","NoTr","NoTrade","NoGroup",6,0,2,2,2,1,5,0,3,3,1,5,4,2,1
"2167",833,834,834,"white","age.gp3","NoTr","NoTrade","NoGroup",12,3,3,5,1,1,9,2,4,8,1,11,6,6,1
"2168",521,522,522,"black","age.gp3","NoTr","NoTrade","NoGroup",4,0,1,2,1,4,0,0,0,4,2,2,3,1,1
"2169",1023,1024,1024,"black","age.gp4","NoTr","NoTrade","NoGroup",3,0,0,2,1,2,1,0,0,3,1,2,2,1,1
"2170",1765,1766,1766,"black","age.gp4","NoTr","NoTrade","NoGroup",1,0,0,1,0,1,0,0,0,1,1,0,1,0,1
"2171",726,727,727,"black","age.gp4","NoTr","NoTrade","NoGroup",1,0,0,1,0,1,0,0,0,1,1,0,1,0,1
"2172",1028,1029,1029,"black","age.gp4","NoTr","NoTrade","NoGroup",1,0,0,1,0,1,0,0,0,1,1,0,1,0,1
"2173",1678,1679,1679,"white","age.gp4","NoTr","Trade","NoGroup",1,0,0,1,0,1,0,0,0,1,1,0,1,0,1
"2174",2051,2052,2052,"white","age.gp4","Tr","NoTrade","Group",13,0,4,3,6,4,7,2,3,10,3,10,9,4,1
"2175",2674,2675,2675,"white","age.gp3","NoTr","NoTrade","NoGroup",9,1,3,5,0,1,7,1,3,6,1,8,7,2,1
"2176",1396,1397,1397,"black","age.gp3","NoTr","NoTrade","NoGroup",7,1,1,3,2,4,3,0,3,4,3,4,5,2,1
"2177",1687,1688,1688,"white","age.gp4","NoTr","Trade","NoGroup",1,0,0,1,0,1,0,0,0,1,1,0,1,0,1
"2178",1911,1912,1912,"other","age.gp2","NoTr","NoTrade","NoGroup",7,0,4,3,0,1,6,0,1,6,3,4,5,2,1
"2179",1431,1432,1432,"white","age.gp3","Tr","NoTrade","NoGroup",11,0,4,6,1,2,7,2,6,5,2,9,9,2,1
"2180",2763,2764,2764,"black","age.gp2","NoTr","NoTrade","NoGroup",7,1,3,2,1,1,5,1,1,6,1,6,2,5,1
"2181",754,755,755,"white","age.gp4","NoTr","NoTrade","NoGroup",4,0,1,1,2,2,2,0,1,3,2,2,3,1,1
"2182",1025,1026,1026,"black","age.gp4","NoTr","NoTrade","NoGroup",5,0,2,2,1,3,2,0,1,4,1,4,4,1,1
"2183",2085,2086,2086,"black","age.gp3","NoTr","NoTrade","NoGroup",7,0,0,5,2,3,4,0,2,5,3,4,4,3,1
"2184",2687,2688,2688,"black","age.gp3","NoTr","NoTrade","NoGroup",9,0,2,1,6,5,4,0,2,7,1,8,6,3,1
"2185",2725,2726,2726,"black","age.gp3","NoTr","NoTrade","NoGroup",5,1,1,3,0,2,3,0,2,3,1,4,4,1,1
"2186",785,786,786,"black","age.gp1","Tr","NoTrade","NoGroup",10,8,1,1,0,7,2,1,4,6,5,5,3,7,1
"2187",2855,2856,2856,"black","age.gp3","NoTr","NoTrade","Group",9,0,3,3,3,7,2,0,2,7,1,8,5,4,1
"2188",626,627,627,"other","age.gp1","NoTr","Trade","Group",9,3,0,6,0,1,8,0,3,6,3,6,5,4,1
"2189",2656,2657,2657,"black","age.gp1","NoTr","NoTrade","NoGroup",9,2,2,4,1,5,4,0,2,7,1,8,5,4,1
"2190",1998,1999,1999,"black","age.gp4","NoTr","NoTrade","NoGroup",1,0,0,1,0,1,0,0,0,1,1,0,1,0,1
"2191",2374,2375,2375,"black","age.gp2","NoTr","NoTrade","NoGroup",6,0,2,2,2,5,1,0,1,5,2,4,4,2,1
"2192",477,478,478,"black","age.gp4","NoTr","NoTrade","NoGroup",4,0,1,0,3,1,3,0,1,3,0,4,3,1,1
"2193",1941,1942,1942,"white","age.gp4","NoTr","NoTrade","Group",13,1,3,1,8,1,10,2,8,5,0,13,10,3,1
"2194",1942,1943,1943,"white","age.gp4","NoTr","NoTrade","Group",9,1,2,1,5,1,6,2,4,5,0,9,6,3,1
"2195",2373,2374,2374,"black","age.gp2","NoTr","NoTrade","NoGroup",8,1,3,2,2,4,3,1,3,5,1,7,5,3,1
"2196",478,479,479,"black","age.gp4","NoTr","NoTrade","NoGroup",4,0,0,1,3,1,3,0,1,3,0,4,4,0,1
"2197",2584,2585,2585,"white","age.gp4","NoTr","NoTrade","Group",10,0,2,3,5,2,8,0,5,5,1,9,6,4,1
"2198",2717,2718,2718,"white","age.gp4","NoTr","NoTrade","Group",8,1,3,0,4,2,6,0,1,7,2,6,4,4,1
"2199",481,482,482,"black","age.gp4","NoTr","NoTrade","NoGroup",4,0,0,2,2,1,3,0,1,3,0,4,2,2,1
"2200",846,847,847,"other","age.gp2","Tr","NoTrade","Group",10,1,4,1,4,1,9,0,6,4,1,9,5,5,1
"2201",1802,1803,1803,"white","age.gp4","Tr","NoTrade","Group",8,1,3,1,3,1,6,1,4,4,0,8,5,3,1
"2202",485,486,486,"black","age.gp4","NoTr","NoTrade","NoGroup",4,1,1,0,2,1,2,1,2,2,1,3,4,0,1
"2203",487,488,488,"black","age.gp4","NoTr","NoTrade","NoGroup",1,0,1,0,0,1,0,0,0,1,0,1,0,1,1
"2204",2506,2507,2507,"black","age.gp2","NoTr","NoTrade","NoGroup",4,0,0,1,3,2,1,1,0,4,0,4,1,3,1
"2205",1836,1837,1837,"black","age.gp4","NoTr","NoTrade","NoGroup",6,0,1,0,5,4,2,0,0,6,0,6,3,3,1
"2206",491,492,492,"black","age.gp4","NoTr","NoTrade","NoGroup",1,0,0,1,0,1,0,0,0,1,0,1,0,1,1
"2207",2077,2078,2078,"black","age.gp3","NoTr","NoTrade","NoGroup",3,1,0,1,1,1,2,0,1,2,1,2,2,1,1
"2208",492,493,493,"black","age.gp4","NoTr","NoTrade","NoGroup",2,0,0,1,1,1,1,0,0,2,0,2,0,2,1
"2209",2616,2617,2617,"white","age.gp4","NoTr","NoTrade","NoGroup",5,0,0,2,3,3,2,0,2,3,0,5,2,3,1
"2210",493,494,494,"black","age.gp4","NoTr","NoTrade","NoGroup",2,0,2,0,0,1,1,0,1,1,0,2,1,1,1
"2211",494,495,495,"black","age.gp4","NoTr","NoTrade","NoGroup",1,0,1,0,0,0,0,1,1,0,0,1,1,0,1
"2212",495,496,496,"black","age.gp4","NoTr","NoTrade","NoGroup",5,1,2,1,1,3,2,0,0,5,0,5,1,4,1
"2213",1472,1473,1473,"white","age.gp1","NoTr","NoTrade","NoGroup",7,6,0,0,1,3,3,1,2,5,2,5,3,4,1
"2214",1533,1534,1534,"black","age.gp4","NoTr","NoTrade","NoGroup",3,0,0,1,2,1,2,0,1,2,0,3,1,2,1
"2215",1536,1537,1537,"black","age.gp4","NoTr","NoTrade","NoGroup",6,0,1,0,5,4,2,0,2,4,0,6,3,3,1
"2216",1951,1952,1952,"white","age.gp4","NoTr","NoTrade","Group",10,1,2,0,7,2,7,1,4,6,0,10,4,6,1
"2217",499,500,500,"black","age.gp4","NoTr","NoTrade","NoGroup",1,1,0,0,0,1,0,0,1,0,1,0,1,0,1
"2218",1669,1670,1670,"black","age.gp1","Tr","Trade","Group",14,4,5,2,3,8,4,2,5,9,3,11,4,10,1
"2219",881,882,882,"white","age.gp3","NoTr","Trade","Group",17,3,6,4,4,3,12,2,8,9,0,17,9,8,1
"2220",1697,1698,1698,"white","age.gp4","NoTr","Trade","NoGroup",3,0,0,0,3,1,2,0,1,2,0,3,2,1,1
"2221",502,503,503,"black","age.gp4","NoTr","NoTrade","NoGroup",1,0,0,0,1,1,0,0,0,1,0,1,0,1,1
"2222",1817,1818,1818,"black","age.gp4","NoTr","NoTrade","NoGroup",3,0,0,1,2,3,0,0,0,3,0,3,0,3,1
"2223",504,505,505,"black","age.gp4","NoTr","NoTrade","NoGroup",1,0,1,0,0,0,1,0,0,1,0,1,0,1,1
"2224",923,924,924,"white","age.gp2","NoTr","NoTrade","NoGroup",7,0,2,1,4,2,5,0,1,6,1,6,4,3,1
"2225",1093,1094,1094,"black","age.gp1","NoTr","NoTrade","NoGroup",9,4,2,1,2,7,2,0,3,6,3,6,4,5,1
"2226",506,507,507,"black","age.gp4","NoTr","NoTrade","NoGroup",1,0,0,0,1,0,1,0,1,0,0,1,1,0,1
"2227",2241,2242,2242,"white","age.gp4","Tr","NoTrade","Group",15,2,2,3,8,1,12,2,5,10,0,15,11,4,1
"2228",1335,1336,1336,"white","age.gp3","NoTr","NoTrade","NoGroup",6,0,3,2,1,1,5,0,4,2,1,5,4,2,1
"2229",2354,2355,2355,"white","age.gp3","Tr","NoTrade","NoGroup",6,0,1,2,3,0,6,0,4,2,0,6,4,2,1
"2230",2637,2638,2638,"white","age.gp4","NoTr","NoTrade","NoGroup",1,0,1,0,0,0,1,0,1,0,0,1,0,1,1
"2231",796,797,797,"white","age.gp4","NoTr","NoTrade","NoGroup",8,1,3,1,3,1,5,2,3,5,1,7,4,4,1
"2232",2852,2853,2853,"black","age.gp3","NoTr","NoTrade","Group",11,2,5,3,1,5,5,1,2,9,1,10,5,6,1
"2233",2084,2085,2085,"black","age.gp3","NoTr","NoTrade","NoGroup",6,0,2,3,1,3,2,1,2,4,1,5,3,3,1
"2234",513,514,514,"black","age.gp3","NoTr","NoTrade","NoGroup",1,0,0,0,1,1,0,0,0,1,1,0,1,0,1
"2235",514,515,515,"black","age.gp3","NoTr","NoTrade","NoGroup",5,2,1,1,1,3,2,0,2,3,1,4,4,1,1
"2236",1475,1476,1476,"black","age.gp1","NoTr","NoTrade","NoGroup",9,4,1,3,1,6,2,1,5,4,1,8,3,6,1
"2237",515,516,516,"black","age.gp3","NoTr","NoTrade","NoGroup",4,0,1,1,2,3,1,0,1,3,0,4,2,2,1
"2238",1090,1091,1091,"black","age.gp1","NoTr","NoTrade","NoGroup",7,3,0,2,2,3,2,2,2,5,0,7,1,6,1
"2239",1262,1263,1263,"black","age.gp3","NoTr","NoTrade","NoGroup",5,2,0,1,2,4,1,0,3,2,1,4,2,3,1
"2240",1809,1810,1810,"black","age.gp4","NoTr","NoTrade","NoGroup",4,0,1,2,1,2,2,0,1,3,1,3,3,1,1
"2241",1849,1850,1850,"black","age.gp3","NoTr","NoTrade","NoGroup",10,2,3,3,2,8,0,2,2,8,2,8,4,6,1
"2242",1086,1087,1087,"black","age.gp2","Tr","NoTrade","NoGroup",8,1,2,3,2,6,1,1,1,7,1,7,1,7,1
"2243",1922,1923,1923,"other","age.gp2","NoTr","NoTrade","NoGroup",5,0,1,2,2,1,4,0,3,2,0,5,4,1,1
"2244",2764,2765,2765,"black","age.gp2","NoTr","NoTrade","NoGroup",10,0,2,6,2,3,7,0,3,7,1,9,7,3,1
"2245",2848,2849,2849,"black","age.gp3","NoTr","NoTrade","Group",13,3,4,4,2,9,4,0,3,10,0,13,5,8,1
"2246",523,524,524,"black","age.gp3","NoTr","NoTrade","NoGroup",4,0,0,2,2,4,0,0,0,4,1,3,3,1,1
"2247",2730,2731,2731,"black","age.gp3","NoTr","NoTrade","NoGroup",7,0,3,3,1,3,3,1,2,5,0,7,5,2,1
"2248",524,525,525,"black","age.gp3","NoTr","NoTrade","NoGroup",5,1,3,0,1,1,3,1,1,4,2,3,4,1,1
"2249",1692,1693,1693,"white","age.gp4","NoTr","Trade","NoGroup",1,0,0,0,1,0,1,0,0,1,0,1,0,1,1
"2250",527,528,528,"white","age.gp4","NoTr","NoTrade","NoGroup",1,0,0,0,1,0,0,1,0,1,0,1,0,1,1
"2251",528,529,529,"white","age.gp4","NoTr","NoTrade","NoGroup",1,0,1,0,0,0,1,0,1,0,0,1,0,1,1
"2252",2939,2940,2940,"white","age.gp4","NoTr","NoTrade","Group",17,1,5,2,9,0,16,1,6,11,0,17,12,5,1
"2253",530,531,531,"white","age.gp4","NoTr","NoTrade","NoGroup",1,0,0,0,1,0,1,0,1,0,0,1,1,0,1
"2254",531,532,532,"white","age.gp4","NoTr","NoTrade","NoGroup",5,1,0,2,2,0,5,0,0,5,0,5,4,1,1
"2255",2568,2569,2569,"white","age.gp4","NoTr","NoTrade","Group",6,0,2,2,2,0,6,0,3,3,0,6,5,1,1
"2256",988,989,989,"white","age.gp4","NoTr","NoTrade","NoGroup",6,1,2,2,1,0,6,0,2,4,0,6,3,3,1
"2257",2076,2077,2077,"black","age.gp3","NoTr","NoTrade","NoGroup",7,1,1,3,2,2,5,0,0,7,0,7,3,4,1
"2258",535,536,536,"white","age.gp4","NoTr","NoTrade","NoGroup",1,0,0,1,0,0,1,0,1,0,0,1,1,0,1
"2259",536,537,537,"white","age.gp4","NoTr","NoTrade","NoGroup",1,0,1,0,0,0,1,0,1,0,0,1,1,0,1
"2260",538,539,539,"white","age.gp4","NoTr","NoTrade","NoGroup",1,0,0,0,1,0,1,0,0,1,0,1,1,0,1
"2261",539,540,540,"white","age.gp4","NoTr","NoTrade","NoGroup",6,0,1,2,3,1,5,0,4,2,0,6,3,3,1
"2262",926,927,927,"white","age.gp3","NoTr","NoTrade","NoGroup",7,0,4,2,1,0,6,1,2,5,0,7,3,4,1
"2263",2360,2361,2361,"white","age.gp3","Tr","NoTrade","NoGroup",6,0,3,1,2,0,4,2,3,3,0,6,4,2,1
"2264",540,541,541,"white","age.gp4","NoTr","NoTrade","NoGroup",6,1,3,2,0,1,5,0,2,4,2,4,5,1,1
"2265",543,544,544,"white","age.gp4","NoTr","NoTrade","NoGroup",1,0,0,0,1,0,1,0,0,1,0,1,1,0,1
"2266",2505,2506,2506,"black","age.gp2","NoTr","NoTrade","NoGroup",8,2,1,2,3,1,7,0,1,7,0,8,4,4,1
"2267",2825,2826,2826,"other","age.gp2","NoTr","NoTrade","NoGroup",7,0,2,1,4,0,7,0,3,4,1,6,5,2,1
"2268",545,546,546,"white","age.gp4","NoTr","NoTrade","NoGroup",3,1,0,1,1,0,3,0,0,3,0,3,2,1,1
"2269",2770,2771,2771,"white","age.gp1","NoTr","NoTrade","NoGroup",7,4,1,0,2,1,5,1,0,7,2,5,2,5,1
"2270",546,547,547,"white","age.gp4","NoTr","NoTrade","NoGroup",2,0,1,0,1,0,1,1,1,1,0,2,1,1,1
"2271",2282,2283,2283,"other","age.gp2","Tr","NoTrade","Group",11,2,3,1,5,1,10,0,3,8,0,11,7,4,1
"2272",547,548,548,"white","age.gp4","NoTr","NoTrade","NoGroup",1,0,0,1,0,0,1,0,0,1,0,1,1,0,1
"2273",550,551,551,"white","age.gp4","NoTr","NoTrade","NoGroup",4,0,1,1,2,2,2,0,0,4,0,4,2,2,1
"2274",2707,2708,2708,"white","age.gp4","NoTr","NoTrade","Group",11,1,4,1,5,0,11,0,4,7,1,10,7,4,1
"2275",553,554,554,"white","age.gp4","NoTr","NoTrade","NoGroup",2,0,1,0,1,0,2,0,1,1,1,1,2,0,1
"2276",2181,2182,2182,"white","age.gp4","NoTr","NoTrade","NoGroup",5,0,1,1,3,0,5,0,3,2,0,5,3,2,1
"2277",556,557,557,"white","age.gp4","NoTr","NoTrade","NoGroup",1,0,0,0,1,0,1,0,1,0,0,1,0,1,1
"2278",557,558,558,"white","age.gp4","NoTr","NoTrade","NoGroup",1,1,0,0,0,0,1,0,1,0,0,1,0,1,1
"2279",1724,1725,1725,"white","age.gp1","Tr","NoTrade","NoGroup",9,3,1,1,4,0,8,1,2,7,1,8,4,5,1
"2280",558,559,559,"other","age.gp4","NoTr","NoTrade","NoGroup",2,0,1,0,1,0,2,0,0,2,0,2,0,2,1
"2281",2443,2444,2444,"white","age.gp4","NoTr","NoTrade","NoGroup",6,0,1,1,4,1,4,1,2,4,0,6,2,4,1
"2282",560,561,561,"other","age.gp4","NoTr","NoTrade","NoGroup",4,1,0,0,3,2,2,0,1,3,0,4,1,3,1
"2283",740,741,741,"black","age.gp4","NoTr","NoTrade","NoGroup",3,1,0,1,1,1,1,1,0,3,0,3,1,2,1
"2284",934,935,935,"white","age.gp3","NoTr","NoTrade","NoGroup",10,0,3,1,6,0,9,1,4,6,0,10,6,4,1
"2285",562,563,563,"other","age.gp4","NoTr","NoTrade","NoGroup",2,0,1,0,1,0,2,0,0,2,0,2,2,0,1
"2286",563,564,564,"other","age.gp4","NoTr","NoTrade","NoGroup",1,0,0,0,1,1,0,0,0,1,0,1,1,0,1
"2287",1360,1361,1361,"black","age.gp4","NoTr","NoTrade","Group",10,0,0,4,6,4,5,1,2,8,0,10,4,6,1
"2288",565,566,566,"other","age.gp4","NoTr","NoTrade","NoGroup",2,1,0,0,1,2,0,0,1,1,1,1,1,1,1
"2289",786,787,787,"black","age.gp1","Tr","NoTrade","NoGroup",4,2,1,0,1,2,1,1,0,4,0,4,0,4,1
"2290",2220,2221,2221,"black","age.gp4","NoTr","Trade","Group",8,0,1,2,5,4,3,1,1,7,1,7,5,3,1
"2291",567,568,568,"other","age.gp4","NoTr","NoTrade","NoGroup",3,0,0,1,2,0,3,0,1,2,1,2,2,1,1
"2292",568,569,569,"other","age.gp4","NoTr","NoTrade","NoGroup",1,0,0,0,1,0,1,0,1,0,0,1,1,0,1
"2293",1285,1286,1286,"white","age.gp4","NoTr","NoTrade","Group",8,0,2,2,4,1,6,1,1,7,0,8,6,2,1
"2294",2583,2584,2584,"white","age.gp4","NoTr","NoTrade","Group",13,2,3,3,5,1,10,2,1,12,1,12,7,6,1
"2295",571,572,572,"other","age.gp4","NoTr","NoTrade","NoGroup",5,0,2,0,3,0,5,0,3,2,0,5,3,2,1
"2296",1316,1317,1317,"white","age.gp2","NoTr","NoTrade","NoGroup",10,2,3,4,1,2,7,1,3,7,0,10,5,5,1
"2297",572,573,573,"other","age.gp4","NoTr","NoTrade","NoGroup",3,0,0,2,1,0,3,0,2,1,0,3,2,1,1
"2298",575,576,576,"other","age.gp4","NoTr","NoTrade","NoGroup",4,0,1,0,3,0,4,0,3,1,0,4,4,0,1
"2299",576,577,577,"other","age.gp4","NoTr","NoTrade","NoGroup",1,0,0,1,0,0,1,0,1,0,0,1,1,0,1
"2300",974,975,975,"white","age.gp4","NoTr","NoTrade","NoGroup",3,0,0,0,3,1,1,1,0,3,0,3,2,1,1
"2301",1541,1542,1542,"white","age.gp2","NoTr","NoTrade","NoGroup",7,2,2,1,2,0,4,3,3,4,1,6,2,5,1
"2302",578,579,579,"other","age.gp4","NoTr","NoTrade","NoGroup",4,0,1,1,2,0,4,0,2,2,0,4,1,3,1
"2303",581,582,582,"other","age.gp4","NoTr","NoTrade","NoGroup",3,0,1,0,2,0,3,0,1,2,0,3,1,2,1
"2304",2432,2433,2433,"white","age.gp4","NoTr","NoTrade","NoGroup",4,0,1,0,3,0,3,1,1,3,0,4,1,3,1
"2305",583,584,584,"other","age.gp4","NoTr","NoTrade","NoGroup",1,0,1,0,0,0,1,0,0,1,0,1,0,1,1
"2306",584,585,585,"other","age.gp4","NoTr","NoTrade","NoGroup",1,0,0,1,0,1,0,0,0,1,0,1,0,1,1
"2307",1185,1186,1186,"white","age.gp4","Tr","NoTrade","NoGroup",7,0,1,2,4,1,5,1,1,6,0,7,4,3,1
"2308",1477,1478,1478,"black","age.gp1","NoTr","NoTrade","NoGroup",10,3,4,1,2,5,4,1,3,7,2,8,5,5,1
"2309",2653,2654,2654,"black","age.gp1","NoTr","NoTrade","NoGroup",9,4,1,1,3,5,3,1,3,6,2,7,4,5,1
"2310",590,591,591,"other","age.gp4","NoTr","NoTrade","NoGroup",3,0,2,0,1,0,3,0,2,1,0,3,1,2,1
"2311",2633,2634,2634,"white","age.gp4","NoTr","NoTrade","NoGroup",5,0,3,0,2,0,4,1,2,3,0,5,1,4,1
"2312",592,593,593,"other","age.gp4","NoTr","NoTrade","NoGroup",2,0,1,0,1,0,2,0,0,2,0,2,2,0,1
"2313",593,594,594,"other","age.gp4","NoTr","NoTrade","NoGroup",4,0,1,1,2,0,4,0,3,1,0,4,4,0,1
"2314",595,596,596,"other","age.gp4","NoTr","NoTrade","NoGroup",1,0,0,0,1,0,1,0,0,1,0,1,1,0,1
"2315",598,599,599,"other","age.gp4","NoTr","NoTrade","NoGroup",2,0,0,0,2,0,2,0,2,0,0,2,1,1,1
"2316",1187,1188,1188,"white","age.gp4","Tr","NoTrade","NoGroup",5,0,3,0,2,0,4,1,1,4,1,4,3,2,1
"2317",2428,2429,2429,"white","age.gp4","NoTr","NoTrade","NoGroup",1,0,0,0,1,0,0,1,0,1,0,1,0,1,1
"2318",601,602,602,"other","age.gp4","NoTr","NoTrade","NoGroup",2,0,1,0,1,0,2,0,1,1,0,2,0,2,1
"2319",1156,1157,1157,"white","age.gp4","NoTr","NoTrade","NoGroup",5,0,0,1,4,0,4,1,1,4,0,5,3,2,1
"2320",602,603,603,"other","age.gp4","NoTr","NoTrade","NoGroup",1,1,0,0,0,0,1,0,1,0,0,1,0,1,1
"2321",2463,2464,2464,"white","age.gp1","Tr","NoTrade","NoGroup",9,4,2,2,1,0,6,3,2,7,1,8,8,1,1
"2322",606,607,607,"other","age.gp4","NoTr","NoTrade","NoGroup",3,0,0,0,3,1,2,0,1,2,0,3,2,1,1
"2323",1999,2000,2000,"black","age.gp4","NoTr","NoTrade","NoGroup",4,0,0,2,2,2,1,1,1,3,0,4,0,4,1
"2324",607,608,608,"other","age.gp4","NoTr","NoTrade","NoGroup",2,0,0,0,2,0,2,0,1,1,0,2,1,1,1
"2325",996,997,997,"white","age.gp4","NoTr","NoTrade","NoGroup",10,0,3,1,6,1,7,2,4,6,0,10,5,5,1
"2326",2034,2035,2035,"white","age.gp4","Tr","NoTrade","Group",9,0,1,2,6,0,7,2,4,5,0,9,4,5,1
"2327",608,609,609,"other","age.gp4","NoTr","NoTrade","NoGroup",4,0,1,1,2,0,4,0,1,3,0,4,3,1,1
"2328",609,610,610,"other","age.gp4","NoTr","NoTrade","NoGroup",2,0,1,0,1,1,1,0,1,1,1,1,1,1,1
"2329",2193,2194,2194,"white","age.gp4","NoTr","NoTrade","NoGroup",7,1,2,1,3,1,5,1,4,3,0,7,4,3,1
"2330",2575,2576,2576,"white","age.gp4","NoTr","NoTrade","Group",5,0,1,0,4,1,3,1,1,4,0,5,3,2,1
"2331",611,612,612,"other","age.gp4","NoTr","NoTrade","NoGroup",1,0,1,0,0,0,1,0,1,0,0,1,1,0,1
"2332",612,613,613,"other","age.gp4","NoTr","NoTrade","NoGroup",2,0,0,0,2,0,2,0,0,2,0,2,2,0,1
"2333",1293,1294,1294,"white","age.gp4","NoTr","NoTrade","Group",15,2,2,2,9,0,13,2,3,12,0,15,11,4,1
"2334",613,614,614,"other","age.gp4","NoTr","NoTrade","NoGroup",1,0,0,1,0,0,1,0,0,1,0,1,1,0,1
"2335",615,616,616,"other","age.gp4","NoTr","NoTrade","NoGroup",4,0,1,1,2,1,3,0,2,2,0,4,3,1,1
"2336",616,617,617,"other","age.gp4","NoTr","NoTrade","NoGroup",3,0,2,0,1,0,3,0,3,0,0,3,0,3,1
"2337",617,618,618,"other","age.gp4","NoTr","NoTrade","NoGroup",6,0,1,0,5,1,5,0,2,4,1,5,5,1,1
"2338",1233,1234,1234,"white","age.gp4","NoTr","NoTrade","NoGroup",4,0,1,0,3,0,3,1,1,3,0,4,3,1,1
"2339",618,619,619,"other","age.gp4","NoTr","NoTrade","NoGroup",5,1,1,1,2,0,5,0,1,4,0,5,3,2,1
"2340",619,620,620,"other","age.gp4","NoTr","NoTrade","NoGroup",4,0,1,1,2,0,4,0,2,2,0,4,2,2,1
"2341",975,976,976,"white","age.gp4","NoTr","NoTrade","NoGroup",1,0,0,0,1,0,0,1,0,1,0,1,0,1,1
"2342",621,622,622,"other","age.gp4","NoTr","NoTrade","NoGroup",2,0,0,0,2,0,2,0,0,2,1,1,1,1,1
"2343",1701,1702,1702,"white","age.gp4","NoTr","Trade","NoGroup",6,0,1,0,5,0,4,2,3,3,0,6,4,2,1
"2344",622,623,623,"other","age.gp1","NoTr","Trade","Group",2,1,0,1,0,1,1,0,0,2,0,2,1,1,1
"2345",1445,1446,1446,"white","age.gp1","NoTr","NoTrade","NoGroup",14,7,3,2,2,0,11,3,6,8,3,11,7,7,1
"2346",2382,2383,2383,"white","age.gp1","NoTr","NoTrade","NoGroup",12,9,1,0,2,0,9,3,2,10,3,9,6,6,1
"2347",624,625,625,"other","age.gp1","NoTr","Trade","Group",7,2,3,1,1,0,6,1,4,3,0,7,3,4,1
"2348",1902,1903,1903,"black","age.gp1","NoTr","NoTrade","NoGroup",9,4,3,1,1,5,2,2,1,8,2,7,4,5,1
"2349",2466,2467,2467,"white","age.gp1","Tr","NoTrade","NoGroup",11,6,1,1,3,0,8,3,3,8,1,10,6,5,1
"2350",2870,2871,2871,"white","age.gp1","NoTr","NoTrade","Group",16,11,2,1,2,2,9,5,4,12,4,12,9,7,1
"2351",920,921,921,"white","age.gp1","NoTr","Trade","NoGroup",7,5,2,0,0,0,5,2,1,6,1,6,2,5,1
"2352",919,920,920,"white","age.gp1","NoTr","Trade","NoGroup",8,7,0,1,0,0,3,5,1,7,3,5,6,2,1
"2353",676,677,677,"white","age.gp4","Tr","NoTrade","Group",11,3,0,4,4,1,8,2,2,9,1,10,6,5,1
"2354",2395,2396,2396,"white","age.gp3","NoTr","NoTrade","NoGroup",10,3,1,2,4,1,7,2,2,8,2,8,7,3,1
"2355",1337,1338,1338,"white","age.gp3","NoTr","NoTrade","NoGroup",6,1,1,2,2,0,4,2,2,4,1,5,5,1,1
"2356",1274,1275,1275,"white","age.gp4","NoTr","NoTrade","Group",14,1,3,3,7,1,11,2,4,10,4,10,12,2,1
"2357",1329,1330,1330,"white","age.gp3","NoTr","NoTrade","NoGroup",7,1,2,1,3,1,5,1,4,3,1,6,4,3,1
"2358",2887,2888,2888,"white","age.gp1","NoTr","NoTrade","Group",19,11,6,2,0,0,13,6,7,12,2,17,10,9,1
"2359",2916,2917,2917,"white","age.gp1","NoTr","NoTrade","NoGroup",13,6,3,3,1,0,10,3,2,11,1,12,10,3,1
"2360",2779,2780,2780,"white","age.gp3","NoTr","NoTrade","Group",16,4,4,4,4,1,10,5,7,9,2,14,13,3,1
"2361",2697,2698,2698,"white","age.gp4","NoTr","NoTrade","Group",12,1,3,0,8,3,6,3,6,6,1,11,12,0,1
"2362",1624,1625,1625,"white","age.gp1","NoTr","NoTrade","NoGroup",9,5,3,1,0,0,7,2,2,7,1,8,2,7,1
"2363",641,642,642,"other","age.gp1","NoTr","Trade","Group",7,4,2,1,0,2,5,0,3,4,2,5,4,3,1
"2364",784,785,785,"black","age.gp1","Tr","NoTrade","NoGroup",11,6,3,2,0,2,7,2,2,9,2,9,7,4,1
"2365",1713,1714,1714,"white","age.gp1","Tr","NoTrade","NoGroup",9,5,2,1,1,1,5,3,5,4,1,8,4,5,1
"2366",2259,2260,2260,"white","age.gp4","Tr","NoTrade","Group",10,4,0,3,3,2,5,3,0,10,4,6,8,2,1
"2367",2381,2382,2382,"white","age.gp1","NoTr","NoTrade","NoGroup",12,7,2,2,1,1,8,3,5,7,2,10,8,4,1
"2368",2464,2465,2465,"white","age.gp1","Tr","NoTrade","NoGroup",10,8,0,1,1,0,6,4,4,6,1,9,3,7,1
"2369",1014,1015,1015,"white","age.gp1","NoTr","NoTrade","NoGroup",9,5,2,2,0,2,5,2,4,5,2,7,5,4,1
"2370",647,648,648,"other","age.gp1","NoTr","Trade","Group",7,1,1,1,4,0,7,0,4,3,0,7,4,3,1
"2371",1447,1448,1448,"white","age.gp1","NoTr","NoTrade","NoGroup",5,2,0,1,2,0,4,1,1,4,1,4,3,2,1
"2372",649,650,650,"other","age.gp1","NoTr","Trade","Group",4,0,1,3,0,0,4,0,2,2,0,4,3,1,1
"2373",927,928,928,"white","age.gp3","NoTr","NoTrade","NoGroup",11,1,5,3,2,1,8,2,7,4,2,9,9,2,1
"2374",1253,1254,1254,"white","age.gp2","Tr","NoTrade","Group",21,5,11,3,2,2,15,4,10,11,2,19,15,6,1
"2375",2819,2820,2820,"other","age.gp2","NoTr","NoTrade","NoGroup",5,0,4,1,0,1,4,0,1,4,0,5,4,1,1
"2376",1451,1452,1452,"black","age.gp1","NoTr","NoTrade","NoGroup",10,4,4,1,1,6,4,0,2,8,1,9,4,6,1
"2377",1535,1536,1536,"black","age.gp4","NoTr","NoTrade","NoGroup",6,0,1,3,2,3,3,0,1,5,0,6,4,2,1
"2378",911,912,912,"other","age.gp1","Tr","NoTrade","NoGroup",7,6,1,0,0,0,7,0,5,2,0,7,2,5,1
"2379",1660,1661,1661,"other","age.gp2","NoTr","NoTrade","NoGroup",6,0,1,2,3,1,5,0,3,3,0,6,4,2,1
"2380",1828,1829,1829,"black","age.gp4","NoTr","NoTrade","NoGroup",1,0,1,0,0,0,1,0,1,0,0,1,0,1,1
"2381",658,659,659,"white","age.gp2","Tr","NoTrade","NoGroup",4,0,2,2,0,1,3,0,2,2,1,3,3,1,1
"2382",2555,2556,2556,"other","age.gp1","NoTr","NoTrade","NoGroup",2,0,2,0,0,0,2,0,2,0,0,2,1,1,1
"2383",2042,2043,2043,"white","age.gp4","Tr","NoTrade","Group",9,2,3,2,2,0,8,1,0,9,0,9,7,2,1
"2384",1089,1090,1090,"black","age.gp2","Tr","NoTrade","NoGroup",8,0,4,4,0,1,7,0,4,4,0,8,5,3,1
"2385",2147,2148,2148,"other","age.gp2","NoTr","NoTrade","NoGroup",5,0,3,0,2,1,4,0,2,3,0,5,3,2,1
"2386",2169,2170,2170,"white","age.gp2","NoTr","NoTrade","Group",24,3,11,7,3,1,19,4,9,15,2,22,17,7,1
"2387",2398,2399,2399,"white","age.gp3","NoTr","NoTrade","NoGroup",7,0,3,2,2,1,6,0,1,6,0,7,3,4,1
"2388",675,676,676,"white","age.gp4","Tr","NoTrade","Group",6,1,3,0,2,1,3,2,2,4,0,6,6,0,1
"2389",2930,2931,2931,"white","age.gp4","NoTr","NoTrade","Group",10,2,2,2,4,0,9,1,3,7,0,10,6,4,1
"2390",719,720,720,"black","age.gp4","NoTr","NoTrade","NoGroup",3,0,2,0,1,2,1,0,1,2,0,3,2,1,1
"2391",2375,2376,2376,"white","age.gp2","NoTr","NoTrade","NoGroup",10,0,5,2,3,2,8,0,2,8,0,10,4,6,1
"2392",2879,2880,2880,"white","age.gp2","NoTr","NoTrade","NoGroup",12,1,7,4,0,1,11,0,6,6,0,12,7,5,1
"2393",670,671,671,"white","age.gp4","Tr","NoTrade","Group",6,1,0,2,3,1,4,1,2,4,0,6,4,2,1
"2394",2441,2442,2442,"white","age.gp4","NoTr","NoTrade","NoGroup",7,0,2,1,4,0,6,1,3,4,0,7,5,2,1
"2395",1568,1569,1569,"white","age.gp4","Tr","NoTrade","Group",15,0,0,2,13,1,14,0,7,8,1,14,13,2,1
"2396",1813,1814,1814,"black","age.gp4","NoTr","NoTrade","NoGroup",2,0,0,0,2,0,2,0,1,1,0,2,1,1,1
"2397",1403,1404,1404,"white","age.gp3","NoTr","NoTrade","Group",18,4,6,4,4,0,15,3,3,15,1,17,9,9,1
"2398",2892,2893,2893,"other","age.gp1","NoTr","NoTrade","NoGroup",6,4,1,0,1,0,6,0,3,3,0,6,3,3,1
"2399",1931,1932,1932,"other","age.gp2","NoTr","NoTrade","NoGroup",5,0,1,3,1,0,5,0,3,2,1,4,4,1,1
"2400",852,853,853,"other","age.gp2","Tr","NoTrade","Group",10,0,8,1,1,1,9,0,4,6,0,10,9,1,1
"2401",940,941,941,"white","age.gp3","NoTr","NoTrade","NoGroup",5,0,0,3,2,0,5,0,2,3,0,5,4,1,1
"2402",1774,1775,1775,"white","age.gp4","Tr","NoTrade","Group",5,0,3,1,1,0,5,0,4,1,0,5,3,2,1
"2403",2408,2409,2409,"white","age.gp3","NoTr","NoTrade","NoGroup",9,2,1,3,3,0,7,2,1,8,1,8,6,3,1
"2404",1155,1156,1156,"white","age.gp4","NoTr","NoTrade","NoGroup",1,0,0,0,1,0,1,0,1,0,0,1,1,0,1
"2405",1284,1285,1285,"white","age.gp4","NoTr","NoTrade","Group",10,1,1,2,6,1,9,0,5,5,0,10,9,1,1
"2406",810,811,811,"white","age.gp4","NoTr","NoTrade","NoGroup",5,0,0,1,4,0,5,0,4,1,0,5,5,0,1
"2407",1245,1246,1246,"white","age.gp1","NoTr","NoTrade","NoGroup",5,1,1,0,3,1,4,0,4,1,0,5,4,1,1
"2408",1347,1348,1348,"black","age.gp4","NoTr","NoTrade","Group",6,0,2,0,4,2,4,0,2,4,0,6,3,3,1
"2409",2967,2968,2968,"white","age.gp2","NoTr","NoTrade","NoGroup",7,0,3,2,2,2,5,0,2,5,0,7,5,2,1
"2410",1237,1238,1238,"white","age.gp4","NoTr","NoTrade","NoGroup",3,0,1,0,2,0,3,0,3,0,0,3,3,0,1
"2411",1929,1930,1930,"other","age.gp2","NoTr","NoTrade","NoGroup",7,0,1,5,1,0,7,0,4,3,0,7,5,2,1
"2412",2634,2635,2635,"white","age.gp4","NoTr","NoTrade","NoGroup",3,0,1,0,2,0,3,0,2,1,0,3,2,1,1
"2413",686,687,687,"white","age.gp4","Tr","NoTrade","Group",7,0,2,1,4,0,7,0,2,5,1,6,3,4,1
"2414",1292,1293,1293,"white","age.gp4","NoTr","NoTrade","Group",8,0,2,0,6,0,8,0,4,4,0,8,6,2,1
"2415",1675,1676,1676,"white","age.gp4","NoTr","Trade","NoGroup",3,0,1,0,2,0,3,0,2,1,0,3,3,0,1
"2416",2376,2377,2377,"white","age.gp2","NoTr","NoTrade","NoGroup",5,0,3,0,2,0,5,0,1,4,0,5,5,0,1
"2417",782,783,783,"white","age.gp2","NoTr","NoTrade","NoGroup",7,0,2,3,2,0,6,1,3,4,0,7,6,1,1
"2418",1068,1069,1069,"white","age.gp4","NoTr","NoTrade","Group",12,0,4,2,6,3,9,0,5,7,1,11,9,3,1
"2419",2627,2628,2628,"white","age.gp4","NoTr","NoTrade","NoGroup",6,0,1,0,5,1,5,0,3,3,0,6,5,1,1
"2420",690,691,691,"white","age.gp4","Tr","NoTrade","Group",4,0,1,1,2,0,3,1,2,2,1,3,3,1,1
"2421",1483,1484,1484,"white","age.gp4","NoTr","NoTrade","NoGroup",2,0,1,0,1,0,1,1,1,1,0,2,1,1,1
"2422",2722,2723,2723,"white","age.gp4","NoTr","NoTrade","Group",10,0,2,3,5,3,7,0,5,5,1,9,7,3,1
"2423",1944,1945,1945,"white","age.gp4","NoTr","NoTrade","Group",6,0,0,2,4,0,6,0,4,2,0,6,6,0,1
"2424",2824,2825,2825,"other","age.gp2","NoTr","NoTrade","NoGroup",5,0,4,0,1,1,4,0,3,2,0,5,3,2,1
"2425",1679,1680,1680,"white","age.gp4","NoTr","Trade","NoGroup",4,0,0,1,3,0,4,0,3,1,0,4,4,0,1
"2426",1916,1917,1917,"other","age.gp2","NoTr","NoTrade","NoGroup",6,0,2,1,3,0,6,0,3,3,0,6,5,1,1
"2427",1897,1898,1898,"white","age.gp1","Tr","NoTrade","NoGroup",6,2,0,2,2,0,5,1,2,4,1,5,4,2,1
"2428",2056,2057,2057,"white","age.gp4","Tr","NoTrade","Group",11,0,3,4,4,0,10,1,7,4,0,11,8,3,1
"2429",2857,2858,2858,"black","age.gp3","NoTr","NoTrade","Group",13,0,6,4,3,6,7,0,5,8,1,12,11,2,1
"2430",701,702,702,"white","age.gp4","Tr","NoTrade","Group",6,0,3,2,1,1,5,0,2,4,1,5,5,1,1
"2431",733,734,734,"black","age.gp4","NoTr","NoTrade","NoGroup",4,1,2,0,1,1,3,0,1,3,0,4,3,1,1
"2432",1617,1618,1618,"white","age.gp3","Tr","NoTrade","NoGroup",5,1,4,0,0,0,5,0,1,4,0,5,4,1,1
"2433",2827,2828,2828,"other","age.gp2","NoTr","NoTrade","NoGroup",5,0,4,0,1,1,4,0,0,5,0,5,3,2,1
"2434",1498,1499,1499,"white","age.gp4","NoTr","NoTrade","NoGroup",3,0,2,0,1,0,3,0,0,3,0,3,3,0,1
"2435",2460,2461,2461,"black","age.gp1","NoTr","NoTrade","NoGroup",12,5,2,1,4,5,7,0,1,11,1,11,7,5,1
"2436",706,707,707,"white","age.gp2","NoTr","NoTrade","Group",20,2,13,2,3,3,12,5,11,9,1,19,11,9,1
"2437",1395,1396,1396,"black","age.gp3","NoTr","NoTrade","NoGroup",8,1,2,2,3,5,3,0,2,6,1,7,4,4,1
"2438",1651,1652,1652,"other","age.gp2","NoTr","NoTrade","NoGroup",2,0,2,0,0,0,2,0,0,2,1,1,2,0,1
"2439",2143,2144,2144,"other","age.gp2","NoTr","NoTrade","NoGroup",6,0,3,1,2,1,5,0,3,3,1,5,5,1,1
"2440",1819,1820,1820,"black","age.gp4","NoTr","NoTrade","NoGroup",1,0,1,0,0,0,1,0,1,0,0,1,1,0,1
"2441",2364,2365,2365,"white","age.gp3","Tr","NoTrade","NoGroup",11,0,4,6,1,1,8,2,4,7,0,11,7,4,1
"2442",2489,2490,2490,"other","age.gp1","NoTr","NoTrade","NoGroup",1,0,1,0,0,0,1,0,1,0,0,1,1,0,1
"2443",922,923,923,"white","age.gp2","NoTr","NoTrade","NoGroup",8,1,3,2,2,0,7,1,4,4,0,8,4,4,1
"2444",925,926,926,"white","age.gp2","NoTr","NoTrade","NoGroup",7,1,3,2,1,0,6,1,3,4,1,6,7,0,1
"2445",1119,1120,1120,"other","age.gp1","NoTr","NoTrade","NoGroup",4,1,3,0,0,0,4,0,2,2,0,4,2,2,1
"2446",1172,1173,1173,"white","age.gp4","NoTr","NoTrade","NoGroup",7,1,1,1,4,2,5,0,3,4,2,5,5,2,1
"2447",1915,1916,1916,"other","age.gp2","NoTr","NoTrade","NoGroup",3,0,1,0,2,0,3,0,1,2,0,3,3,0,1
"2448",2832,2833,2833,"white","age.gp2","Tr","NoTrade","NoGroup",12,0,5,3,4,0,11,1,4,8,0,12,9,3,1
"2449",1928,1929,1929,"other","age.gp2","NoTr","NoTrade","NoGroup",4,1,2,1,0,0,4,0,3,1,0,4,3,1,1
"2450",2140,2141,2141,"other","age.gp2","NoTr","NoTrade","NoGroup",3,0,1,1,1,1,2,0,1,2,0,3,2,1,1
"2451",713,714,714,"black","age.gp4","NoTr","NoTrade","NoGroup",1,0,0,0,1,0,1,0,1,0,0,1,1,0,1
"2452",714,715,715,"black","age.gp4","NoTr","NoTrade","NoGroup",1,0,0,1,0,0,1,0,0,1,1,0,1,0,1
"2453",715,716,716,"black","age.gp4","NoTr","NoTrade","NoGroup",1,0,1,0,0,1,0,0,0,1,0,1,1,0,1
"2454",716,717,717,"black","age.gp4","NoTr","NoTrade","NoGroup",1,0,1,0,0,0,1,0,1,0,0,1,1,0,1
"2455",717,718,718,"black","age.gp4","NoTr","NoTrade","NoGroup",1,0,0,0,1,1,0,0,0,1,0,1,0,1,1
"2456",720,721,721,"black","age.gp4","NoTr","NoTrade","NoGroup",6,0,2,1,3,4,2,0,1,5,1,5,3,3,1
"2457",718,719,719,"black","age.gp4","NoTr","NoTrade","NoGroup",1,0,1,0,0,1,0,0,0,1,1,0,1,0,1
"2458",721,722,722,"black","age.gp4","NoTr","NoTrade","NoGroup",1,0,0,1,0,1,0,0,0,1,0,1,0,1,1
"2459",2093,2094,2094,"black","age.gp3","NoTr","NoTrade","NoGroup",9,1,2,4,2,5,3,1,2,7,4,5,5,4,1
"2460",724,725,725,"black","age.gp4","NoTr","NoTrade","NoGroup",1,0,1,0,0,0,0,1,1,0,0,1,1,0,1
"2461",859,860,860,"other","age.gp2","Tr","NoTrade","Group",10,0,3,1,6,1,9,0,3,7,0,10,9,1,1
"2462",727,728,728,"black","age.gp4","NoTr","NoTrade","NoGroup",1,0,0,1,0,1,0,0,0,1,0,1,0,1,1
"2463",1397,1398,1398,"black","age.gp3","NoTr","NoTrade","NoGroup",8,0,4,2,2,4,4,0,2,6,0,8,5,3,1
"2464",2204,2205,2205,"white","age.gp4","NoTr","NoTrade","NoGroup",7,2,1,1,3,1,5,1,3,4,0,7,3,4,1
"2465",2226,2227,2227,"black","age.gp4","NoTr","Trade","Group",10,0,1,3,6,5,5,0,4,6,0,10,6,4,1
"2466",732,733,733,"black","age.gp4","NoTr","NoTrade","NoGroup",2,0,0,1,1,1,1,0,0,2,0,2,1,1,1
"2467",735,736,736,"black","age.gp4","NoTr","NoTrade","NoGroup",2,0,0,0,2,1,1,0,0,2,0,2,1,1,1
"2468",1755,1756,1756,"black","age.gp4","NoTr","NoTrade","NoGroup",2,0,0,0,2,2,0,0,0,2,0,2,0,2,1
"2469",736,737,737,"black","age.gp4","NoTr","NoTrade","NoGroup",1,0,0,0,1,0,1,0,1,0,0,1,0,1,1
"2470",737,738,738,"black","age.gp4","NoTr","NoTrade","NoGroup",3,0,1,1,1,2,1,0,2,1,1,2,2,1,1
"2471",1032,1033,1033,"black","age.gp4","NoTr","NoTrade","NoGroup",1,0,0,0,1,1,0,0,0,1,0,1,0,1,1
"2472",1762,1763,1763,"black","age.gp4","NoTr","NoTrade","NoGroup",1,0,0,0,1,1,0,0,0,1,0,1,0,1,1
"2473",1825,1826,1826,"black","age.gp4","NoTr","NoTrade","NoGroup",5,0,0,1,4,5,0,0,0,5,0,5,1,4,1
"2474",2081,2082,2082,"black","age.gp3","NoTr","NoTrade","NoGroup",6,1,2,1,2,2,2,2,1,5,0,6,2,4,1
"2475",741,742,742,"black","age.gp4","NoTr","NoTrade","NoGroup",4,0,0,2,2,3,1,0,0,4,0,4,2,2,1
"2476",1269,1270,1270,"black","age.gp3","NoTr","NoTrade","NoGroup",2,0,0,1,1,2,0,0,0,2,0,2,0,2,1
"2477",1515,1516,1516,"black","age.gp4","NoTr","NoTrade","NoGroup",2,0,1,0,1,2,0,0,0,2,0,2,0,2,1
"2478",2139,2140,2140,"other","age.gp2","NoTr","NoTrade","NoGroup",3,0,2,1,0,0,3,0,2,1,0,3,3,0,1
"2479",748,749,749,"white","age.gp4","NoTr","NoTrade","NoGroup",5,0,2,0,3,1,4,0,1,4,0,5,4,1,1
"2480",2541,2542,2542,"other","age.gp1","NoTr","NoTrade","NoGroup",3,1,2,0,0,0,3,0,2,1,0,3,2,1,1
"2481",1131,1132,1132,"other","age.gp1","NoTr","NoTrade","NoGroup",4,3,1,0,0,1,3,0,2,2,1,3,2,2,1
"2482",2665,2666,2666,"white","age.gp3","NoTr","NoTrade","NoGroup",10,1,3,3,3,1,8,1,5,5,0,10,6,4,1
"2483",818,819,819,"white","age.gp4","NoTr","NoTrade","NoGroup",7,1,1,3,2,1,6,0,4,3,0,7,3,4,1
"2484",2145,2146,2146,"other","age.gp2","NoTr","NoTrade","NoGroup",5,0,3,1,1,0,5,0,2,3,1,4,4,1,1
"2485",2808,2809,2809,"other","age.gp2","NoTr","NoTrade","NoGroup",5,0,4,0,1,1,4,0,3,2,0,5,3,2,1
"2486",747,748,748,"white","age.gp4","NoTr","NoTrade","NoGroup",3,1,0,1,1,0,2,1,1,2,0,3,3,0,1
"2487",2165,2166,2166,"black","age.gp2","NoTr","NoTrade","NoGroup",7,0,4,0,3,5,2,0,1,6,0,7,0,7,1
"2488",749,750,750,"white","age.gp4","NoTr","NoTrade","NoGroup",1,0,0,1,0,0,1,0,0,1,0,1,1,0,1
"2489",750,751,751,"white","age.gp4","NoTr","NoTrade","NoGroup",1,0,0,0,1,0,1,0,0,1,0,1,0,1,1
"2490",762,763,763,"white","age.gp4","NoTr","NoTrade","NoGroup",5,0,0,2,3,0,5,0,2,3,0,5,4,1,1
"2491",1934,1935,1935,"white","age.gp4","NoTr","NoTrade","Group",8,2,2,1,3,0,7,1,3,5,0,8,6,2,1
"2492",752,753,753,"white","age.gp4","NoTr","NoTrade","NoGroup",1,0,0,1,0,0,1,0,0,1,0,1,1,0,1
"2493",753,754,754,"white","age.gp4","NoTr","NoTrade","NoGroup",1,0,0,0,1,0,1,0,1,0,0,1,1,0,1
"2494",755,756,756,"white","age.gp4","NoTr","NoTrade","NoGroup",1,0,0,1,0,0,1,0,0,1,1,0,1,0,1
"2495",756,757,757,"white","age.gp4","NoTr","NoTrade","NoGroup",7,0,1,3,3,1,6,0,1,6,2,5,6,1,1
"2496",757,758,758,"white","age.gp4","NoTr","NoTrade","NoGroup",1,0,0,1,0,0,1,0,0,1,1,0,1,0,1
"2497",758,759,759,"white","age.gp4","NoTr","NoTrade","NoGroup",1,1,0,0,0,0,1,0,1,0,0,1,0,1,1
"2498",759,760,760,"white","age.gp4","NoTr","NoTrade","NoGroup",3,0,1,0,2,0,3,0,2,1,0,3,2,1,1
"2499",2262,2263,2263,"white","age.gp4","Tr","NoTrade","Group",14,2,2,2,8,0,13,1,5,9,3,11,7,7,1
"2500",763,764,764,"white","age.gp4","NoTr","NoTrade","NoGroup",1,0,0,1,0,0,1,0,0,1,1,0,1,0,1
"2501",764,765,765,"white","age.gp4","NoTr","NoTrade","NoGroup",6,1,1,1,3,0,5,1,2,4,0,6,5,1,1
"2502",765,766,766,"white","age.gp4","NoTr","NoTrade","NoGroup",6,1,0,2,3,0,5,1,4,2,0,6,3,3,1
"2503",906,907,907,"other","age.gp1","Tr","NoTrade","NoGroup",3,2,0,0,1,0,3,0,0,3,0,3,0,3,1
"2504",1442,1443,1443,"white","age.gp3","Tr","NoTrade","NoGroup",7,0,2,0,5,0,7,0,2,5,1,6,5,2,1
"2505",766,767,767,"white","age.gp4","NoTr","NoTrade","NoGroup",1,0,1,0,0,0,0,1,0,1,0,1,0,1,1
"2506",767,768,768,"white","age.gp4","NoTr","NoTrade","NoGroup",1,0,0,0,1,0,1,0,0,1,0,1,1,0,1
"2507",769,770,770,"white","age.gp4","NoTr","NoTrade","NoGroup",1,0,0,1,0,0,1,0,0,1,0,1,0,1,1
"2508",2747,2748,2748,"white","age.gp3","NoTr","NoTrade","NoGroup",9,1,2,3,3,0,9,0,3,6,0,9,5,4,1
"2509",770,771,771,"white","age.gp4","NoTr","NoTrade","NoGroup",5,0,1,0,4,0,5,0,3,2,0,5,3,2,1
"2510",1063,1064,1064,"white","age.gp4","NoTr","NoTrade","Group",12,0,3,4,5,0,10,2,7,5,0,12,8,4,1
"2511",772,773,773,"white","age.gp4","NoTr","NoTrade","NoGroup",4,0,3,1,0,0,3,1,0,4,0,4,2,2,1
"2512",773,774,774,"white","age.gp4","NoTr","NoTrade","NoGroup",8,0,2,3,3,0,8,0,3,5,1,7,6,2,1
"2513",774,775,775,"white","age.gp4","NoTr","NoTrade","NoGroup",1,0,0,0,1,0,1,0,0,1,0,1,1,0,1
"2514",1015,1016,1016,"white","age.gp1","NoTr","NoTrade","NoGroup",3,2,0,0,1,0,2,1,0,3,0,3,0,3,1
"2515",958,959,959,"black","age.gp2","Tr","NoTrade","NoGroup",11,3,5,1,2,8,2,1,1,10,1,10,5,6,1
"2516",1643,1644,1644,"other","age.gp2","NoTr","NoTrade","NoGroup",2,1,1,0,0,0,2,0,0,2,0,2,1,1,1
"2517",1910,1911,1911,"other","age.gp2","NoTr","NoTrade","NoGroup",3,0,2,1,0,0,3,0,1,2,0,3,2,1,1
"2518",1918,1919,1919,"other","age.gp2","NoTr","NoTrade","NoGroup",6,1,3,2,0,2,4,0,2,4,1,5,2,4,1
"2519",2822,2823,2823,"other","age.gp2","NoTr","NoTrade","NoGroup",1,0,1,0,0,0,1,0,0,1,0,1,0,1,1
"2520",783,784,784,"white","age.gp2","NoTr","NoTrade","NoGroup",8,1,3,2,2,0,7,1,2,6,0,8,7,1,1
"2521",2652,2653,2653,"black","age.gp1","NoTr","NoTrade","NoGroup",8,8,0,0,0,3,3,2,6,2,3,5,4,4,1
"2522",2655,2656,2656,"black","age.gp1","NoTr","NoTrade","NoGroup",6,2,1,0,3,5,1,0,2,4,0,6,3,3,1
"2523",2457,2458,2458,"black","age.gp1","NoTr","NoTrade","NoGroup",4,4,0,0,0,2,2,0,2,2,0,4,0,4,1
"2524",1218,1219,1219,"white","age.gp4","NoTr","NoTrade","NoGroup",3,1,1,0,1,1,1,1,2,1,0,3,1,2,1
"2525",789,790,790,"white","age.gp4","NoTr","NoTrade","NoGroup",1,0,0,0,1,0,1,0,0,1,0,1,0,1,1
"2526",1110,1111,1111,"other","age.gp1","NoTr","NoTrade","NoGroup",4,1,1,1,1,0,4,0,2,2,0,4,0,4,1
"2527",2548,2549,2549,"other","age.gp1","NoTr","NoTrade","NoGroup",5,2,0,2,1,0,5,0,0,5,0,5,1,4,1
"2528",795,796,796,"white","age.gp4","NoTr","NoTrade","NoGroup",1,1,0,0,0,0,1,0,0,1,0,1,1,0,1
"2529",797,798,798,"white","age.gp4","NoTr","NoTrade","NoGroup",1,0,0,0,1,0,1,0,1,0,0,1,1,0,1
"2530",798,799,799,"white","age.gp4","NoTr","NoTrade","NoGroup",5,0,1,2,2,1,4,0,2,3,0,5,3,2,1
"2531",799,800,800,"white","age.gp4","NoTr","NoTrade","NoGroup",1,0,0,1,0,1,0,0,0,1,0,1,1,0,1
"2532",800,801,801,"white","age.gp4","NoTr","NoTrade","NoGroup",1,0,0,0,1,0,1,0,0,1,0,1,1,0,1
"2533",1430,1431,1431,"white","age.gp3","Tr","NoTrade","NoGroup",5,1,2,0,2,2,3,0,0,5,1,4,0,5,1
"2534",802,803,803,"white","age.gp4","NoTr","NoTrade","NoGroup",3,0,0,0,3,0,3,0,3,0,0,3,3,0,1
"2535",803,804,804,"white","age.gp4","NoTr","NoTrade","NoGroup",1,0,0,0,1,0,1,0,0,1,0,1,1,0,1
"2536",804,805,805,"white","age.gp4","NoTr","NoTrade","NoGroup",1,0,1,0,0,0,1,0,1,0,0,1,1,0,1
"2537",805,806,806,"white","age.gp4","NoTr","NoTrade","NoGroup",1,0,0,0,1,0,1,0,1,0,0,1,0,1,1
"2538",973,974,974,"white","age.gp4","NoTr","NoTrade","NoGroup",1,0,0,0,1,0,1,0,0,1,0,1,0,1,1
"2539",808,809,809,"white","age.gp4","NoTr","NoTrade","NoGroup",2,0,1,0,1,0,2,0,1,1,0,2,2,0,1
"2540",809,810,810,"white","age.gp4","NoTr","NoTrade","NoGroup",1,0,0,0,1,0,1,0,1,0,0,1,1,0,1
"2541",811,812,812,"white","age.gp4","NoTr","NoTrade","NoGroup",1,0,0,1,0,0,1,0,0,1,1,0,1,0,1
"2542",812,813,813,"white","age.gp4","NoTr","NoTrade","NoGroup",1,0,0,1,0,0,1,0,1,0,0,1,0,1,1
"2543",2456,2457,2457,"white","age.gp4","NoTr","NoTrade","NoGroup",2,0,0,1,1,0,2,0,0,2,0,2,1,1,1
"2544",814,815,815,"white","age.gp4","NoTr","NoTrade","NoGroup",1,0,0,0,1,1,0,0,0,1,0,1,0,1,1
"2545",2017,2018,2018,"black","age.gp4","NoTr","NoTrade","NoGroup",4,1,0,2,1,3,1,0,1,3,1,3,2,2,1
"2546",815,816,816,"white","age.gp4","NoTr","NoTrade","NoGroup",6,0,2,2,2,1,5,0,5,1,0,6,3,3,1
"2547",817,818,818,"white","age.gp4","NoTr","NoTrade","NoGroup",1,1,0,0,0,0,0,1,0,1,0,1,1,0,1
"2548",1436,1437,1437,"white","age.gp3","Tr","NoTrade","NoGroup",9,1,1,4,3,4,4,1,1,8,1,8,7,2,1
"2549",2512,2513,2513,"white","age.gp1","NoTr","NoTrade","NoGroup",16,9,2,1,4,1,13,2,3,13,3,13,8,8,1
"2550",819,820,820,"white","age.gp4","NoTr","NoTrade","NoGroup",1,0,1,0,0,0,1,0,1,0,0,1,1,0,1
"2551",820,821,821,"white","age.gp4","NoTr","NoTrade","NoGroup",1,0,1,0,0,0,0,1,1,0,0,1,1,0,1
"2552",825,826,826,"white","age.gp3","NoTr","NoTrade","NoGroup",3,0,1,1,1,1,1,1,0,3,1,2,1,2,1
"2553",826,827,827,"white","age.gp3","NoTr","NoTrade","NoGroup",12,0,5,5,2,2,9,1,6,6,1,11,11,1,1
"2554",1991,1992,1992,"white","age.gp4","Tr","NoTrade","NoGroup",3,0,1,1,1,0,3,0,1,2,0,3,2,1,1
"2555",1890,1891,1891,"other","age.gp1","NoTr","NoTrade","Group",11,4,1,3,3,3,8,0,5,6,0,11,4,7,1
"2556",1972,1973,1973,"white","age.gp4","Tr","NoTrade","NoGroup",4,1,0,2,1,1,3,0,0,4,0,4,1,3,1
"2557",1471,1472,1472,"white","age.gp1","NoTr","NoTrade","NoGroup",7,4,1,2,0,0,6,1,2,5,1,6,2,5,1
"2558",2503,2504,2504,"other","age.gp1","NoTr","NoTrade","NoGroup",5,1,2,2,0,0,5,0,2,3,0,5,2,3,1
"2559",1457,1458,1458,"white","age.gp1","NoTr","NoTrade","NoGroup",12,7,1,3,1,1,10,1,2,10,0,12,4,8,1
"2560",2485,2486,2486,"other","age.gp1","NoTr","NoTrade","NoGroup",4,1,0,2,1,2,2,0,1,3,0,4,1,3,1
"2561",835,836,836,"white","age.gp3","NoTr","NoTrade","NoGroup",9,1,5,2,1,1,7,1,5,4,1,8,6,3,1
"2562",1489,1490,1490,"white","age.gp4","NoTr","NoTrade","NoGroup",2,0,0,2,0,0,2,0,0,2,0,2,1,1,1
"2563",961,962,962,"black","age.gp2","NoTr","NoTrade","Group",13,0,10,0,3,8,4,1,5,8,2,11,10,3,1
"2564",1078,1079,1079,"white","age.gp4","NoTr","NoTrade","Group",12,1,8,0,3,1,8,3,7,5,0,12,7,5,1
"2565",1139,1140,1140,"white","age.gp1","NoTr","NoTrade","NoGroup",6,3,1,1,1,1,5,0,1,5,1,5,2,4,1
"2566",2357,2358,2358,"white","age.gp3","Tr","NoTrade","NoGroup",7,0,3,3,1,0,6,1,3,4,1,6,6,1,1
"2567",2531,2532,2532,"other","age.gp1","NoTr","NoTrade","NoGroup",3,1,1,1,0,0,3,0,1,2,0,3,2,1,1
"2568",2801,2802,2802,"white","age.gp2","NoTr","NoTrade","NoGroup",7,1,3,1,2,0,6,1,3,4,0,7,6,1,1
"2569",2927,2928,2928,"white","age.gp4","NoTr","NoTrade","Group",7,0,1,0,6,2,4,1,4,3,0,7,5,2,1
"2570",1443,1444,1444,"white","age.gp3","Tr","NoTrade","NoGroup",7,1,5,0,1,1,3,3,4,3,1,6,4,3,1
"2571",1823,1824,1824,"black","age.gp4","NoTr","NoTrade","NoGroup",4,0,2,1,1,2,1,1,2,2,0,4,2,2,1
"2572",1174,1175,1175,"white","age.gp4","NoTr","NoTrade","NoGroup",8,2,2,2,2,0,5,3,5,3,0,8,4,4,1
"2573",2754,2755,2755,"white","age.gp3","NoTr","NoTrade","NoGroup",3,0,2,1,0,0,2,1,2,1,0,3,3,0,1
"2574",1055,1056,1056,"white","age.gp4","NoTr","NoTrade","Group",6,0,4,0,2,1,2,3,4,2,0,6,3,3,1
"2575",862,863,863,"other","age.gp2","Tr","NoTrade","Group",4,0,3,1,0,0,4,0,2,2,0,4,4,0,1
"2576",993,994,994,"white","age.gp4","NoTr","NoTrade","NoGroup",2,0,1,0,1,0,1,1,1,1,0,2,2,0,1
"2577",872,873,873,"other","age.gp2","Tr","NoTrade","Group",5,0,1,4,0,3,2,0,1,4,0,5,2,3,1
"2578",2678,2679,2679,"black","age.gp3","NoTr","NoTrade","NoGroup",4,0,3,1,0,1,2,1,3,1,0,4,3,1,1
"2579",1459,1460,1460,"white","age.gp1","NoTr","NoTrade","NoGroup",14,4,1,5,4,0,11,3,5,9,1,13,10,4,1
"2580",1977,1978,1978,"white","age.gp4","Tr","NoTrade","NoGroup",1,0,0,1,0,0,1,0,0,1,1,0,1,0,1
"2581",2155,2156,2156,"other","age.gp2","NoTr","NoTrade","NoGroup",5,0,0,3,2,0,5,0,1,4,1,4,4,1,1
"2582",1087,1088,1088,"black","age.gp2","Tr","NoTrade","NoGroup",9,2,3,3,1,2,7,0,3,6,2,7,7,2,1
"2583",1730,1731,1731,"white","age.gp3","Tr","NoTrade","Group",11,0,6,3,2,2,9,0,5,6,1,10,9,2,1
"2584",2495,2496,2496,"other","age.gp1","NoTr","NoTrade","NoGroup",3,1,0,2,0,1,2,0,1,2,1,2,2,1,1
"2585",1151,1152,1152,"white","age.gp4","NoTr","NoTrade","NoGroup",1,0,0,1,0,0,1,0,0,1,1,0,1,0,1
"2586",1879,1880,1880,"other","age.gp1","NoTr","NoTrade","Group",7,2,1,3,1,0,7,0,4,3,2,5,5,2,1
"2587",2453,2454,2454,"white","age.gp4","NoTr","NoTrade","NoGroup",3,0,0,2,1,0,3,0,1,2,1,2,3,0,1
"2588",1314,1315,1315,"white","age.gp1","NoTr","NoTrade","NoGroup",7,3,1,2,1,0,7,0,3,4,1,6,4,3,1
"2589",1659,1660,1660,"other","age.gp2","NoTr","NoTrade","NoGroup",4,1,1,1,1,1,3,0,0,4,1,3,3,1,1
"2590",2499,2500,2500,"other","age.gp1","NoTr","NoTrade","NoGroup",2,1,0,1,0,0,2,0,0,2,1,1,1,1,1
"2591",905,906,906,"other","age.gp1","Tr","NoTrade","NoGroup",4,2,0,2,0,0,4,0,0,4,1,3,3,1,1
"2592",1374,1375,1375,"black","age.gp4","NoTr","NoTrade","Group",3,1,0,1,1,2,1,0,0,3,2,1,2,1,1
"2593",1030,1031,1031,"black","age.gp4","NoTr","NoTrade","NoGroup",1,0,0,1,0,0,1,0,0,1,1,0,1,0,1
"2594",1176,1177,1177,"white","age.gp4","Tr","NoTrade","NoGroup",7,0,2,2,3,0,7,0,2,5,1,6,5,2,1
"2595",2101,2102,2102,"black","age.gp3","NoTr","NoTrade","NoGroup",6,1,0,4,1,2,4,0,2,4,2,4,4,2,1
"2596",2287,2288,2288,"other","age.gp2","Tr","NoTrade","Group",5,0,0,3,2,0,5,0,0,5,1,4,4,1,1
"2597",2307,2308,2308,"white","age.gp2","NoTr","NoTrade","NoGroup",5,1,1,2,1,0,4,1,0,5,1,4,3,2,1
"2598",1007,1008,1008,"white","age.gp1","Tr","NoTrade","Group",22,11,7,3,1,0,18,4,7,15,1,21,10,12,1
"2599",2232,2233,2233,"black","age.gp4","NoTr","Trade","Group",6,2,2,0,2,4,1,1,2,4,0,6,1,5,1
"2600",889,890,890,"other","age.gp1","Tr","NoTrade","NoGroup",3,1,1,1,0,1,2,0,0,3,0,3,2,1,1
"2601",2765,2766,2766,"black","age.gp2","NoTr","NoTrade","NoGroup",6,2,0,1,3,4,1,1,2,4,1,5,2,4,1
"2602",2321,2322,2322,"white","age.gp1","NoTr","NoTrade","NoGroup",11,5,0,6,0,1,8,2,5,6,1,10,4,7,1
"2603",893,894,894,"other","age.gp1","Tr","NoTrade","NoGroup",1,0,0,1,0,0,1,0,1,0,0,1,1,0,1
"2604",1458,1459,1459,"white","age.gp1","NoTr","NoTrade","NoGroup",8,7,1,0,0,1,5,2,5,3,1,7,3,5,1
"2605",2677,2678,2678,"black","age.gp3","NoTr","NoTrade","NoGroup",4,2,1,0,1,2,0,2,1,3,1,3,2,2,1
"2606",2906,2907,2907,"other","age.gp1","NoTr","NoTrade","NoGroup",3,2,0,1,0,1,1,1,1,2,0,3,0,3,1
"2607",899,900,900,"other","age.gp1","Tr","NoTrade","NoGroup",4,2,2,0,0,1,3,0,2,2,0,4,3,1,1
"2608",900,901,901,"other","age.gp1","Tr","NoTrade","NoGroup",1,0,0,1,0,1,0,0,0,1,0,1,0,1,1
"2609",2615,2616,2616,"white","age.gp4","NoTr","NoTrade","NoGroup",1,1,0,0,0,0,0,1,1,0,0,1,0,1,1
"2610",903,904,904,"other","age.gp1","Tr","NoTrade","NoGroup",1,0,0,1,0,0,1,0,0,1,0,1,1,0,1
"2611",2470,2471,2471,"white","age.gp1","NoTr","NoTrade","NoGroup",6,6,0,0,0,0,4,2,2,4,0,6,2,4,1
"2612",907,908,908,"other","age.gp1","Tr","NoTrade","NoGroup",8,5,1,1,1,1,6,1,3,5,1,7,5,3,1
"2613",908,909,909,"other","age.gp1","Tr","NoTrade","NoGroup",5,3,0,1,1,1,4,0,3,2,0,5,1,4,1
"2614",1540,1541,1541,"black","age.gp4","NoTr","NoTrade","NoGroup",4,1,2,1,0,3,0,1,2,2,1,3,2,2,1
"2615",910,911,911,"other","age.gp1","Tr","NoTrade","NoGroup",5,1,1,3,0,0,5,0,2,3,0,5,2,3,1
"2616",1714,1715,1715,"white","age.gp1","Tr","NoTrade","NoGroup",10,5,1,4,0,2,5,3,3,7,1,9,7,3,1
"2617",914,915,915,"other","age.gp1","Tr","NoTrade","NoGroup",3,2,1,0,0,0,3,0,1,2,0,3,1,2,1
"2618",915,916,916,"other","age.gp1","Tr","NoTrade","NoGroup",4,3,0,1,0,0,4,0,0,4,1,3,2,2,1
"2619",2538,2539,2539,"other","age.gp1","NoTr","NoTrade","NoGroup",7,5,0,1,1,2,5,0,1,6,3,4,4,3,1
"2620",2874,2875,2875,"white","age.gp1","NoTr","NoTrade","NoGroup",8,4,3,1,0,0,5,3,3,5,1,7,3,5,1
"2621",1248,1249,1249,"white","age.gp1","NoTr","NoTrade","NoGroup",8,3,1,1,3,0,7,1,4,4,1,7,6,2,1
"2622",2429,2430,2430,"white","age.gp4","NoTr","NoTrade","NoGroup",1,0,0,1,0,0,1,0,0,1,0,1,0,1,1
"2623",928,929,929,"white","age.gp3","NoTr","NoTrade","NoGroup",1,0,1,0,0,0,1,0,1,0,0,1,1,0,1
"2624",1989,1990,1990,"white","age.gp4","Tr","NoTrade","NoGroup",4,0,1,1,2,2,2,0,1,3,1,3,2,2,1
"2625",2397,2398,2398,"white","age.gp3","NoTr","NoTrade","NoGroup",7,2,0,5,0,0,7,0,3,4,2,5,4,3,1
"2626",2828,2829,2829,"other","age.gp2","NoTr","NoTrade","NoGroup",5,0,1,3,1,0,5,0,1,4,0,5,4,1,1
"2627",1909,1910,1910,"other","age.gp2","NoTr","NoTrade","NoGroup",5,1,2,2,0,1,4,0,1,4,0,5,4,1,1
"2628",2202,2203,2203,"white","age.gp4","NoTr","NoTrade","NoGroup",1,0,0,1,0,0,1,0,1,0,0,1,1,0,1
"2629",1416,1417,1417,"black","age.gp2","NoTr","NoTrade","NoGroup",8,1,4,2,1,3,4,1,2,6,0,8,3,5,1
"2630",2270,2271,2271,"white","age.gp4","Tr","NoTrade","Group",7,1,0,2,4,0,7,0,2,5,0,7,5,2,1
"2631",2611,2612,2612,"white","age.gp4","NoTr","NoTrade","NoGroup",1,0,0,1,0,0,1,0,1,0,0,1,1,0,1
"2632",2720,2721,2721,"white","age.gp4","NoTr","NoTrade","Group",11,0,3,3,5,1,10,0,6,5,0,11,9,2,1
"2633",2098,2099,2099,"black","age.gp3","NoTr","NoTrade","NoGroup",2,0,1,1,0,1,1,0,2,0,0,2,1,1,1
"2634",2817,2818,2818,"other","age.gp2","NoTr","NoTrade","NoGroup",4,0,3,1,0,0,4,0,2,2,0,4,4,0,1
"2635",1266,1267,1267,"black","age.gp3","NoTr","NoTrade","NoGroup",8,1,3,3,1,3,5,0,5,3,2,6,6,2,1
"2636",2618,2619,2619,"white","age.gp4","NoTr","NoTrade","NoGroup",1,0,0,1,0,0,1,0,1,0,0,1,1,0,1
"2637",2012,2013,2013,"black","age.gp4","NoTr","NoTrade","NoGroup",1,0,1,0,0,1,0,0,1,0,0,1,0,1,1
"2638",1644,1645,1645,"other","age.gp2","NoTr","NoTrade","NoGroup",2,0,1,1,0,1,1,0,2,0,0,2,1,1,1
"2639",1924,1925,1925,"other","age.gp2","NoTr","NoTrade","NoGroup",4,1,3,0,0,1,3,0,3,1,0,4,2,2,1
"2640",2219,2220,2220,"black","age.gp4","NoTr","Trade","Group",7,0,2,1,4,5,2,0,1,6,1,6,2,5,1
"2641",959,960,960,"black","age.gp2","Tr","NoTrade","NoGroup",1,0,1,0,0,1,0,0,0,1,0,1,1,0,1
"2642",960,961,961,"black","age.gp2","Tr","NoTrade","NoGroup",1,0,0,0,1,1,0,0,0,1,0,1,1,0,1
"2643",1277,1278,1278,"white","age.gp4","NoTr","NoTrade","Group",8,0,6,0,2,1,5,2,4,4,1,7,5,3,1
"2644",1272,1273,1273,"black","age.gp3","NoTr","NoTrade","NoGroup",5,1,3,0,1,4,0,1,0,5,0,5,3,2,1
"2645",2021,2022,2022,"black","age.gp4","NoTr","NoTrade","NoGroup",4,0,1,1,2,4,0,0,0,4,1,3,4,0,1
"2646",2689,2690,2690,"black","age.gp3","NoTr","NoTrade","NoGroup",6,0,3,2,1,4,2,0,1,5,0,6,5,1,1
"2647",1820,1821,1821,"black","age.gp4","NoTr","NoTrade","NoGroup",1,0,1,0,0,1,0,0,0,1,0,1,1,0,1
"2648",2802,2803,2803,"other","age.gp2","NoTr","NoTrade","NoGroup",7,1,2,3,1,2,5,0,2,5,1,6,6,1,1
"2649",1092,1093,1093,"black","age.gp1","NoTr","NoTrade","NoGroup",8,3,1,2,2,4,4,0,0,8,0,8,4,4,1
"2650",2508,2509,2509,"black","age.gp2","NoTr","NoTrade","NoGroup",12,2,5,3,2,7,5,0,5,7,3,9,7,5,1
"2651",1208,1209,1209,"white","age.gp4","NoTr","NoTrade","NoGroup",5,1,2,0,2,0,5,0,2,3,0,5,2,3,1
"2652",2799,2800,2800,"white","age.gp2","NoTr","NoTrade","NoGroup",5,1,2,1,1,0,4,1,4,1,0,5,4,1,1
"2653",2928,2929,2929,"white","age.gp4","NoTr","NoTrade","Group",10,0,1,2,7,0,10,0,5,5,2,8,8,2,1
"2654",998,999,999,"white","age.gp4","NoTr","NoTrade","NoGroup",1,0,1,0,0,0,1,0,1,0,0,1,1,0,1
"2655",971,972,972,"white","age.gp4","NoTr","NoTrade","NoGroup",1,0,0,0,1,0,1,0,1,0,0,1,1,0,1
"2656",972,973,973,"white","age.gp4","NoTr","NoTrade","NoGroup",1,0,0,0,1,1,0,0,0,1,0,1,0,1,1
"2657",976,977,977,"white","age.gp4","NoTr","NoTrade","NoGroup",6,0,1,1,4,0,6,0,3,3,0,6,4,2,1
"2658",1230,1231,1231,"white","age.gp4","NoTr","NoTrade","NoGroup",1,0,0,0,1,0,1,0,0,1,0,1,0,1,1
"2659",2355,2356,2356,"white","age.gp3","Tr","NoTrade","NoGroup",3,1,0,1,1,0,2,1,0,3,0,3,1,2,1
"2660",977,978,978,"white","age.gp4","NoTr","NoTrade","NoGroup",2,0,0,0,2,0,2,0,0,2,0,2,0,2,1
"2661",1497,1498,1498,"white","age.gp4","NoTr","NoTrade","NoGroup",4,1,1,1,1,0,4,0,2,2,0,4,3,1,1
"2662",1505,1506,1506,"white","age.gp4","NoTr","NoTrade","NoGroup",3,0,1,0,2,0,3,0,1,2,0,3,0,3,1
"2663",978,979,979,"white","age.gp4","NoTr","NoTrade","NoGroup",1,0,0,1,0,0,1,0,1,0,0,1,1,0,1
"2664",2295,2296,2296,"other","age.gp2","Tr","NoTrade","Group",8,1,0,5,2,0,8,0,1,7,0,8,5,3,1
"2665",983,984,984,"white","age.gp4","NoTr","NoTrade","NoGroup",1,0,0,0,1,0,1,0,0,1,0,1,1,0,1
"2666",1771,1772,1772,"black","age.gp4","NoTr","NoTrade","NoGroup",1,0,0,0,1,0,1,0,0,1,0,1,0,1,1
"2667",2194,2195,2195,"white","age.gp4","NoTr","NoTrade","NoGroup",1,0,0,0,1,0,1,0,0,1,0,1,0,1,1
"2668",986,987,987,"white","age.gp4","NoTr","NoTrade","NoGroup",2,0,0,1,1,0,2,0,1,1,0,2,2,0,1
"2669",987,988,988,"white","age.gp4","NoTr","NoTrade","NoGroup",1,0,1,0,0,0,1,0,1,0,0,1,1,0,1
"2670",991,992,992,"white","age.gp4","NoTr","NoTrade","NoGroup",5,1,0,2,2,0,5,0,2,3,0,5,3,2,1
"2671",992,993,993,"white","age.gp4","NoTr","NoTrade","NoGroup",1,0,0,0,1,0,1,0,1,0,0,1,1,0,1
"2672",999,1000,1000,"white","age.gp4","NoTr","NoTrade","NoGroup",1,0,0,0,1,0,1,0,1,0,0,1,1,0,1
"2673",1000,1001,1001,"white","age.gp4","NoTr","NoTrade","NoGroup",3,1,0,0,2,0,3,0,3,0,0,3,2,1,1
"2674",1569,1570,1570,"white","age.gp4","Tr","NoTrade","Group",10,0,3,1,6,3,7,0,3,7,2,8,8,2,1
"2675",1002,1003,1003,"white","age.gp4","NoTr","NoTrade","NoGroup",1,0,0,0,1,0,1,0,1,0,0,1,1,0,1
"2676",1869,1870,1870,"other","age.gp1","NoTr","NoTrade","Group",7,2,2,1,2,0,7,0,3,4,0,7,5,2,1
"2677",1380,1381,1381,"white","age.gp1","NoTr","NoTrade","NoGroup",14,8,2,2,2,1,12,1,6,8,0,14,7,7,1
"2678",1492,1493,1493,"white","age.gp4","NoTr","NoTrade","NoGroup",1,1,0,0,0,0,1,0,1,0,0,1,1,0,1
"2679",2898,2899,2899,"other","age.gp1","NoTr","NoTrade","NoGroup",5,3,1,0,1,0,5,0,3,2,0,5,2,3,1
"2680",1166,1167,1167,"white","age.gp4","NoTr","NoTrade","NoGroup",4,1,1,0,2,0,4,0,3,1,0,4,3,1,1
"2681",1170,1171,1171,"white","age.gp4","NoTr","NoTrade","NoGroup",1,1,0,0,0,0,1,0,1,0,0,1,1,0,1
"2682",2537,2538,2538,"other","age.gp1","NoTr","NoTrade","NoGroup",4,3,1,0,0,0,4,0,2,2,0,4,4,0,1
"2683",2890,2891,2891,"other","age.gp1","NoTr","NoTrade","NoGroup",4,2,0,0,2,0,4,0,2,2,0,4,3,1,1
"2684",1901,1902,1902,"black","age.gp1","NoTr","NoTrade","NoGroup",6,2,2,2,0,5,1,0,2,4,0,6,2,4,1
"2685",2008,2009,2009,"black","age.gp4","NoTr","NoTrade","NoGroup",7,2,1,1,3,4,3,0,3,4,1,6,2,5,1
"2686",2492,2493,2493,"other","age.gp1","NoTr","NoTrade","NoGroup",5,5,0,0,0,0,5,0,1,4,0,5,2,3,1
"2687",1118,1119,1119,"other","age.gp1","NoTr","NoTrade","NoGroup",3,2,1,0,0,0,3,0,1,2,0,3,0,3,1
"2688",2496,2497,2497,"other","age.gp1","NoTr","NoTrade","NoGroup",2,1,0,1,0,0,2,0,1,1,1,1,1,1,1
"2689",2510,2511,2511,"white","age.gp1","NoTr","NoTrade","NoGroup",8,6,1,0,1,2,6,0,3,5,1,7,3,5,1
"2690",1127,1128,1128,"other","age.gp1","NoTr","NoTrade","NoGroup",2,1,1,0,0,0,2,0,0,2,0,2,1,1,1
"2691",2315,2316,2316,"white","age.gp2","NoTr","NoTrade","NoGroup",6,2,2,2,0,2,4,0,2,4,1,5,3,3,1
"2692",2543,2544,2544,"other","age.gp1","NoTr","NoTrade","NoGroup",2,0,2,0,0,0,2,0,1,1,1,1,1,1,1
"2693",2680,2681,2681,"black","age.gp3","NoTr","NoTrade","NoGroup",3,1,1,0,1,1,2,0,1,2,0,3,1,2,1
"2694",1027,1028,1028,"black","age.gp4","NoTr","NoTrade","NoGroup",3,0,2,0,1,0,1,2,0,3,0,3,1,2,1
"2695",1029,1030,1030,"black","age.gp4","NoTr","NoTrade","NoGroup",1,0,1,0,0,1,0,0,0,1,0,1,1,0,1
"2696",1034,1035,1035,"black","age.gp4","NoTr","NoTrade","NoGroup",1,0,0,0,1,0,1,0,0,1,0,1,1,0,1
"2697",1035,1036,1036,"black","age.gp4","NoTr","NoTrade","NoGroup",3,0,0,0,3,3,0,0,0,3,2,1,3,0,1
"2698",1036,1037,1037,"black","age.gp4","NoTr","NoTrade","NoGroup",5,1,1,3,0,1,4,0,1,4,0,5,2,3,1
"2699",1827,1828,1828,"black","age.gp4","NoTr","NoTrade","NoGroup",1,0,0,0,1,1,0,0,0,1,0,1,0,1,1
"2700",1039,1040,1040,"black","age.gp4","NoTr","NoTrade","NoGroup",1,0,0,1,0,1,0,0,0,1,0,1,1,0,1
"2701",2952,2953,2953,"white","age.gp4","NoTr","NoTrade","Group",8,0,1,2,5,1,7,0,2,6,0,8,5,3,1
"2702",2036,2037,2037,"white","age.gp4","Tr","NoTrade","Group",10,0,1,2,7,2,8,0,2,8,1,9,3,7,1
"2703",2083,2084,2084,"black","age.gp3","NoTr","NoTrade","NoGroup",3,0,1,0,2,1,2,0,1,2,0,3,2,1,1
"2704",1046,1047,1047,"black","age.gp4","NoTr","NoTrade","NoGroup",1,0,0,0,1,1,0,0,0,1,0,1,1,0,1
"2705",1973,1974,1974,"white","age.gp4","Tr","NoTrade","NoGroup",6,0,2,1,3,2,4,0,5,1,1,5,4,2,1
"2706",1049,1050,1050,"black","age.gp4","NoTr","NoTrade","NoGroup",1,0,0,0,1,1,0,0,0,1,0,1,1,0,1
"2707",1831,1832,1832,"black","age.gp4","NoTr","NoTrade","NoGroup",1,0,0,0,1,1,0,0,0,1,0,1,0,1,1
"2708",1228,1229,1229,"white","age.gp4","NoTr","NoTrade","NoGroup",5,0,3,0,2,1,3,1,2,3,0,5,2,3,1
"2709",1221,1222,1222,"white","age.gp4","NoTr","NoTrade","NoGroup",1,0,0,0,1,0,1,0,0,1,0,1,1,0,1
"2710",2530,2531,2531,"other","age.gp1","NoTr","NoTrade","NoGroup",4,0,1,0,3,0,4,0,2,2,0,4,4,0,1
"2711",1671,1672,1672,"white","age.gp2","Tr","NoTrade","NoGroup",11,0,8,1,2,1,10,0,4,7,0,11,10,1,1
"2712",1538,1539,1539,"black","age.gp4","NoTr","NoTrade","NoGroup",3,0,1,1,1,1,2,0,0,3,0,3,3,0,1
"2713",2031,2032,2032,"white","age.gp4","Tr","NoTrade","Group",7,1,1,2,3,0,7,0,2,5,1,6,4,3,1
"2714",1437,1438,1438,"white","age.gp3","Tr","NoTrade","NoGroup",3,0,0,1,2,0,3,0,1,2,1,2,2,1,1
"2715",1157,1158,1158,"white","age.gp4","NoTr","NoTrade","NoGroup",1,0,0,0,1,0,1,0,0,1,0,1,1,0,1
"2716",2378,2379,2379,"white","age.gp2","NoTr","NoTrade","NoGroup",9,0,3,1,5,0,9,0,3,6,0,9,5,4,1
"2717",2698,2699,2699,"white","age.gp4","NoTr","NoTrade","Group",5,1,1,0,3,0,4,1,2,3,0,5,4,1,1
"2718",1065,1066,1066,"white","age.gp4","NoTr","NoTrade","Group",6,0,2,1,3,0,6,0,3,3,0,6,5,1,1
"2719",2182,2183,2183,"white","age.gp4","NoTr","NoTrade","NoGroup",3,0,0,0,3,0,3,0,1,2,0,3,3,0,1
"2720",2807,2808,2808,"other","age.gp2","NoTr","NoTrade","NoGroup",3,0,1,1,1,1,2,0,1,2,0,3,2,1,1
"2721",1330,1331,1331,"white","age.gp3","NoTr","NoTrade","NoGroup",9,1,3,3,2,1,6,2,3,6,1,8,7,2,1
"2722",1661,1662,1662,"other","age.gp2","NoTr","NoTrade","NoGroup",5,0,4,0,1,0,4,1,2,3,0,5,4,1,1
"2723",1751,1752,1752,"black","age.gp4","NoTr","NoTrade","NoGroup",1,0,0,0,1,0,1,0,0,1,0,1,1,0,1
"2724",1770,1771,1771,"black","age.gp4","NoTr","NoTrade","NoGroup",1,0,0,0,1,0,1,0,0,1,0,1,1,0,1
"2725",1493,1494,1494,"white","age.gp4","NoTr","NoTrade","NoGroup",1,0,0,0,1,0,1,0,0,1,0,1,1,0,1
"2726",1641,1642,1642,"other","age.gp2","NoTr","NoTrade","NoGroup",3,0,1,0,2,0,3,0,1,2,0,3,1,2,1
"2727",1693,1694,1694,"white","age.gp4","NoTr","Trade","NoGroup",1,0,0,0,1,0,1,0,0,1,0,1,1,0,1
"2728",2640,2641,2641,"white","age.gp4","NoTr","NoTrade","NoGroup",1,0,0,0,1,0,1,0,0,1,0,1,1,0,1
"2729",1524,1525,1525,"black","age.gp4","NoTr","NoTrade","NoGroup",2,0,0,0,2,0,2,0,1,1,0,2,2,0,1
"2730",1957,1958,1958,"white","age.gp4","NoTr","NoTrade","Group",7,1,1,2,3,1,6,0,3,4,2,5,4,3,1
"2731",2617,2618,2618,"white","age.gp4","NoTr","NoTrade","NoGroup",1,0,0,0,1,0,1,0,0,1,0,1,1,0,1
"2732",2684,2685,2685,"black","age.gp3","NoTr","NoTrade","NoGroup",5,0,2,1,2,3,2,0,1,4,1,4,3,2,1
"2733",1130,1131,1131,"other","age.gp1","NoTr","NoTrade","NoGroup",3,2,0,0,1,1,2,0,2,1,0,3,1,2,1
"2734",2082,2083,2083,"black","age.gp3","NoTr","NoTrade","NoGroup",3,2,0,1,0,2,0,1,0,3,0,3,0,3,1
"2735",1094,1095,1095,"black","age.gp1","NoTr","NoTrade","NoGroup",1,1,0,0,0,1,0,0,0,1,0,1,0,1,1
"2736",1198,1199,1199,"white","age.gp4","Tr","NoTrade","NoGroup",5,0,2,2,1,1,4,0,0,5,0,5,4,1,1
"2737",1100,1101,1101,"black","age.gp2","NoTr","NoTrade","NoGroup",7,0,3,3,1,2,4,1,3,4,2,5,4,3,1
"2738",1107,1108,1108,"other","age.gp1","NoTr","NoTrade","NoGroup",1,0,1,0,0,1,0,0,0,1,0,1,1,0,1
"2739",1109,1110,1110,"other","age.gp1","NoTr","NoTrade","NoGroup",3,2,0,1,0,0,3,0,1,2,0,3,1,2,1
"2740",1112,1113,1113,"other","age.gp1","NoTr","NoTrade","NoGroup",2,0,1,1,0,0,2,0,1,1,1,1,2,0,1
"2741",1113,1114,1114,"other","age.gp1","NoTr","NoTrade","NoGroup",2,2,0,0,0,0,1,1,0,2,0,2,1,1,1
"2742",1115,1116,1116,"other","age.gp1","NoTr","NoTrade","NoGroup",5,1,1,1,2,0,5,0,0,5,0,5,4,1,1
"2743",1116,1117,1117,"other","age.gp1","NoTr","NoTrade","NoGroup",3,1,1,0,1,2,1,0,0,3,1,2,2,1,1
"2744",1593,1594,1594,"black","age.gp1","Tr","Trade","NoGroup",3,1,2,0,0,0,1,2,0,3,0,3,1,2,1
"2745",1121,1122,1122,"other","age.gp1","NoTr","NoTrade","NoGroup",2,0,1,0,1,0,2,0,2,0,0,2,2,0,1
"2746",1124,1125,1125,"other","age.gp1","NoTr","NoTrade","NoGroup",4,4,0,0,0,1,3,0,1,3,0,4,0,4,1
"2747",1313,1314,1314,"white","age.gp1","NoTr","NoTrade","NoGroup",8,3,1,2,2,0,6,2,2,6,0,8,4,4,1
"2748",1125,1126,1126,"other","age.gp1","NoTr","NoTrade","NoGroup",1,0,0,0,1,0,1,0,0,1,0,1,1,0,1
"2749",1217,1218,1218,"white","age.gp4","NoTr","NoTrade","NoGroup",3,1,1,0,1,0,2,1,2,1,0,3,2,1,1
"2750",1128,1129,1129,"other","age.gp1","NoTr","NoTrade","NoGroup",1,1,0,0,0,0,1,0,1,0,0,1,0,1,1
"2751",1129,1130,1130,"other","age.gp1","NoTr","NoTrade","NoGroup",2,0,1,1,0,0,2,0,2,0,0,2,2,0,1
"2752",1164,1165,1165,"white","age.gp4","NoTr","NoTrade","NoGroup",6,0,3,0,3,0,5,1,2,4,0,6,4,2,1
"2753",2154,2155,2155,"other","age.gp2","NoTr","NoTrade","NoGroup",3,0,2,0,1,2,1,0,1,2,0,3,2,1,1
"2754",1649,1650,1650,"other","age.gp2","NoTr","NoTrade","NoGroup",3,0,1,1,1,1,2,0,2,1,0,3,2,1,1
"2755",2905,2906,2906,"other","age.gp1","NoTr","NoTrade","NoGroup",4,1,1,2,0,1,3,0,4,0,1,3,4,0,1
"2756",1979,1980,1980,"white","age.gp4","Tr","NoTrade","NoGroup",7,1,3,0,3,1,6,0,3,4,1,6,6,1,1
"2757",2149,2150,2150,"other","age.gp2","NoTr","NoTrade","NoGroup",7,1,4,0,2,0,7,0,3,4,1,6,6,1,1
"2758",1446,1447,1447,"white","age.gp1","NoTr","NoTrade","NoGroup",10,5,2,3,0,2,6,2,2,8,0,10,5,5,1
"2759",1637,1638,1638,"black","age.gp1","Tr","NoTrade","NoGroup",6,4,1,0,1,2,4,0,1,5,1,5,2,4,1
"2760",1143,1144,1144,"white","age.gp4","NoTr","NoTrade","NoGroup",4,0,0,1,3,1,3,0,1,3,1,3,4,0,1
"2761",1144,1145,1145,"white","age.gp4","NoTr","NoTrade","NoGroup",1,0,1,0,0,0,1,0,1,0,0,1,1,0,1
"2762",1147,1148,1148,"white","age.gp4","NoTr","NoTrade","NoGroup",5,0,1,0,4,1,4,0,2,3,0,5,3,2,1
"2763",1491,1492,1492,"white","age.gp4","NoTr","NoTrade","NoGroup",2,0,0,0,2,0,2,0,0,2,0,2,1,1,1
"2764",2882,2883,2883,"white","age.gp2","NoTr","NoTrade","NoGroup",8,0,1,4,3,0,8,0,2,6,0,8,6,2,1
"2765",1150,1151,1151,"white","age.gp4","NoTr","NoTrade","NoGroup",1,0,0,0,1,0,1,0,0,1,0,1,1,0,1
"2766",1152,1153,1153,"white","age.gp4","NoTr","NoTrade","NoGroup",1,0,0,0,1,0,1,0,1,0,0,1,1,0,1
"2767",1153,1154,1154,"white","age.gp4","NoTr","NoTrade","NoGroup",2,1,1,0,0,0,1,1,1,1,0,2,0,2,1
"2768",1158,1159,1159,"white","age.gp4","NoTr","NoTrade","NoGroup",3,0,1,1,1,0,3,0,1,2,0,3,2,1,1
"2769",1159,1160,1160,"white","age.gp4","NoTr","NoTrade","NoGroup",1,0,0,0,1,0,1,0,1,0,0,1,1,0,1
"2770",1161,1162,1162,"white","age.gp4","NoTr","NoTrade","NoGroup",1,0,0,0,1,0,1,0,0,1,0,1,0,1,1
"2771",1163,1164,1164,"white","age.gp4","NoTr","NoTrade","NoGroup",1,0,0,1,0,1,0,0,0,1,0,1,0,1,1
"2772",1215,1216,1216,"white","age.gp4","NoTr","NoTrade","NoGroup",1,0,0,0,1,0,1,0,0,1,0,1,0,1,1
"2773",1167,1168,1168,"white","age.gp4","NoTr","NoTrade","NoGroup",2,1,1,0,0,0,2,0,1,1,0,2,1,1,1
"2774",1171,1172,1172,"white","age.gp4","NoTr","NoTrade","NoGroup",1,0,0,0,1,0,1,0,0,1,0,1,1,0,1
"2775",1178,1179,1179,"white","age.gp4","Tr","NoTrade","NoGroup",1,0,0,0,1,0,1,0,0,1,0,1,1,0,1
"2776",1183,1184,1184,"white","age.gp4","Tr","NoTrade","NoGroup",1,0,1,0,0,0,1,0,0,1,0,1,1,0,1
"2777",1184,1185,1185,"white","age.gp4","Tr","NoTrade","NoGroup",1,0,1,0,0,0,1,0,0,1,1,0,1,0,1
"2778",1220,1221,1221,"white","age.gp4","NoTr","NoTrade","NoGroup",1,0,0,0,1,0,1,0,1,0,0,1,0,1,1
"2779",1810,1811,1811,"black","age.gp4","NoTr","NoTrade","NoGroup",1,0,0,0,1,0,1,0,1,0,0,1,0,1,1
"2780",1189,1190,1190,"white","age.gp4","Tr","NoTrade","NoGroup",1,0,0,0,1,0,1,0,0,1,0,1,1,0,1
"2781",1190,1191,1191,"white","age.gp4","Tr","NoTrade","NoGroup",1,0,0,0,1,0,1,0,1,0,0,1,1,0,1
"2782",1192,1193,1193,"white","age.gp4","Tr","NoTrade","NoGroup",1,0,0,0,1,0,1,0,1,0,0,1,1,0,1
"2783",1764,1765,1765,"black","age.gp4","NoTr","NoTrade","NoGroup",3,0,0,0,3,2,1,0,1,2,1,2,1,2,1
"2784",1197,1198,1198,"white","age.gp4","Tr","NoTrade","NoGroup",1,0,0,0,1,0,1,0,0,1,0,1,1,0,1
"2785",1974,1975,1975,"white","age.gp4","Tr","NoTrade","NoGroup",1,0,0,0,1,0,1,0,1,0,0,1,0,1,1
"2786",1202,1203,1203,"white","age.gp4","Tr","NoTrade","NoGroup",1,0,1,0,0,0,1,0,0,1,0,1,1,0,1
"2787",2205,2206,2206,"white","age.gp4","NoTr","NoTrade","NoGroup",5,0,1,1,3,0,4,1,2,3,0,5,3,2,1
"2788",2448,2449,2449,"white","age.gp4","NoTr","NoTrade","NoGroup",3,1,1,0,1,0,3,0,1,2,0,3,1,2,1
"2789",1214,1215,1215,"white","age.gp4","NoTr","NoTrade","NoGroup",1,0,1,0,0,0,1,0,0,1,0,1,1,0,1
"2790",1588,1589,1589,"white","age.gp4","Tr","NoTrade","Group",13,1,5,1,6,2,10,1,4,9,0,13,8,5,1
"2791",1222,1223,1223,"white","age.gp4","NoTr","NoTrade","NoGroup",1,0,1,0,0,0,1,0,0,1,0,1,0,1,1
"2792",1224,1225,1225,"white","age.gp4","NoTr","NoTrade","NoGroup",1,0,0,0,1,0,1,0,0,1,0,1,1,0,1
"2793",1945,1946,1946,"white","age.gp4","NoTr","NoTrade","Group",12,1,1,2,8,0,12,0,6,6,0,12,8,4,1
"2794",1235,1236,1236,"white","age.gp4","NoTr","NoTrade","NoGroup",1,0,0,0,1,0,1,0,0,1,0,1,0,1,1
"2795",2536,2537,2537,"other","age.gp1","NoTr","NoTrade","NoGroup",6,4,1,1,0,0,6,0,3,3,0,6,2,4,1
"2796",1759,1760,1760,"black","age.gp4","NoTr","NoTrade","NoGroup",5,2,2,0,1,0,4,1,2,3,0,5,2,3,1
"2797",2097,2098,2098,"black","age.gp3","NoTr","NoTrade","NoGroup",5,0,2,2,1,4,1,0,1,4,1,4,2,3,1
"2798",1891,1892,1892,"other","age.gp1","NoTr","NoTrade","Group",5,3,1,1,0,0,5,0,2,3,0,5,1,4,1
"2799",1900,1901,1901,"white","age.gp1","Tr","NoTrade","NoGroup",11,2,3,4,2,2,8,1,2,9,1,10,8,3,1
"2800",1921,1922,1922,"other","age.gp2","NoTr","NoTrade","NoGroup",6,0,2,1,3,0,6,0,3,3,0,6,4,2,1
"2801",2137,2138,2138,"other","age.gp2","NoTr","NoTrade","NoGroup",5,1,3,1,0,1,4,0,3,2,1,4,4,1,1
"2802",1716,1717,1717,"white","age.gp1","Tr","NoTrade","NoGroup",8,3,0,3,2,0,8,0,2,6,1,7,6,2,1
"2803",1522,1523,1523,"black","age.gp4","NoTr","NoTrade","NoGroup",1,0,0,1,0,1,0,0,0,1,0,1,0,1,1
"2804",1263,1264,1264,"black","age.gp3","NoTr","NoTrade","NoGroup",1,0,0,0,1,1,0,0,0,1,0,1,1,0,1
"2805",2095,2096,2096,"black","age.gp3","NoTr","NoTrade","NoGroup",6,2,2,0,2,2,4,0,0,6,0,6,4,2,1
"2806",1449,1450,1450,"black","age.gp1","NoTr","NoTrade","NoGroup",6,1,1,2,2,1,5,0,1,5,1,5,5,1,1
"2807",2818,2819,2819,"other","age.gp2","NoTr","NoTrade","NoGroup",6,0,3,0,3,0,6,0,1,5,0,6,5,1,1
"2808",2766,2767,2767,"black","age.gp2","NoTr","NoTrade","NoGroup",5,0,3,1,1,0,4,1,2,3,0,5,3,2,1
"2809",2912,2913,2913,"other","age.gp1","NoTr","NoTrade","NoGroup",5,3,1,1,0,1,4,0,2,3,1,4,2,3,1
"2810",2425,2426,2426,"white","age.gp4","NoTr","NoTrade","NoGroup",1,0,1,0,0,0,1,0,0,1,0,1,0,1,1
"2811",2554,2555,2555,"other","age.gp1","NoTr","NoTrade","NoGroup",5,2,2,0,1,0,5,0,1,4,0,5,2,3,1
"2812",2644,2645,2645,"white","age.gp1","NoTr","NoTrade","NoGroup",4,2,2,0,0,1,2,1,1,3,0,4,2,2,1
"2813",1907,1908,1908,"other","age.gp2","NoTr","NoTrade","NoGroup",8,0,5,1,2,1,7,0,5,3,0,8,5,3,1
"2814",1529,1530,1530,"black","age.gp4","NoTr","NoTrade","NoGroup",5,0,1,0,4,0,5,0,5,0,0,5,5,0,1
"2815",1332,1333,1333,"white","age.gp3","NoTr","NoTrade","NoGroup",3,0,2,0,1,0,3,0,1,2,0,3,2,1,1
"2816",1333,1334,1334,"white","age.gp3","NoTr","NoTrade","NoGroup",1,0,0,0,1,1,0,0,0,1,0,1,0,1,1
"2817",1370,1371,1371,"black","age.gp4","NoTr","NoTrade","Group",6,0,1,0,5,6,0,0,0,6,1,5,3,3,1
"2818",1527,1528,1528,"black","age.gp4","NoTr","NoTrade","NoGroup",2,0,1,0,1,1,1,0,1,1,0,2,2,0,1
"2819",1753,1754,1754,"black","age.gp4","NoTr","NoTrade","NoGroup",4,1,0,0,3,2,2,0,1,3,0,4,3,1,1
"2820",1534,1535,1535,"black","age.gp4","NoTr","NoTrade","NoGroup",3,0,0,1,2,2,1,0,1,2,0,3,2,1,1
"2821",1351,1352,1352,"black","age.gp4","NoTr","NoTrade","Group",4,1,0,0,3,1,3,0,1,3,1,3,4,0,1
"2822",1513,1514,1514,"black","age.gp4","NoTr","NoTrade","NoGroup",5,1,0,1,3,3,1,1,1,4,0,5,4,1,1
"2823",1748,1749,1749,"black","age.gp4","NoTr","NoTrade","NoGroup",4,0,0,1,3,4,0,0,0,4,0,4,1,3,1
"2824",2734,2735,2735,"black","age.gp3","NoTr","NoTrade","NoGroup",6,0,3,2,1,5,1,0,1,5,1,5,3,3,1
"2825",1366,1367,1367,"black","age.gp4","NoTr","NoTrade","Group",13,2,0,2,9,6,6,1,3,10,2,11,8,5,1
"2826",1516,1517,1517,"black","age.gp4","NoTr","NoTrade","NoGroup",3,1,0,0,2,3,0,0,0,3,0,3,1,2,1
"2827",1995,1996,1996,"white","age.gp4","Tr","NoTrade","NoGroup",5,0,1,1,3,2,3,0,2,3,0,5,3,2,1
"2828",2225,2226,2226,"black","age.gp4","NoTr","Trade","Group",5,0,0,1,4,4,1,0,0,5,1,4,4,1,1
"2829",2020,2021,2021,"black","age.gp4","NoTr","NoTrade","NoGroup",1,0,0,0,1,1,0,0,0,1,0,1,1,0,1
"2830",2135,2136,2136,"other","age.gp2","NoTr","NoTrade","NoGroup",4,0,1,1,2,1,3,0,0,4,0,4,3,1,1
"2831",1387,1388,1388,"black","age.gp3","NoTr","NoTrade","NoGroup",3,0,2,1,0,2,1,0,0,3,0,3,2,1,1
"2832",1398,1399,1399,"black","age.gp3","NoTr","NoTrade","NoGroup",1,0,0,1,0,1,0,0,0,1,0,1,0,1,1
"2833",2736,2737,2737,"black","age.gp3","NoTr","NoTrade","NoGroup",5,0,1,3,1,3,2,0,2,3,0,5,2,3,1
"2834",1676,1677,1677,"white","age.gp4","NoTr","Trade","NoGroup",2,0,0,1,1,0,2,0,1,1,0,2,2,0,1
"2835",1652,1653,1653,"other","age.gp2","NoTr","NoTrade","NoGroup",3,0,0,2,1,0,3,0,0,3,0,3,2,1,1
"2836",2199,2200,2200,"white","age.gp4","NoTr","NoTrade","NoGroup",1,0,0,1,0,0,1,0,0,1,0,1,1,0,1
"2837",2664,2665,2665,"white","age.gp3","NoTr","NoTrade","NoGroup",1,0,0,1,0,0,1,0,0,1,0,1,1,0,1
"2838",1495,1496,1496,"white","age.gp4","NoTr","NoTrade","NoGroup",1,0,0,1,0,0,1,0,0,1,0,1,1,0,1
"2839",1612,1613,1613,"white","age.gp3","Tr","NoTrade","NoGroup",6,1,2,3,0,1,4,1,2,4,0,6,4,2,1
"2840",1912,1913,1913,"other","age.gp2","NoTr","NoTrade","NoGroup",2,0,0,1,1,0,2,0,0,2,0,2,1,1,1
"2841",2823,2824,2824,"other","age.gp2","NoTr","NoTrade","NoGroup",4,1,2,1,0,1,3,0,2,2,1,3,4,0,1
"2842",2813,2814,2814,"other","age.gp2","NoTr","NoTrade","NoGroup",3,0,1,2,0,0,3,0,1,2,0,3,2,1,1
"2843",2507,2508,2508,"black","age.gp2","NoTr","NoTrade","NoGroup",7,2,3,1,1,4,2,1,3,4,0,7,5,2,1
"2844",2549,2550,2550,"other","age.gp1","NoTr","NoTrade","NoGroup",4,2,2,0,0,0,4,0,2,2,0,4,3,1,1
"2845",2798,2799,2799,"white","age.gp2","NoTr","NoTrade","NoGroup",9,0,6,3,0,0,7,2,5,4,0,9,5,4,1
"2846",1440,1441,1441,"white","age.gp3","Tr","NoTrade","NoGroup",5,1,2,1,1,1,4,0,1,4,0,5,3,2,1
"2847",2197,2198,2198,"white","age.gp4","NoTr","NoTrade","NoGroup",1,0,0,1,0,0,1,0,1,0,0,1,0,1,1
"2848",1683,1684,1684,"white","age.gp4","NoTr","Trade","NoGroup",3,0,1,2,0,0,3,0,1,2,0,3,1,2,1
"2849",1851,1852,1852,"black","age.gp3","NoTr","NoTrade","NoGroup",5,3,1,1,0,2,3,0,1,4,0,5,2,3,1
"2850",2551,2552,2552,"other","age.gp1","NoTr","NoTrade","NoGroup",5,2,1,1,1,1,4,0,2,3,1,4,3,2,1
"2851",2610,2611,2611,"white","age.gp4","NoTr","NoTrade","NoGroup",7,0,2,1,4,0,7,0,3,4,1,6,6,1,1
"2852",2545,2546,2546,"other","age.gp1","NoTr","NoTrade","NoGroup",3,2,0,1,0,0,3,0,1,2,0,3,1,2,1
"2853",1480,1481,1481,"white","age.gp4","NoTr","NoTrade","NoGroup",1,0,0,0,1,0,1,0,0,1,0,1,1,0,1
"2854",1488,1489,1489,"white","age.gp4","NoTr","NoTrade","NoGroup",1,0,0,0,1,0,1,0,0,1,0,1,0,1,1
"2855",2715,2716,2716,"white","age.gp4","NoTr","NoTrade","Group",6,0,2,0,4,0,6,0,3,3,0,6,5,1,1
"2856",1494,1495,1495,"white","age.gp4","NoTr","NoTrade","NoGroup",1,0,0,0,1,0,1,0,1,0,0,1,1,0,1
"2857",1496,1497,1497,"white","age.gp4","NoTr","NoTrade","NoGroup",3,0,1,0,2,0,3,0,3,0,0,3,2,1,1
"2858",1500,1501,1501,"white","age.gp4","NoTr","NoTrade","NoGroup",1,0,1,0,0,0,1,0,1,0,0,1,1,0,1
"2859",1503,1504,1504,"white","age.gp4","NoTr","NoTrade","NoGroup",1,0,1,0,0,0,1,0,1,0,0,1,1,0,1
"2860",1504,1505,1505,"white","age.gp4","NoTr","NoTrade","NoGroup",1,0,0,0,1,0,1,0,0,1,0,1,1,0,1
"2861",1509,1510,1510,"white","age.gp4","NoTr","NoTrade","NoGroup",1,1,0,0,0,0,0,1,0,1,0,1,0,1,1
"2862",2487,2488,2488,"other","age.gp1","NoTr","NoTrade","NoGroup",3,0,0,2,1,0,3,0,1,2,0,3,1,2,1
"2863",1512,1513,1513,"black","age.gp4","NoTr","NoTrade","NoGroup",4,0,1,0,3,2,2,0,1,3,2,2,4,0,1
"2864",1514,1515,1515,"black","age.gp4","NoTr","NoTrade","NoGroup",1,0,0,0,1,0,1,0,1,0,0,1,1,0,1
"2865",1756,1757,1757,"black","age.gp4","NoTr","NoTrade","NoGroup",1,0,0,0,1,1,0,0,0,1,0,1,0,1,1
"2866",1519,1520,1520,"black","age.gp4","NoTr","NoTrade","NoGroup",1,0,0,1,0,1,0,0,0,1,0,1,1,0,1
"2867",1526,1527,1527,"black","age.gp4","NoTr","NoTrade","NoGroup",1,0,1,0,0,1,0,0,0,1,1,0,1,0,1
"2868",1531,1532,1532,"black","age.gp4","NoTr","NoTrade","NoGroup",1,0,0,1,0,1,0,0,0,1,0,1,0,1,1
"2869",1980,1981,1981,"white","age.gp4","Tr","NoTrade","NoGroup",1,0,0,1,0,0,1,0,0,1,0,1,1,0,1
"2870",2190,2191,2191,"white","age.gp4","NoTr","NoTrade","NoGroup",1,0,0,1,0,0,1,0,0,1,0,1,1,0,1
"2871",1824,1825,1825,"black","age.gp4","NoTr","NoTrade","NoGroup",4,1,0,0,3,2,2,0,1,3,0,4,2,2,1
"2872",2582,2583,2583,"white","age.gp4","NoTr","NoTrade","Group",6,1,0,1,4,0,6,0,4,2,0,6,5,1,1
"2873",2187,2188,2188,"white","age.gp4","NoTr","NoTrade","NoGroup",1,0,0,0,1,0,1,0,1,0,0,1,1,0,1
"2874",2198,2199,2199,"white","age.gp4","NoTr","NoTrade","NoGroup",1,0,0,0,1,0,1,0,1,0,0,1,1,0,1
"2875",1829,1830,1830,"black","age.gp4","NoTr","NoTrade","NoGroup",1,0,0,0,1,0,1,0,1,0,0,1,1,0,1
"2876",1689,1690,1690,"white","age.gp4","NoTr","Trade","NoGroup",1,0,0,0,1,0,1,0,1,0,0,1,1,0,1
"2877",2400,2401,2401,"white","age.gp3","NoTr","NoTrade","NoGroup",6,3,0,2,1,1,4,1,2,4,1,5,3,3,1
"2878",2759,2760,2760,"white","age.gp3","NoTr","NoTrade","NoGroup",5,0,2,2,1,0,5,0,3,2,0,5,3,2,1
"2879",2638,2639,2639,"white","age.gp4","NoTr","NoTrade","NoGroup",1,1,0,0,0,0,1,0,0,1,0,1,0,1,1
"2880",2451,2452,2452,"white","age.gp4","NoTr","NoTrade","NoGroup",1,0,1,0,0,0,0,1,0,1,0,1,0,1,1
"2881",1653,1654,1654,"other","age.gp2","NoTr","NoTrade","NoGroup",3,0,2,0,1,0,3,0,1,2,0,3,3,0,1
"2882",1971,1972,1972,"white","age.gp4","Tr","NoTrade","NoGroup",1,0,1,0,0,0,0,1,0,1,0,1,0,1,1
"2883",1657,1658,1658,"other","age.gp2","NoTr","NoTrade","NoGroup",1,0,0,1,0,0,1,0,1,0,0,1,1,0,1
"2884",1662,1663,1663,"other","age.gp2","NoTr","NoTrade","NoGroup",3,0,2,0,1,0,3,0,2,1,0,3,2,1,1
"2885",1677,1678,1678,"white","age.gp4","NoTr","Trade","NoGroup",3,0,1,1,1,0,3,0,1,2,0,3,3,0,1
"2886",1680,1681,1681,"white","age.gp4","NoTr","Trade","NoGroup",1,0,0,0,1,0,1,0,1,0,0,1,1,0,1
"2887",1681,1682,1682,"white","age.gp4","NoTr","Trade","NoGroup",1,0,0,0,1,0,1,0,0,1,0,1,1,0,1
"2888",1688,1689,1689,"white","age.gp4","NoTr","Trade","NoGroup",1,0,0,0,1,1,0,0,0,1,1,0,1,0,1
"2889",1695,1696,1696,"white","age.gp4","NoTr","Trade","NoGroup",4,0,0,0,4,0,4,0,1,3,0,4,4,0,1
"2890",1698,1699,1699,"white","age.gp4","NoTr","Trade","NoGroup",1,1,0,0,0,0,1,0,0,1,0,1,1,0,1
"2891",1699,1700,1700,"white","age.gp4","NoTr","Trade","NoGroup",1,0,0,1,0,0,1,0,0,1,1,0,1,0,1
"2892",1700,1701,1701,"white","age.gp4","NoTr","Trade","NoGroup",1,0,0,0,1,0,1,0,1,0,0,1,1,0,1
"2893",1705,1706,1706,"white","age.gp4","NoTr","Trade","NoGroup",1,0,0,0,1,0,1,0,0,1,0,1,1,0,1
"2894",2450,2451,2451,"white","age.gp4","NoTr","NoTrade","NoGroup",4,2,2,0,0,0,3,1,2,2,0,4,3,1,1
"2895",1926,1927,1927,"other","age.gp2","NoTr","NoTrade","NoGroup",1,0,1,0,0,0,1,0,0,1,0,1,1,0,1
"2896",1932,1933,1933,"other","age.gp2","NoTr","NoTrade","NoGroup",4,0,2,0,2,1,3,0,3,1,1,3,3,1,1
"2897",2721,2722,2722,"white","age.gp4","NoTr","NoTrade","Group",4,0,3,0,1,0,4,0,1,3,0,4,2,2,1
"2898",2427,2428,2428,"white","age.gp4","NoTr","NoTrade","NoGroup",1,0,1,0,0,0,1,0,0,1,0,1,1,0,1
"2899",2176,2177,2177,"white","age.gp4","NoTr","NoTrade","NoGroup",4,0,0,2,2,0,4,0,3,1,0,4,3,1,1
"2900",2439,2440,2440,"white","age.gp4","NoTr","NoTrade","NoGroup",1,0,0,1,0,0,1,0,1,0,0,1,1,0,1
"2901",2621,2622,2622,"white","age.gp4","NoTr","NoTrade","NoGroup",1,0,0,0,1,1,0,0,0,1,0,1,0,1,1
"2902",1743,1744,1744,"black","age.gp4","NoTr","NoTrade","NoGroup",1,0,0,1,0,1,0,0,0,1,0,1,0,1,1
"2903",1744,1745,1745,"black","age.gp4","NoTr","NoTrade","NoGroup",1,0,1,0,0,0,1,0,0,1,0,1,1,0,1
"2904",1745,1746,1746,"black","age.gp4","NoTr","NoTrade","NoGroup",3,0,1,1,1,3,0,0,0,3,0,3,0,3,1
"2905",2404,2405,2405,"white","age.gp3","NoTr","NoTrade","NoGroup",3,0,1,0,2,1,2,0,1,2,0,3,2,1,1
"2906",1821,1822,1822,"black","age.gp4","NoTr","NoTrade","NoGroup",1,0,0,0,1,1,0,0,0,1,0,1,0,1,1
"2907",1758,1759,1759,"black","age.gp4","NoTr","NoTrade","NoGroup",1,0,0,0,1,1,0,0,0,1,0,1,0,1,1
"2908",1769,1770,1770,"black","age.gp4","NoTr","NoTrade","NoGroup",1,0,0,0,1,0,1,0,0,1,0,1,1,0,1
"2909",2572,2573,2573,"white","age.gp4","NoTr","NoTrade","Group",5,0,1,2,2,1,4,0,2,3,0,5,3,2,1
"2910",2535,2536,2536,"other","age.gp1","NoTr","NoTrade","NoGroup",2,0,0,1,1,1,1,0,1,1,0,2,1,1,1
"2911",1777,1778,1778,"white","age.gp4","Tr","NoTrade","Group",1,0,0,0,1,0,1,0,0,1,0,1,1,0,1
"2912",1778,1779,1779,"white","age.gp4","Tr","NoTrade","Group",4,1,0,0,3,0,3,1,1,3,0,4,3,1,1
"2913",1994,1995,1995,"white","age.gp4","Tr","NoTrade","NoGroup",1,0,0,0,1,0,1,0,1,0,0,1,1,0,1
"2914",1983,1984,1984,"white","age.gp4","Tr","NoTrade","NoGroup",3,0,0,0,3,0,3,0,2,1,0,3,2,1,1
"2915",2446,2447,2447,"white","age.gp4","NoTr","NoTrade","NoGroup",1,0,0,0,1,0,1,0,1,0,0,1,1,0,1
"2916",1996,1997,1997,"white","age.gp4","Tr","NoTrade","NoGroup",1,0,0,0,1,0,1,0,1,0,0,1,1,0,1
"2917",2662,2663,2663,"white","age.gp3","NoTr","NoTrade","NoGroup",1,0,1,0,0,0,1,0,1,0,0,1,1,0,1
"2918",2442,2443,2443,"white","age.gp4","NoTr","NoTrade","NoGroup",1,0,1,0,0,0,1,0,1,0,0,1,1,0,1
"2919",1814,1815,1815,"black","age.gp4","NoTr","NoTrade","NoGroup",1,0,1,0,0,1,0,0,1,0,1,0,1,0,1
"2920",1816,1817,1817,"black","age.gp4","NoTr","NoTrade","NoGroup",2,0,1,0,1,2,0,0,0,2,0,2,0,2,1
"2921",2010,2011,2011,"black","age.gp4","NoTr","NoTrade","NoGroup",3,0,1,0,2,3,0,0,0,3,1,2,2,1,1
"2922",1834,1835,1835,"black","age.gp4","NoTr","NoTrade","NoGroup",1,0,0,0,1,1,0,0,0,1,0,1,0,1,1
"2923",1839,1840,1840,"black","age.gp3","NoTr","NoTrade","NoGroup",1,0,1,0,0,1,0,0,0,1,0,1,0,1,1
"2924",2498,2499,2499,"other","age.gp1","NoTr","NoTrade","NoGroup",2,0,0,2,0,0,2,0,0,2,0,2,1,1,1
"2925",1871,1872,1872,"other","age.gp1","NoTr","NoTrade","Group",3,0,1,1,1,0,3,0,1,2,0,3,2,1,1
"2926",2431,2432,2432,"white","age.gp4","NoTr","NoTrade","NoGroup",5,2,1,0,2,0,3,2,1,4,0,5,4,1,1
"2927",2018,2019,2019,"black","age.gp4","NoTr","NoTrade","NoGroup",1,1,0,0,0,0,0,1,0,1,0,1,1,0,1
"2928",1914,1915,1915,"other","age.gp2","NoTr","NoTrade","NoGroup",1,0,1,0,0,0,1,0,1,0,0,1,1,0,1
"2929",1956,1957,1957,"white","age.gp4","NoTr","NoTrade","Group",3,0,1,1,1,1,2,0,1,2,1,2,3,0,1
"2930",2191,2192,2192,"white","age.gp4","NoTr","NoTrade","NoGroup",1,0,0,0,1,0,1,0,1,0,0,1,0,1,1
"2931",1978,1979,1979,"white","age.gp4","Tr","NoTrade","NoGroup",1,0,1,0,0,0,0,1,0,1,0,1,0,1,1
"2932",1981,1982,1982,"white","age.gp4","Tr","NoTrade","NoGroup",1,0,0,0,1,0,1,0,0,1,0,1,1,0,1
"2933",1984,1985,1985,"white","age.gp4","Tr","NoTrade","NoGroup",1,0,1,0,0,0,1,0,1,0,0,1,1,0,1
"2934",1987,1988,1988,"white","age.gp4","Tr","NoTrade","NoGroup",1,0,0,0,1,0,1,0,1,0,0,1,0,1,1
"2935",1990,1991,1991,"white","age.gp4","Tr","NoTrade","NoGroup",1,0,1,0,0,0,0,1,0,1,0,1,0,1,1
"2936",2007,2008,2008,"black","age.gp4","NoTr","NoTrade","NoGroup",1,1,0,0,0,1,0,0,0,1,0,1,0,1,1
"2937",2023,2024,2024,"black","age.gp4","NoTr","NoTrade","NoGroup",3,0,1,2,0,2,1,0,0,3,1,2,1,2,1
"2938",2025,2026,2026,"black","age.gp4","NoTr","NoTrade","NoGroup",1,0,0,1,0,1,0,0,0,1,0,1,0,1,1
"2939",2639,2640,2640,"white","age.gp4","NoTr","NoTrade","NoGroup",1,0,0,0,1,0,1,0,1,0,0,1,1,0,1
"2940",2626,2627,2627,"white","age.gp4","NoTr","NoTrade","NoGroup",3,0,2,0,1,0,2,1,1,2,0,3,1,2,1
"2941",2179,2180,2180,"white","age.gp4","NoTr","NoTrade","NoGroup",1,0,0,1,0,0,1,0,1,0,0,1,1,0,1
"2942",2087,2088,2088,"black","age.gp3","NoTr","NoTrade","NoGroup",1,0,1,0,0,1,0,0,0,1,0,1,0,1,1
"2943",2724,2725,2725,"black","age.gp3","NoTr","NoTrade","NoGroup",1,0,0,1,0,1,0,0,0,1,0,1,0,1,1
"2944",2183,2184,2184,"white","age.gp4","NoTr","NoTrade","NoGroup",1,0,1,0,0,0,0,1,1,0,0,1,1,0,1
"2945",2501,2502,2502,"other","age.gp1","NoTr","NoTrade","NoGroup",1,0,0,0,1,0,1,0,1,0,0,1,1,0,1
"2946",2488,2489,2489,"other","age.gp1","NoTr","NoTrade","NoGroup",1,1,0,0,0,0,1,0,0,1,0,1,0,1,1
"2947",2630,2631,2631,"white","age.gp4","NoTr","NoTrade","NoGroup",2,0,0,1,1,0,2,0,1,1,0,2,1,1,1
"2948",2654,2655,2655,"black","age.gp1","NoTr","NoTrade","NoGroup",2,1,1,0,0,1,1,0,0,2,0,2,1,1,1
"2949",2625,2626,2626,"white","age.gp4","NoTr","NoTrade","NoGroup",1,0,0,1,0,0,1,0,0,1,1,0,1,0,1
"2950",2491,2492,2492,"other","age.gp1","NoTr","NoTrade","NoGroup",2,1,0,1,0,0,2,0,0,2,1,1,1,1,1
"2951",2447,2448,2448,"white","age.gp4","NoTr","NoTrade","NoGroup",1,0,1,0,0,0,1,0,1,0,0,1,1,0,1
"2952",2449,2450,2450,"white","age.gp4","NoTr","NoTrade","NoGroup",1,1,0,0,0,0,0,1,0,1,0,1,0,1,1
"2953",2454,2455,2455,"white","age.gp4","NoTr","NoTrade","NoGroup",1,0,0,1,0,0,1,0,0,1,0,1,0,1,1
"2954",2486,2487,2487,"other","age.gp1","NoTr","NoTrade","NoGroup",4,2,0,1,1,1,3,0,1,3,0,4,1,3,1
"2955",2628,2629,2629,"white","age.gp4","NoTr","NoTrade","NoGroup",1,0,1,0,0,0,1,0,0,1,0,1,1,0,1
"2956",2620,2621,2621,"white","age.gp4","NoTr","NoTrade","NoGroup",1,0,1,0,0,0,1,0,1,0,0,1,1,0,1
"2957",2623,2624,2624,"white","age.gp4","NoTr","NoTrade","NoGroup",2,0,1,0,1,0,2,0,1,1,0,2,2,0,1
"2958",2631,2632,2632,"white","age.gp4","NoTr","NoTrade","NoGroup",1,0,0,1,0,0,1,0,0,1,0,1,0,1,1
"2959",2812,2813,2813,"other","age.gp2","NoTr","NoTrade","NoGroup",3,1,1,0,1,0,3,0,0,3,0,3,2,1,1
"2960",2894,2895,2895,"other","age.gp1","NoTr","NoTrade","NoGroup",1,1,0,0,0,0,1,0,0,1,0,1,1,0,1
"2961",2889,2890,2890,"other","age.gp1","NoTr","NoTrade","NoGroup",1,1,0,0,0,0,1,0,0,1,0,1,1,0,1
"2962",0,1,1,"black","age.gp3","NoTr","Trade","NoGroup",6,1,1,3,1,3,3,0,2,4,0,6,4,2,2
"2963",16,17,17,"black","age.gp2","Tr","NoTrade","Group",16,0,8,6,2,8,8,0,5,11,2,14,12,4,2
"2964",1003,1004,1004,"white","age.gp1","Tr","NoTrade","Group",21,12,4,2,3,1,12,8,5,16,3,18,11,10,2
"2965",1064,1065,1065,"white","age.gp4","NoTr","NoTrade","Group",8,0,4,3,1,1,6,1,3,5,1,7,4,4,2
"2966",1391,1392,1392,"black","age.gp3","NoTr","NoTrade","NoGroup",6,3,1,2,0,5,1,0,1,5,3,3,2,4,2
"2967",1395,1396,1396,"black","age.gp3","NoTr","NoTrade","NoGroup",5,1,2,2,0,3,1,1,1,4,2,3,2,3,2
"2968",1867,1868,1868,"white","age.gp3","NoTr","NoTrade","Group",22,1,5,10,6,3,18,1,6,16,4,18,16,6,2
"2969",1,2,2,"black","age.gp3","NoTr","Trade","NoGroup",4,1,2,0,1,1,3,0,0,4,0,4,0,4,2
"2970",459,460,460,"white","age.gp1","NoTr","NoTrade","NoGroup",12,5,3,2,2,2,8,2,4,8,2,10,5,7,2
"2971",780,781,781,"white","age.gp2","NoTr","NoTrade","NoGroup",8,1,3,1,3,4,4,0,3,5,3,5,6,2,2
"2972",2025,2026,2026,"black","age.gp4","NoTr","NoTrade","NoGroup",1,0,0,1,0,1,0,0,0,1,1,0,0,1,2
"2973",2315,2316,2316,"white","age.gp2","NoTr","NoTrade","NoGroup",13,2,6,3,2,1,9,3,7,6,3,10,10,3,2
"2974",2,3,3,"black","age.gp3","NoTr","Trade","NoGroup",7,1,2,2,2,2,5,0,4,3,0,7,4,3,2
"2975",92,93,93,"white","age.gp3","NoTr","NoTrade","Group",17,4,2,9,2,2,14,1,6,11,3,14,10,7,2
"2976",245,246,246,"white","age.gp2","Tr","NoTrade","Group",25,3,6,5,11,1,22,2,5,20,4,21,18,7,2
"2977",787,788,788,"black","age.gp1","Tr","NoTrade","NoGroup",15,9,1,2,3,6,5,4,3,12,3,12,6,9,2
"2978",956,957,957,"black","age.gp2","Tr","NoTrade","NoGroup",10,3,4,1,2,4,6,0,2,8,1,9,6,4,2
"2979",1337,1338,1338,"white","age.gp3","NoTr","NoTrade","NoGroup",10,0,4,3,3,1,8,1,3,7,2,8,8,2,2
"2980",1953,1954,1954,"white","age.gp4","NoTr","NoTrade","Group",7,2,1,1,3,1,6,0,1,6,1,6,1,6,2
"2981",2057,2058,2058,"white","age.gp4","Tr","NoTrade","Group",12,2,1,3,6,2,8,2,4,8,2,10,5,7,2
"2982",3,4,4,"black","age.gp3","NoTr","Trade","NoGroup",5,0,2,3,0,3,2,0,3,2,1,4,3,2,2
"2983",409,410,410,"white","age.gp2","Tr","Trade","Group",22,2,7,12,1,4,16,2,7,15,2,20,13,9,2
"2984",515,516,516,"black","age.gp3","NoTr","NoTrade","NoGroup",5,0,3,1,1,2,2,1,3,2,2,3,2,3,2
"2985",516,517,517,"black","age.gp3","NoTr","NoTrade","NoGroup",6,0,4,2,0,3,2,1,4,2,1,5,3,3,2
"2986",1733,1734,1734,"white","age.gp3","Tr","NoTrade","Group",23,4,10,5,4,4,17,2,4,19,5,18,16,7,2
"2987",2368,2369,2369,"black","age.gp2","Tr","NoTrade","Group",22,4,5,8,5,11,11,0,8,14,2,20,4,18,2
"2988",4,5,5,"black","age.gp3","NoTr","Trade","NoGroup",10,0,3,3,4,4,6,0,2,8,2,8,5,5,2
"2989",96,97,97,"white","age.gp3","NoTr","NoTrade","Group",18,2,7,8,1,4,13,1,11,7,1,17,12,6,2
"2990",191,192,192,"white","age.gp2","Tr","NoTrade","NoGroup",12,0,6,3,3,1,9,2,2,10,1,11,6,6,2
"2991",443,444,444,"white","age.gp4","NoTr","NoTrade","NoGroup",7,0,3,3,1,2,5,0,3,4,1,6,6,1,2
"2992",471,472,472,"black","age.gp3","NoTr","Trade","Group",12,2,4,5,1,5,4,3,3,9,1,11,7,5,2
"2993",479,480,480,"black","age.gp4","NoTr","NoTrade","NoGroup",5,0,1,2,2,3,2,0,0,5,1,4,1,4,2
"2994",951,952,952,"white","age.gp3","Tr","NoTrade","Group",19,2,8,6,3,5,11,3,6,13,1,18,11,8,2
"2995",1537,1538,1538,"black","age.gp4","NoTr","NoTrade","NoGroup",8,0,4,3,1,4,3,1,3,5,2,6,6,2,2
"2996",2235,2236,2236,"black","age.gp4","NoTr","Trade","Group",10,1,1,5,3,8,2,0,1,9,3,7,4,6,2
"2997",2661,2662,2662,"white","age.gp2","NoTr","NoTrade","Group",29,1,14,8,6,5,23,1,13,16,3,26,22,7,2
"2998",2798,2799,2799,"white","age.gp2","NoTr","NoTrade","NoGroup",10,0,4,2,4,1,8,1,5,5,1,9,7,3,2
"2999",5,6,6,"black","age.gp3","NoTr","Trade","NoGroup",7,0,3,4,0,5,2,0,0,7,2,5,3,4,2
"3000",456,457,457,"black","age.gp3","NoTr","NoTrade","NoGroup",3,0,1,2,0,2,1,0,1,2,1,2,1,2,2
"3001",1103,1104,1104,"black","age.gp2","NoTr","NoTrade","NoGroup",6,2,1,3,0,5,1,0,2,4,4,2,3,3,2
"3002",2390,2391,2391,"black","age.gp2","NoTr","NoTrade","NoGroup",9,0,3,4,2,7,2,0,1,8,2,7,3,6,2
"3003",2418,2419,2419,"white","age.gp3","NoTr","Trade","Group",13,2,5,3,3,1,11,1,3,10,2,11,7,6,2
"3004",2423,2424,2424,"white","age.gp3","NoTr","Trade","Group",17,3,5,6,3,3,12,2,2,15,1,16,9,8,2
"3005",2609,2610,2610,"black","age.gp2","NoTr","NoTrade","Group",24,1,10,10,3,13,11,0,7,17,6,18,12,12,2
"3006",2731,2732,2732,"black","age.gp3","NoTr","NoTrade","NoGroup",2,0,0,2,0,2,0,0,0,2,1,1,1,1,2
"3007",6,7,7,"black","age.gp3","NoTr","Trade","NoGroup",9,2,2,5,0,4,4,1,1,8,3,6,5,4,2
"3008",181,182,182,"white","age.gp3","Tr","NoTrade","NoGroup",14,3,5,2,4,1,9,4,4,10,2,12,6,8,2
"3009",467,468,468,"black","age.gp3","NoTr","Trade","Group",12,2,3,4,3,7,3,2,1,11,3,9,8,4,2
"3010",639,640,640,"other","age.gp1","NoTr","Trade","Group",6,2,0,2,2,1,5,0,0,6,2,4,2,4,2
"3011",2421,2422,2422,"white","age.gp3","NoTr","Trade","Group",18,4,3,7,4,4,13,1,6,12,3,15,9,9,2
"3012",2756,2757,2757,"white","age.gp3","NoTr","NoTrade","NoGroup",12,1,4,6,1,1,10,1,4,8,1,11,7,5,2
"3013",2834,2835,2835,"black","age.gp2","NoTr","NoTrade","NoGroup",10,1,4,1,4,7,3,0,2,8,3,7,4,6,2
"3014",2852,2853,2853,"black","age.gp3","NoTr","NoTrade","Group",15,1,3,7,4,7,7,1,2,13,2,13,7,8,2
"3015",2973,2974,2974,"white","age.gp1","NoTr","NoTrade","Group",20,10,2,4,4,3,14,3,6,14,3,17,10,10,2
"3016",7,8,8,"black","age.gp3","NoTr","Trade","NoGroup",4,1,2,1,0,4,0,0,2,2,0,4,3,1,2
"3017",15,16,16,"black","age.gp2","Tr","NoTrade","Group",14,1,6,4,3,10,4,0,3,11,3,11,10,4,2
"3018",784,785,785,"black","age.gp1","Tr","NoTrade","NoGroup",17,7,3,4,3,12,4,1,4,13,4,13,5,12,2
"3019",964,965,965,"black","age.gp2","NoTr","NoTrade","Group",16,2,3,10,1,7,6,3,4,12,3,13,8,8,2
"3020",2853,2854,2854,"black","age.gp3","NoTr","NoTrade","Group",14,2,5,4,3,6,7,1,3,11,1,13,9,5,2
"3021",8,9,9,"black","age.gp3","NoTr","Trade","NoGroup",1,0,0,1,0,1,0,0,0,1,0,1,0,1,2
"3022",9,10,10,"black","age.gp3","NoTr","Trade","NoGroup",3,1,2,0,0,2,0,1,1,2,0,3,2,1,2
"3023",18,19,19,"black","age.gp2","Tr","NoTrade","Group",27,5,9,6,7,14,12,1,5,22,5,22,13,14,2
"3024",1415,1416,1416,"black","age.gp2","NoTr","NoTrade","NoGroup",10,1,4,3,2,6,4,0,2,8,2,8,3,7,2
"3025",1870,1871,1871,"other","age.gp1","NoTr","NoTrade","Group",11,4,3,3,1,1,10,0,5,6,3,8,7,4,2
"3026",10,11,11,"black","age.gp3","NoTr","Trade","NoGroup",5,1,1,2,1,4,1,0,0,5,1,4,1,4,2
"3027",446,447,447,"black","age.gp3","NoTr","NoTrade","NoGroup",7,1,1,3,2,5,2,0,1,6,1,6,3,4,2
"3028",887,888,888,"white","age.gp3","NoTr","Trade","Group",13,1,4,4,4,2,11,0,4,9,1,12,11,2,2
"3029",1477,1478,1478,"black","age.gp1","NoTr","NoTrade","NoGroup",6,3,0,2,1,2,3,1,3,3,1,5,1,5,2
"3030",1747,1748,1748,"black","age.gp4","NoTr","NoTrade","NoGroup",6,0,1,2,3,2,4,0,2,4,1,5,2,4,2
"3031",2165,2166,2166,"black","age.gp2","NoTr","NoTrade","NoGroup",7,1,4,1,1,3,2,2,1,6,1,6,4,3,2
"3032",11,12,12,"black","age.gp3","NoTr","Trade","NoGroup",4,1,0,3,0,3,1,0,0,4,1,3,3,1,2
"3033",463,464,464,"black","age.gp3","NoTr","Trade","Group",13,0,7,3,3,8,4,1,2,11,3,10,8,5,2
"3034",1452,1453,1453,"black","age.gp1","NoTr","NoTrade","NoGroup",10,2,1,4,3,4,5,1,3,7,2,8,6,4,2
"3035",1859,1860,1860,"white","age.gp3","NoTr","NoTrade","Group",12,0,5,5,2,1,10,1,3,9,2,10,9,3,2
"3036",2847,2848,2848,"black","age.gp3","NoTr","NoTrade","Group",14,0,3,6,5,9,5,0,2,12,3,11,6,8,2
"3037",12,13,13,"black","age.gp3","NoTr","Trade","NoGroup",1,0,1,0,0,1,0,0,0,1,0,1,0,1,2
"3038",227,228,228,"black","age.gp2","NoTr","NoTrade","NoGroup",14,1,7,2,4,8,6,0,6,8,2,12,9,5,2
"3039",13,14,14,"black","age.gp3","NoTr","Trade","NoGroup",3,1,0,1,1,3,0,0,1,2,2,1,1,2,2
"3040",464,465,465,"black","age.gp3","NoTr","Trade","Group",15,0,5,5,5,10,5,0,4,11,1,14,6,9,2
"3041",1533,1534,1534,"black","age.gp4","NoTr","NoTrade","NoGroup",7,0,2,2,3,5,2,0,2,5,1,6,2,5,2
"3042",1594,1595,1595,"black","age.gp1","Tr","Trade","NoGroup",17,8,2,3,4,12,5,0,6,11,5,12,9,8,2
"3043",14,15,15,"black","age.gp2","Tr","NoTrade","Group",20,4,9,5,2,14,6,0,5,15,5,15,12,8,2
"3044",17,18,18,"black","age.gp2","Tr","NoTrade","Group",24,1,10,8,5,11,11,2,8,16,2,22,13,11,2
"3045",292,293,293,"black","age.gp2","NoTr","NoTrade","Group",16,1,9,1,5,8,7,1,6,10,2,14,8,8,2
"3046",952,953,953,"white","age.gp3","Tr","NoTrade","Group",20,2,6,3,9,5,15,0,5,15,1,19,14,6,2
"3047",1018,1019,1019,"white","age.gp2","NoTr","Trade","Group",25,1,10,6,8,4,21,0,12,13,0,25,18,7,2
"3048",1087,1088,1088,"black","age.gp2","Tr","NoTrade","NoGroup",5,0,2,3,0,4,1,0,1,4,0,5,3,2,2
"3049",1445,1446,1446,"white","age.gp1","NoTr","NoTrade","NoGroup",12,4,4,1,3,2,9,1,5,7,1,11,7,5,2
"3050",1453,1454,1454,"black","age.gp1","NoTr","NoTrade","NoGroup",16,6,4,4,2,9,5,2,3,13,2,14,7,9,2
"3051",1629,1630,1630,"white","age.gp1","NoTr","NoTrade","NoGroup",9,2,3,2,2,2,5,2,2,7,0,9,7,2,2
"3052",2077,2078,2078,"black","age.gp3","NoTr","NoTrade","NoGroup",6,1,1,3,1,5,1,0,1,5,2,4,4,2,2
"3053",2102,2103,2103,"white","age.gp2","Tr","NoTrade","Group",31,2,18,5,6,2,21,8,13,18,0,31,20,11,2
"3054",2218,2219,2219,"black","age.gp4","NoTr","Trade","Group",7,0,4,1,2,3,4,0,3,4,0,7,6,1,2
"3055",2227,2228,2228,"black","age.gp4","NoTr","Trade","Group",5,1,1,0,3,2,3,0,1,4,1,4,4,1,2
"3056",2369,2370,2370,"black","age.gp2","Tr","NoTrade","Group",20,1,11,3,5,13,7,0,5,15,2,18,12,8,2
"3057",2414,2415,2415,"white","age.gp3","NoTr","Trade","Group",19,0,8,6,5,2,16,1,10,9,2,17,15,4,2
"3058",2516,2517,2517,"black","age.gp2","NoTr","NoTrade","Group",17,2,8,4,3,10,6,1,2,15,1,16,12,5,2
"3059",2606,2607,2607,"black","age.gp2","NoTr","NoTrade","Group",25,0,11,9,5,15,10,0,5,20,1,24,10,15,2
"3060",2656,2657,2657,"black","age.gp1","NoTr","NoTrade","NoGroup",10,2,3,3,2,7,1,2,3,7,1,9,4,6,2
"3061",2764,2765,2765,"black","age.gp2","NoTr","NoTrade","NoGroup",9,0,4,3,2,6,3,0,2,7,1,8,5,4,2
"3062",53,54,54,"white","age.gp2","Tr","NoTrade","Group",27,2,14,11,0,4,20,3,14,13,4,23,22,5,2
"3063",230,231,231,"white","age.gp2","Tr","NoTrade","Group",16,1,9,5,1,1,13,2,8,8,0,16,11,5,2
"3064",468,469,469,"black","age.gp3","NoTr","Trade","Group",9,2,3,2,2,5,3,1,5,4,0,9,2,7,2
"3065",727,728,728,"black","age.gp4","NoTr","NoTrade","NoGroup",5,1,2,1,1,3,1,1,1,4,0,5,2,3,2
"3066",1090,1091,1091,"black","age.gp1","NoTr","NoTrade","NoGroup",5,2,1,2,0,2,2,1,1,4,0,5,2,3,2
"3067",1345,1346,1346,"black","age.gp4","NoTr","NoTrade","Group",9,0,3,2,4,4,4,1,3,6,0,9,5,4,2
"3068",1364,1365,1365,"black","age.gp4","NoTr","NoTrade","Group",10,0,4,2,4,6,4,0,5,5,2,8,5,5,2
"3069",1390,1391,1391,"black","age.gp3","NoTr","NoTrade","NoGroup",4,1,1,1,1,2,2,0,2,2,1,3,3,1,2
"3070",1406,1407,1407,"white","age.gp3","NoTr","NoTrade","Group",27,3,9,6,9,2,20,5,14,13,0,27,22,5,2
"3071",2209,2210,2210,"black","age.gp2","NoTr","Trade","Group",26,0,15,6,5,15,11,0,11,15,3,23,20,6,2
"3072",2525,2526,2526,"white","age.gp2","NoTr","NoTrade","Group",28,0,17,8,3,3,20,5,11,17,2,26,19,9,2
"3073",2607,2608,2608,"black","age.gp2","NoTr","NoTrade","Group",15,2,4,4,5,9,5,1,4,11,2,13,8,7,2
"3074",142,143,143,"white","age.gp3","NoTr","NoTrade","Group",21,2,9,4,6,2,15,4,10,11,2,19,16,5,2
"3075",662,663,663,"white","age.gp2","NoTr","NoTrade","Group",24,3,11,6,4,2,20,2,10,14,0,24,17,7,2
"3076",965,966,966,"black","age.gp2","NoTr","NoTrade","Group",16,1,8,5,2,7,7,2,6,10,2,14,9,7,2
"3077",1249,1250,1250,"white","age.gp2","Tr","NoTrade","Group",36,3,21,3,9,6,22,8,16,20,0,36,22,14,2
"3078",1560,1561,1561,"white","age.gp3","NoTr","NoTrade","Group",17,1,6,3,7,2,13,2,8,9,0,17,11,6,2
"3079",1587,1588,1588,"white","age.gp4","Tr","NoTrade","Group",19,3,4,3,9,1,16,2,6,13,0,19,12,7,2
"3080",1718,1719,1719,"white","age.gp2","NoTr","NoTrade","Group",27,3,10,11,3,3,21,3,12,15,0,27,18,9,2
"3081",1810,1811,1811,"black","age.gp4","NoTr","NoTrade","NoGroup",1,0,1,0,0,1,0,0,1,0,0,1,1,0,2
"3082",2067,2068,2068,"white","age.gp3","Tr","NoTrade","Group",23,2,6,9,6,3,17,3,11,12,2,21,13,10,2
"3083",2085,2086,2086,"black","age.gp3","NoTr","NoTrade","NoGroup",9,1,5,3,0,6,2,1,3,6,0,9,4,5,2
"3084",2277,2278,2278,"black","age.gp2","Tr","Trade","Group",18,0,11,4,3,6,10,2,7,11,1,17,13,5,2
"3085",2527,2528,2528,"white","age.gp2","NoTr","NoTrade","Group",18,2,7,5,4,2,15,1,8,10,0,18,13,5,2
"3086",2850,2851,2851,"black","age.gp3","NoTr","NoTrade","Group",18,2,8,5,3,9,6,3,2,16,3,15,9,9,2
"3087",137,138,138,"white","age.gp2","NoTr","NoTrade","NoGroup",5,1,2,1,1,1,4,0,2,3,0,5,3,2,2
"3088",282,283,283,"white","age.gp2","Tr","NoTrade","Group",19,1,10,5,3,2,13,4,9,10,2,17,11,8,2
"3089",405,406,406,"black","age.gp4","NoTr","NoTrade","NoGroup",7,0,1,1,5,6,1,0,2,5,2,5,3,4,2
"3090",457,458,458,"black","age.gp3","NoTr","NoTrade","NoGroup",4,0,1,3,0,4,0,0,1,3,0,4,2,2,2
"3091",474,475,475,"black","age.gp3","NoTr","Trade","Group",8,0,3,3,2,5,3,0,3,5,1,7,3,5,2
"3092",660,661,661,"white","age.gp2","NoTr","NoTrade","Group",29,1,15,6,7,3,25,1,18,11,1,28,24,5,2
"3093",862,863,863,"other","age.gp2","Tr","NoTrade","Group",16,2,5,6,3,1,15,0,8,8,1,15,11,5,2
"3094",865,866,866,"other","age.gp2","Tr","NoTrade","Group",13,2,5,4,2,2,11,0,6,7,2,11,12,1,2
"3095",967,968,968,"white","age.gp2","Tr","NoTrade","Group",29,1,11,7,10,4,23,2,6,23,3,26,18,11,2
"3096",1014,1015,1015,"white","age.gp1","NoTr","NoTrade","NoGroup",11,5,2,3,1,1,7,3,6,5,0,11,7,4,2
"3097",1294,1295,1295,"white","age.gp4","NoTr","NoTrade","Group",7,1,2,1,3,3,4,0,2,5,0,7,4,3,2
"3098",1606,1607,1607,"white","age.gp3","Tr","NoTrade","NoGroup",8,2,2,3,1,1,6,1,3,5,1,7,5,3,2
"3099",1749,1750,1750,"black","age.gp4","NoTr","NoTrade","NoGroup",5,0,2,1,2,4,1,0,2,3,0,5,4,1,2
"3100",1827,1828,1828,"black","age.gp4","NoTr","NoTrade","NoGroup",4,0,2,0,2,2,2,0,2,2,1,3,4,0,2
"3101",1851,1852,1852,"black","age.gp3","NoTr","NoTrade","NoGroup",14,1,5,4,4,7,6,1,3,11,1,13,8,6,2
"3102",2064,2065,2065,"white","age.gp3","Tr","NoTrade","Group",23,0,9,5,9,4,17,2,11,12,1,22,14,9,2
"3103",2385,2386,2386,"white","age.gp2","Tr","NoTrade","Group",29,6,12,6,5,6,20,3,7,22,1,28,17,12,2
"3104",2407,2408,2408,"white","age.gp3","NoTr","NoTrade","NoGroup",12,0,4,2,6,1,11,0,5,7,1,11,11,1,2
"3105",2505,2506,2506,"black","age.gp2","NoTr","NoTrade","NoGroup",8,0,6,1,1,5,3,0,5,3,2,6,5,3,2
"3106",2745,2746,2746,"white","age.gp2","NoTr","NoTrade","Group",16,1,10,3,2,1,12,3,5,11,1,15,11,5,2
"3107",2849,2850,2850,"black","age.gp3","NoTr","NoTrade","Group",16,2,3,5,6,8,7,1,7,9,3,13,8,8,2
"3108",264,265,265,"white","age.gp4","NoTr","NoTrade","NoGroup",5,1,1,1,2,2,3,0,2,3,0,5,4,1,2
"3109",293,294,294,"black","age.gp2","NoTr","NoTrade","Group",19,2,11,5,1,11,8,0,8,11,2,17,13,6,2
"3110",433,434,434,"white","age.gp4","NoTr","NoTrade","NoGroup",8,0,4,2,2,1,6,1,4,4,1,7,7,1,2
"3111",566,567,567,"other","age.gp4","NoTr","NoTrade","NoGroup",4,0,2,0,2,2,2,0,3,1,1,3,4,0,2
"3112",706,707,707,"white","age.gp2","NoTr","NoTrade","Group",22,2,9,9,2,1,18,3,9,13,1,21,12,10,2
"3113",1243,1244,1244,"white","age.gp2","Tr","NoTrade","NoGroup",6,0,4,0,2,2,4,0,1,5,0,6,4,2,2
"3114",1259,1260,1260,"black","age.gp3","NoTr","NoTrade","NoGroup",7,2,2,1,2,5,2,0,3,4,0,7,4,3,2
"3115",1352,1353,1353,"black","age.gp4","NoTr","NoTrade","Group",6,0,2,1,3,4,2,0,2,4,0,6,3,3,2
"3116",1427,1428,1428,"white","age.gp2","Tr","NoTrade","Group",29,3,17,5,4,2,23,4,15,14,1,28,22,7,2
"3117",1720,1721,1721,"white","age.gp2","NoTr","NoTrade","Group",30,3,19,3,5,1,25,4,12,18,3,27,18,12,2
"3118",2228,2229,2229,"black","age.gp4","NoTr","Trade","Group",9,2,3,2,2,5,4,0,4,5,0,9,5,4,2
"3119",2411,2412,2412,"white","age.gp3","NoTr","Trade","Group",13,2,6,2,3,2,11,0,5,8,0,13,10,3,2
"3120",2458,2459,2459,"black","age.gp1","NoTr","NoTrade","NoGroup",7,2,1,1,3,5,1,1,2,5,1,6,3,4,2
"3121",2460,2461,2461,"black","age.gp1","NoTr","NoTrade","NoGroup",8,3,2,1,2,6,0,2,1,7,3,5,4,4,2
"3122",2654,2655,2655,"black","age.gp1","NoTr","NoTrade","NoGroup",16,9,5,0,2,9,3,4,7,9,3,13,7,9,2
"3123",2677,2678,2678,"black","age.gp3","NoTr","NoTrade","NoGroup",5,0,1,2,2,4,1,0,1,4,0,5,4,1,2
"3124",2681,2682,2682,"black","age.gp3","NoTr","NoTrade","NoGroup",3,1,1,0,1,2,1,0,2,1,0,3,3,0,2
"3125",2715,2716,2716,"white","age.gp4","NoTr","NoTrade","Group",7,0,3,1,3,1,6,0,5,2,0,7,5,2,2
"3126",2789,2790,2790,"white","age.gp2","NoTr","NoTrade","Group",20,5,7,6,2,2,16,2,8,12,3,17,16,4,2
"3127",2838,2839,2839,"black","age.gp2","NoTr","NoTrade","NoGroup",16,3,7,4,2,9,7,0,3,13,0,16,8,8,2
"3128",2864,2865,2865,"white","age.gp2","Tr","NoTrade","Group",33,3,16,10,4,2,26,5,14,19,3,30,22,11,2
"3129",2887,2888,2888,"white","age.gp1","NoTr","NoTrade","Group",35,16,7,5,7,4,21,10,14,21,4,31,19,16,2
"3130",19,20,20,"black","age.gp4","NoTr","Trade","NoGroup",3,0,1,1,1,2,1,0,1,2,0,3,3,0,2
"3131",1936,1937,1937,"white","age.gp4","NoTr","NoTrade","Group",9,1,0,2,6,3,6,0,2,7,1,8,6,3,2
"3132",2845,2846,2846,"black","age.gp3","NoTr","NoTrade","Group",19,1,7,4,7,11,7,1,4,15,6,13,12,7,2
"3133",20,21,21,"black","age.gp4","NoTr","Trade","NoGroup",5,0,2,1,2,3,1,1,1,4,2,3,5,0,2
"3134",466,467,467,"black","age.gp3","NoTr","Trade","Group",17,2,5,7,3,6,9,2,4,13,2,15,5,12,2
"3135",869,870,870,"other","age.gp2","Tr","NoTrade","Group",11,2,5,1,3,1,9,1,4,7,2,9,8,3,2
"3136",1373,1374,1374,"black","age.gp4","NoTr","NoTrade","Group",12,0,4,4,4,8,4,0,4,8,1,11,7,5,2
"3137",2216,2217,2217,"black","age.gp4","NoTr","Trade","Group",7,2,0,0,5,4,3,0,2,5,1,6,2,5,2
"3138",2659,2660,2660,"white","age.gp2","NoTr","NoTrade","Group",25,1,9,9,6,3,19,3,8,17,3,22,16,9,2
"3139",21,22,22,"black","age.gp4","NoTr","Trade","NoGroup",1,0,0,0,1,0,1,0,0,1,0,1,1,0,2
"3140",1071,1072,1072,"white","age.gp4","NoTr","NoTrade","Group",12,0,4,4,4,1,11,0,5,7,2,10,8,4,2
"3141",22,23,23,"black","age.gp4","NoTr","Trade","NoGroup",8,0,1,4,3,6,2,0,1,7,0,8,4,4,2
"3142",360,361,361,"black","age.gp4","NoTr","NoTrade","NoGroup",4,0,0,0,4,3,1,0,0,4,1,3,2,2,2
"3143",396,397,397,"black","age.gp4","NoTr","NoTrade","NoGroup",12,0,1,1,10,9,3,0,2,10,2,10,9,3,2
"3144",1401,1402,1402,"white","age.gp3","NoTr","NoTrade","Group",20,4,8,4,4,3,16,1,8,12,3,17,13,7,2
"3145",1621,1622,1622,"white","age.gp2","Tr","NoTrade","Group",24,2,11,2,9,2,19,3,8,16,5,19,15,9,2
"3146",1760,1761,1761,"black","age.gp4","NoTr","NoTrade","NoGroup",4,0,2,0,2,4,0,0,1,3,2,2,2,2,2
"3147",2854,2855,2855,"black","age.gp3","NoTr","NoTrade","Group",12,2,7,1,2,9,3,0,4,8,2,10,4,8,2
"3148",23,24,24,"black","age.gp4","NoTr","Trade","NoGroup",3,0,3,0,0,2,1,0,0,3,1,2,2,1,2
"3149",2206,2207,2207,"black","age.gp2","NoTr","Trade","Group",23,2,10,5,6,17,5,1,4,19,4,19,10,13,2
"3150",2319,2320,2320,"white","age.gp2","NoTr","NoTrade","NoGroup",10,0,6,2,2,3,6,1,3,7,3,7,7,3,2
"3151",24,25,25,"black","age.gp4","NoTr","Trade","NoGroup",3,0,0,3,0,2,1,0,0,3,0,3,2,1,2
"3152",2735,2736,2736,"black","age.gp3","NoTr","NoTrade","NoGroup",11,0,8,1,2,7,4,0,4,7,1,10,7,4,2
"3153",25,26,26,"black","age.gp4","NoTr","Trade","NoGroup",3,0,1,0,2,2,1,0,0,3,1,2,3,0,2
"3154",315,316,316,"white","age.gp4","NoTr","NoTrade","Group",6,1,0,1,4,1,5,0,2,4,1,5,2,4,2
"3155",2219,2220,2220,"black","age.gp4","NoTr","Trade","Group",10,1,0,2,7,7,2,1,1,9,4,6,5,5,2
"3156",2346,2347,2347,"black","age.gp2","NoTr","NoTrade","Group",11,1,6,1,3,5,6,0,6,5,3,8,7,4,2
"3157",26,27,27,"black","age.gp4","NoTr","Trade","NoGroup",4,0,2,1,1,1,2,1,2,2,0,4,2,2,2
"3158",226,227,227,"black","age.gp2","NoTr","NoTrade","NoGroup",5,0,3,0,2,2,2,1,2,3,1,4,3,2,2
"3159",610,611,611,"other","age.gp4","NoTr","NoTrade","NoGroup",7,2,1,2,2,3,4,0,4,3,2,5,4,3,2
"3160",947,948,948,"white","age.gp3","Tr","NoTrade","Group",17,0,6,6,5,1,16,0,9,8,2,15,14,3,2
"3161",1321,1322,1322,"white","age.gp2","Tr","NoTrade","Group",25,5,12,3,5,3,19,3,9,16,1,24,17,8,2
"3162",27,28,28,"black","age.gp4","NoTr","Trade","NoGroup",4,0,1,0,3,2,2,0,1,3,0,4,3,1,2
"3163",505,506,506,"black","age.gp4","NoTr","NoTrade","NoGroup",1,0,0,0,1,1,0,0,0,1,1,0,0,1,2
"3164",704,705,705,"white","age.gp2","NoTr","NoTrade","Group",20,2,9,5,4,4,14,2,10,10,3,17,14,6,2
"3165",1354,1355,1355,"black","age.gp4","NoTr","NoTrade","Group",10,0,4,1,5,8,2,0,2,8,2,8,5,5,2
"3166",1797,1798,1798,"white","age.gp4","Tr","NoTrade","Group",9,1,1,2,5,2,7,0,3,6,1,8,6,3,2
"3167",28,29,29,"black","age.gp4","NoTr","Trade","NoGroup",4,0,0,1,3,4,0,0,0,4,0,4,1,3,2
"3168",454,455,455,"black","age.gp3","NoTr","NoTrade","NoGroup",4,1,2,0,1,3,0,1,1,3,1,3,2,2,2
"3169",504,505,505,"black","age.gp4","NoTr","NoTrade","NoGroup",7,0,0,3,4,5,2,0,0,7,3,4,4,3,2
"3170",1363,1364,1364,"black","age.gp4","NoTr","NoTrade","Group",8,2,3,1,2,2,5,1,1,7,3,5,6,2,2
"3171",1527,1528,1528,"black","age.gp4","NoTr","NoTrade","NoGroup",4,1,0,1,2,1,3,0,2,2,1,3,2,2,2
"3172",29,30,30,"black","age.gp4","NoTr","Trade","NoGroup",1,0,0,0,1,1,0,0,0,1,0,1,0,1,2
"3173",1529,1530,1530,"black","age.gp4","NoTr","NoTrade","NoGroup",6,0,3,0,3,5,1,0,0,6,1,5,0,6,2
"3174",30,31,31,"black","age.gp4","NoTr","Trade","NoGroup",1,0,0,0,1,1,0,0,0,1,0,1,0,1,2
"3175",1766,1767,1767,"black","age.gp4","NoTr","NoTrade","NoGroup",9,0,1,4,4,7,2,0,1,8,2,7,5,4,2
"3176",31,32,32,"black","age.gp4","NoTr","Trade","NoGroup",2,0,0,1,1,0,2,0,0,2,0,2,2,0,2
"3177",103,104,104,"white","age.gp3","NoTr","NoTrade","Group",21,4,5,6,6,2,17,2,9,12,1,20,9,12,2
"3178",2952,2953,2953,"white","age.gp4","NoTr","NoTrade","Group",8,2,2,2,2,1,6,1,3,5,1,7,6,2,2
"3179",32,33,33,"black","age.gp4","NoTr","Trade","NoGroup",3,0,1,0,2,3,0,0,0,3,1,2,1,2,2
"3180",370,371,371,"black","age.gp4","NoTr","NoTrade","NoGroup",2,0,0,0,2,1,1,0,0,2,1,1,1,1,2
"3181",1416,1417,1417,"black","age.gp2","NoTr","NoTrade","NoGroup",8,1,2,2,3,7,1,0,2,6,1,7,2,6,2
"3182",2238,2239,2239,"black","age.gp4","NoTr","Trade","Group",11,1,2,1,7,6,5,0,3,8,2,9,9,2,2
"3183",33,34,34,"black","age.gp4","NoTr","Trade","NoGroup",4,0,1,1,2,0,4,0,3,1,0,4,4,0,2
"3184",1250,1251,1251,"white","age.gp2","Tr","NoTrade","Group",28,3,16,0,9,3,23,2,10,18,2,26,19,9,2
"3185",1583,1584,1584,"white","age.gp4","Tr","NoTrade","Group",11,1,4,2,4,2,8,1,4,7,3,8,8,3,2
"3186",2071,2072,2072,"white","age.gp3","Tr","NoTrade","Group",16,0,3,3,10,2,14,0,5,11,1,15,11,5,2
"3187",2946,2947,2947,"white","age.gp4","NoTr","NoTrade","Group",10,2,2,2,4,1,9,0,2,8,1,9,6,4,2
"3188",34,35,35,"black","age.gp4","NoTr","Trade","NoGroup",2,1,0,0,1,0,2,0,1,1,0,2,1,1,2
"3189",1060,1061,1061,"white","age.gp4","NoTr","NoTrade","Group",9,0,2,2,5,2,7,0,5,4,1,8,7,2,2
"3190",1722,1723,1723,"white","age.gp1","Tr","NoTrade","NoGroup",20,9,3,2,6,3,12,5,5,15,3,17,10,10,2
"3191",35,36,36,"black","age.gp4","NoTr","Trade","NoGroup",1,0,0,0,1,1,0,0,0,1,0,1,1,0,2
"3192",1358,1359,1359,"black","age.gp4","NoTr","NoTrade","Group",22,1,4,10,7,13,8,1,4,18,1,21,9,13,2
"3193",36,37,37,"black","age.gp4","NoTr","Trade","NoGroup",8,0,3,1,4,6,1,1,1,7,1,7,2,6,2
"3194",38,39,39,"black","age.gp4","NoTr","Trade","NoGroup",1,0,0,0,1,1,0,0,0,1,1,0,0,1,2
"3195",1046,1047,1047,"black","age.gp4","NoTr","NoTrade","NoGroup",8,0,1,1,6,6,2,0,1,7,2,6,4,4,2
"3196",1758,1759,1759,"black","age.gp4","NoTr","NoTrade","NoGroup",1,0,0,0,1,1,0,0,0,1,1,0,0,1,2
"3197",1814,1815,1815,"black","age.gp4","NoTr","NoTrade","NoGroup",6,0,1,1,4,4,1,1,1,5,1,5,2,4,2
"3198",2137,2138,2138,"other","age.gp2","NoTr","NoTrade","NoGroup",4,0,2,1,1,2,2,0,1,3,1,3,2,2,2
"3199",2341,2342,2342,"white","age.gp2","Tr","NoTrade","Group",18,1,13,2,2,3,14,1,8,10,4,14,9,9,2
"3200",2608,2609,2609,"black","age.gp2","NoTr","NoTrade","Group",25,2,10,7,6,9,12,4,9,16,2,23,8,17,2
"3201",2730,2731,2731,"black","age.gp3","NoTr","NoTrade","NoGroup",11,1,3,1,6,6,4,1,2,9,1,10,5,6,2
"3202",37,38,38,"black","age.gp4","NoTr","Trade","NoGroup",1,0,0,0,1,1,0,0,0,1,0,1,0,1,2
"3203",493,494,494,"black","age.gp4","NoTr","NoTrade","NoGroup",6,1,1,0,4,4,2,0,0,6,3,3,4,2,2
"3204",39,40,40,"black","age.gp4","NoTr","Trade","NoGroup",6,1,3,1,1,2,4,0,1,5,2,4,3,3,2
"3205",411,412,412,"white","age.gp2","Tr","Trade","Group",20,0,12,5,3,3,16,1,8,12,1,19,11,9,2
"3206",2124,2125,2125,"white","age.gp3","NoTr","NoTrade","Group",22,3,10,3,6,1,19,2,7,15,2,20,16,6,2
"3207",2184,2185,2185,"white","age.gp4","NoTr","NoTrade","NoGroup",4,0,1,0,3,1,2,1,2,2,1,3,2,2,2
"3208",2207,2208,2208,"black","age.gp2","NoTr","Trade","Group",18,4,6,4,4,6,12,0,7,11,2,16,9,9,2
"3209",40,41,41,"black","age.gp4","NoTr","Trade","NoGroup",1,0,1,0,0,1,0,0,0,1,0,1,1,0,2
"3210",2518,2519,2519,"black","age.gp2","NoTr","NoTrade","Group",20,1,10,5,4,9,9,2,6,14,4,16,10,10,2
"3211",41,42,42,"black","age.gp4","NoTr","Trade","NoGroup",1,0,0,0,1,0,1,0,1,0,0,1,1,0,2
"3212",2046,2047,2047,"white","age.gp4","Tr","NoTrade","Group",13,1,3,2,7,2,9,2,4,9,1,12,10,3,2
"3213",42,43,43,"black","age.gp4","NoTr","Trade","NoGroup",3,0,0,1,2,3,0,0,0,3,1,2,1,2,2
"3214",362,363,363,"black","age.gp4","NoTr","NoTrade","NoGroup",8,0,0,1,7,5,3,0,2,6,1,7,4,4,2
"3215",523,524,524,"black","age.gp3","NoTr","NoTrade","NoGroup",5,0,1,3,1,4,1,0,1,4,1,4,4,1,2
"3216",2223,2224,2224,"black","age.gp4","NoTr","Trade","Group",9,0,2,2,5,4,5,0,4,5,1,8,3,6,2
"3217",43,44,44,"black","age.gp4","NoTr","Trade","NoGroup",1,0,0,0,1,0,1,0,0,1,0,1,1,0,2
"3218",60,61,61,"white","age.gp4","NoTr","NoTrade","Group",14,1,4,1,8,3,10,1,4,10,1,13,7,7,2
"3219",44,45,45,"black","age.gp4","NoTr","Trade","NoGroup",3,0,0,1,2,2,1,0,0,3,2,1,2,1,2
"3220",882,883,883,"white","age.gp3","NoTr","Trade","Group",10,0,3,3,4,1,9,0,3,7,3,7,6,4,2
"3221",2213,2214,2214,"black","age.gp4","NoTr","Trade","Group",14,0,5,3,6,7,6,1,1,13,3,11,6,8,2
"3222",45,46,46,"black","age.gp4","NoTr","Trade","NoGroup",1,1,0,0,0,0,0,1,0,1,0,1,1,0,2
"3223",1875,1876,1876,"other","age.gp1","NoTr","NoTrade","Group",6,1,2,0,3,1,5,0,5,1,1,5,2,4,2
"3224",46,47,47,"black","age.gp4","NoTr","Trade","NoGroup",11,2,1,2,6,5,5,1,5,6,2,9,7,4,2
"3225",243,244,244,"white","age.gp2","Tr","NoTrade","Group",24,4,12,3,5,2,21,1,9,15,4,20,12,12,2
"3226",517,518,518,"black","age.gp3","NoTr","NoTrade","NoGroup",8,2,2,1,3,5,1,2,1,7,1,7,1,7,2
"3227",899,900,900,"other","age.gp1","Tr","NoTrade","NoGroup",3,0,1,0,2,1,2,0,1,2,1,2,2,1,2
"3228",1231,1232,1232,"white","age.gp4","NoTr","NoTrade","NoGroup",9,0,1,1,7,2,7,0,4,5,2,7,7,2,2
"3229",1361,1362,1362,"black","age.gp4","NoTr","NoTrade","Group",6,1,0,1,4,3,3,0,1,5,2,4,4,2,2
"3230",1520,1521,1521,"black","age.gp4","NoTr","NoTrade","NoGroup",7,1,0,2,4,6,1,0,1,6,2,5,1,6,2
"3231",1669,1670,1670,"black","age.gp1","Tr","Trade","Group",12,7,1,2,2,6,4,2,4,8,4,8,4,8,2
"3232",1789,1790,1790,"white","age.gp4","Tr","NoTrade","Group",11,2,3,1,5,1,10,0,3,8,1,10,3,8,2
"3233",2123,2124,2124,"white","age.gp3","NoTr","NoTrade","Group",19,2,5,7,5,3,15,1,8,11,4,15,10,9,2
"3234",2253,2254,2254,"white","age.gp4","Tr","NoTrade","Group",16,1,1,2,12,2,13,1,5,11,1,15,10,6,2
"3235",47,48,48,"black","age.gp4","NoTr","Trade","NoGroup",2,1,0,0,1,1,1,0,0,2,0,2,0,2,2
"3236",714,715,715,"black","age.gp4","NoTr","NoTrade","NoGroup",9,0,4,2,3,3,4,2,5,4,1,8,4,5,2
"3237",1625,1626,1626,"white","age.gp1","NoTr","NoTrade","NoGroup",12,4,4,2,2,3,8,1,6,6,2,10,7,5,2
"3238",48,49,49,"black","age.gp4","NoTr","Trade","NoGroup",3,0,2,1,0,1,2,0,0,3,0,3,2,1,2
"3239",921,922,922,"white","age.gp2","NoTr","NoTrade","NoGroup",8,1,2,3,2,2,6,0,1,7,1,7,2,6,2
"3240",1553,1554,1554,"white","age.gp3","NoTr","NoTrade","Group",15,0,7,3,5,2,12,1,4,11,1,14,8,7,2
"3241",49,50,50,"white","age.gp2","Tr","NoTrade","Group",29,4,12,8,5,2,26,1,8,21,3,26,21,8,2
"3242",57,58,58,"black","age.gp2","NoTr","NoTrade","NoGroup",10,0,6,3,1,5,4,1,5,5,2,8,7,3,2
"3243",99,100,100,"white","age.gp3","NoTr","NoTrade","Group",10,2,3,4,1,1,8,1,2,8,0,10,7,3,2
"3244",156,157,157,"white","age.gp1","NoTr","NoTrade","Group",25,13,4,5,3,1,20,4,5,20,3,22,12,13,2
"3245",820,821,821,"white","age.gp4","NoTr","NoTrade","NoGroup",5,0,2,0,3,1,3,1,4,1,0,5,4,1,2
"3246",867,868,868,"other","age.gp2","Tr","NoTrade","Group",15,0,3,7,5,2,13,0,3,12,2,13,10,5,2
"3247",1022,1023,1023,"white","age.gp2","NoTr","Trade","Group",19,0,7,10,2,1,16,2,7,12,0,19,10,9,2
"3248",1097,1098,1098,"white","age.gp2","NoTr","NoTrade","Group",36,1,19,10,6,2,32,2,23,13,1,35,25,11,2
"3249",1136,1137,1137,"white","age.gp2","Tr","NoTrade","Group",22,1,12,4,5,1,19,2,7,15,1,21,16,6,2
"3250",1257,1258,1258,"white","age.gp1","Tr","Trade","Group",26,11,6,5,4,3,17,6,6,20,2,24,15,11,2
"3251",1301,1302,1302,"white","age.gp4","NoTr","NoTrade","Group",12,1,4,3,4,2,10,0,4,8,1,11,8,4,2
"3252",1327,1328,1328,"white","age.gp3","NoTr","NoTrade","NoGroup",11,2,5,2,2,1,10,0,6,5,1,10,9,2,2
"3253",1442,1443,1443,"white","age.gp3","Tr","NoTrade","NoGroup",15,2,8,1,4,0,13,2,5,10,1,14,10,5,2
"3254",1468,1469,1469,"white","age.gp2","NoTr","Trade","Group",14,2,7,3,2,1,12,1,8,6,2,12,10,4,2
"3255",1618,1619,1619,"white","age.gp2","Tr","NoTrade","Group",25,3,10,6,6,3,21,1,9,16,1,24,17,8,2
"3256",1623,1624,1624,"white","age.gp1","NoTr","NoTrade","NoGroup",15,5,3,5,2,1,11,3,3,12,2,13,11,4,2
"3257",1804,1805,1805,"white","age.gp2","Tr","NoTrade","Group",26,3,12,7,4,1,21,4,11,15,0,26,16,10,2
"3258",1863,1864,1864,"white","age.gp3","NoTr","NoTrade","Group",14,4,5,2,3,0,14,0,6,8,1,13,7,7,2
"3259",2073,2074,2074,"white","age.gp3","Tr","NoTrade","Group",18,0,6,7,5,1,16,1,6,12,0,18,15,3,2
"3260",2169,2170,2170,"white","age.gp2","NoTr","NoTrade","Group",27,3,13,4,7,5,20,2,9,18,2,25,16,11,2
"3261",2172,2173,2173,"white","age.gp2","NoTr","NoTrade","Group",24,2,11,10,1,3,18,3,10,14,0,24,18,6,2
"3262",2311,2312,2312,"white","age.gp2","Tr","NoTrade","NoGroup",12,1,8,1,2,1,7,4,5,7,1,11,6,6,2
"3263",2526,2527,2527,"white","age.gp2","NoTr","NoTrade","Group",26,3,13,3,7,2,22,2,13,13,3,23,18,8,2
"3264",2586,2587,2587,"white","age.gp4","NoTr","NoTrade","Group",12,0,1,1,10,1,11,0,1,11,1,11,9,3,2
"3265",2593,2594,2594,"white","age.gp3","NoTr","NoTrade","Group",19,1,11,2,5,1,16,2,12,7,0,19,14,5,2
"3266",2689,2690,2690,"black","age.gp3","NoTr","NoTrade","NoGroup",12,1,3,2,6,7,2,3,2,10,2,10,6,6,2
"3267",2698,2699,2699,"white","age.gp4","NoTr","NoTrade","Group",12,1,3,2,6,2,10,0,4,8,1,11,6,6,2
"3268",2749,2750,2750,"white","age.gp3","NoTr","NoTrade","NoGroup",9,2,4,0,3,0,7,2,5,4,2,7,9,0,2
"3269",2884,2885,2885,"white","age.gp1","NoTr","NoTrade","Group",16,5,5,1,5,1,11,4,6,10,1,15,9,7,2
"3270",50,51,51,"white","age.gp2","Tr","NoTrade","Group",18,2,6,6,4,2,14,2,7,11,3,15,15,3,2
"3271",80,81,81,"white","age.gp4","NoTr","NoTrade","Group",10,1,2,1,6,0,9,1,5,5,0,10,7,3,2
"3272",95,96,96,"white","age.gp3","NoTr","NoTrade","Group",18,3,8,2,5,2,16,0,8,10,1,17,11,7,2
"3273",281,282,282,"white","age.gp2","Tr","NoTrade","Group",21,1,11,6,3,0,19,2,6,15,2,19,14,7,2
"3274",328,329,329,"white","age.gp1","NoTr","NoTrade","NoGroup",3,1,2,0,0,0,3,0,1,2,0,3,2,1,2
"3275",1286,1287,1287,"white","age.gp4","NoTr","NoTrade","Group",14,0,4,3,7,1,11,2,3,11,1,13,5,9,2
"3276",1421,1422,1422,"white","age.gp2","NoTr","NoTrade","Group",19,4,8,5,2,0,17,2,8,11,5,14,14,5,2
"3277",1430,1431,1431,"white","age.gp3","Tr","NoTrade","NoGroup",12,1,7,2,2,0,11,1,5,7,0,12,10,2,2
"3278",1467,1468,1468,"white","age.gp2","NoTr","Trade","Group",23,3,11,4,5,1,18,4,10,13,0,23,15,8,2
"3279",1588,1589,1589,"white","age.gp4","Tr","NoTrade","Group",6,1,3,1,1,0,5,1,2,4,2,4,4,2,2
"3280",2301,2302,2302,"other","age.gp2","Tr","NoTrade","Group",11,1,5,3,2,0,11,0,4,7,2,9,9,2,2
"3281",2338,2339,2339,"white","age.gp3","Tr","NoTrade","Group",20,1,9,7,3,2,16,2,9,11,1,19,16,4,2
"3282",2739,2740,2740,"white","age.gp2","Tr","NoTrade","Group",24,1,18,3,2,2,16,6,8,16,2,22,14,10,2
"3283",2855,2856,2856,"black","age.gp3","NoTr","NoTrade","Group",19,1,7,5,6,10,8,1,4,15,0,19,11,8,2
"3284",2913,2914,2914,"other","age.gp1","NoTr","NoTrade","NoGroup",7,3,2,2,0,1,5,1,2,5,2,5,3,4,2
"3285",51,52,52,"white","age.gp2","Tr","NoTrade","Group",27,2,16,4,5,1,20,6,12,15,2,25,16,11,2
"3286",140,141,141,"white","age.gp2","NoTr","NoTrade","NoGroup",10,0,8,1,1,1,7,2,4,6,2,8,7,3,2
"3287",234,235,235,"white","age.gp2","Tr","NoTrade","Group",25,3,14,5,3,1,20,4,12,13,2,23,19,6,2
"3288",242,243,243,"white","age.gp2","Tr","NoTrade","Group",28,3,9,8,8,4,21,3,8,20,2,26,17,11,2
"3289",246,247,247,"white","age.gp2","Tr","NoTrade","Group",19,2,9,5,3,0,15,4,11,8,2,17,12,7,2
"3290",344,345,345,"white","age.gp2","NoTr","NoTrade","Group",30,3,13,11,3,2,26,2,16,14,2,28,19,11,2
"3291",445,446,446,"black","age.gp3","NoTr","NoTrade","NoGroup",10,0,4,3,3,7,3,0,3,7,1,9,4,6,2
"3292",663,664,664,"white","age.gp2","NoTr","NoTrade","Group",30,4,12,7,7,4,22,4,10,20,2,28,20,10,2
"3293",841,842,842,"white","age.gp2","Tr","NoTrade","NoGroup",12,0,7,4,1,0,12,0,5,7,0,12,10,2,2
"3294",847,848,848,"other","age.gp2","Tr","NoTrade","Group",13,1,5,1,6,1,12,0,5,8,1,12,8,5,2
"3295",873,874,874,"white","age.gp3","NoTr","Trade","Group",19,2,9,4,4,0,19,0,8,11,1,18,12,7,2
"3296",911,912,912,"other","age.gp1","Tr","NoTrade","NoGroup",5,0,2,3,0,0,5,0,3,2,0,5,4,1,2
"3297",1098,1099,1099,"white","age.gp2","NoTr","NoTrade","Group",19,4,10,2,3,2,15,2,10,9,0,19,13,6,2
"3298",1226,1227,1227,"white","age.gp4","NoTr","NoTrade","NoGroup",6,0,2,0,4,0,6,0,4,2,1,5,3,3,2
"3299",1562,1563,1563,"white","age.gp4","Tr","NoTrade","Group",8,2,3,1,2,1,5,2,4,4,0,8,4,4,2
"3300",1731,1732,1732,"white","age.gp3","Tr","NoTrade","Group",24,2,12,4,6,2,21,1,10,14,3,21,18,6,2
"3301",1907,1908,1908,"other","age.gp2","NoTr","NoTrade","NoGroup",4,1,2,1,0,1,3,0,1,3,0,4,3,1,2
"3302",2029,2030,2030,"white","age.gp4","Tr","NoTrade","Group",10,1,4,0,5,1,9,0,3,7,0,10,7,3,2
"3303",2058,2059,2059,"white","age.gp4","Tr","NoTrade","Group",16,1,4,2,9,1,14,1,7,9,2,14,11,5,2
"3304",2290,2291,2291,"other","age.gp2","Tr","NoTrade","Group",13,0,8,3,2,0,13,0,8,5,0,13,11,2,2
"3305",2305,2306,2306,"white","age.gp2","NoTr","NoTrade","NoGroup",12,0,5,5,2,1,10,1,4,8,1,11,10,2,2
"3306",2416,2417,2417,"white","age.gp3","NoTr","Trade","Group",24,4,6,8,6,0,23,1,8,16,2,22,16,8,2
"3307",2645,2646,2646,"white","age.gp1","NoTr","NoTrade","NoGroup",8,6,1,1,0,0,8,0,2,6,1,7,4,4,2
"3308",2658,2659,2659,"white","age.gp2","NoTr","NoTrade","Group",24,1,14,6,3,2,20,2,13,11,1,23,16,8,2
"3309",2809,2810,2810,"other","age.gp2","NoTr","NoTrade","NoGroup",3,0,2,0,1,0,3,0,3,0,0,3,3,0,2
"3310",2819,2820,2820,"other","age.gp2","NoTr","NoTrade","NoGroup",6,0,4,2,0,0,6,0,3,3,0,6,5,1,2
"3311",2879,2880,2880,"white","age.gp2","NoTr","NoTrade","NoGroup",14,0,10,3,1,2,11,1,10,4,1,13,13,1,2
"3312",52,53,53,"white","age.gp2","Tr","NoTrade","Group",20,1,7,7,5,2,16,2,7,13,4,16,16,4,2
"3313",470,471,471,"black","age.gp3","NoTr","Trade","Group",18,0,6,5,7,10,7,1,6,12,1,17,12,6,2
"3314",711,712,712,"white","age.gp2","Tr","NoTrade","Group",17,1,7,8,1,2,14,1,7,10,3,14,10,7,2
"3315",768,769,769,"white","age.gp4","NoTr","NoTrade","NoGroup",8,0,3,1,4,1,7,0,1,7,1,7,7,1,2
"3316",857,858,858,"other","age.gp2","Tr","NoTrade","Group",10,0,7,1,2,2,8,0,4,6,1,9,4,6,2
"3317",941,942,942,"white","age.gp3","Tr","NoTrade","Group",20,2,7,6,5,1,18,1,4,16,2,18,16,4,2
"3318",1383,1384,1384,"white","age.gp1","NoTr","NoTrade","NoGroup",15,10,4,1,0,2,11,2,7,8,2,13,6,9,2
"3319",1547,1548,1548,"white","age.gp3","NoTr","NoTrade","Group",22,4,8,7,3,3,18,1,12,10,4,18,14,8,2
"3320",1717,1718,1718,"white","age.gp2","NoTr","NoTrade","Group",21,1,9,8,3,1,20,0,8,13,0,21,15,6,2
"3321",1918,1919,1919,"other","age.gp2","NoTr","NoTrade","NoGroup",6,0,3,0,3,0,6,0,3,3,0,6,4,2,2
"3322",1948,1949,1949,"white","age.gp4","NoTr","NoTrade","Group",14,1,3,2,8,1,12,1,3,11,1,13,11,3,2
"3323",2162,2163,2163,"white","age.gp2","Tr","NoTrade","NoGroup",12,2,8,1,1,2,9,1,4,8,1,11,6,6,2
"3324",2208,2209,2209,"black","age.gp2","NoTr","Trade","Group",10,0,6,1,3,7,3,0,2,8,0,10,6,4,2
"3325",2247,2248,2248,"white","age.gp4","Tr","NoTrade","Group",7,0,2,1,4,1,6,0,2,5,0,7,5,2,2
"3326",2331,2332,2332,"white","age.gp3","Tr","NoTrade","Group",23,2,7,8,6,6,15,2,12,11,3,20,15,8,2
"3327",2596,2597,2597,"white","age.gp3","NoTr","NoTrade","Group",18,0,8,6,4,2,16,0,8,10,3,15,16,2,2
"3328",2696,2697,2697,"white","age.gp4","NoTr","NoTrade","Group",10,0,5,1,4,4,5,1,5,5,0,10,7,3,2
"3329",2716,2717,2717,"white","age.gp4","NoTr","NoTrade","Group",13,2,2,3,6,2,10,1,5,8,1,12,11,2,2
"3330",244,245,245,"white","age.gp2","Tr","NoTrade","Group",23,1,8,9,5,3,17,3,8,15,2,21,18,5,2
"3331",280,281,281,"white","age.gp2","Tr","NoTrade","Group",27,2,12,8,5,3,23,1,13,14,2,25,19,8,2
"3332",878,879,879,"white","age.gp3","NoTr","Trade","Group",15,0,8,3,4,1,12,2,8,7,0,15,11,4,2
"3333",881,882,882,"white","age.gp3","NoTr","Trade","Group",20,1,7,4,8,1,16,3,10,10,1,19,14,6,2
"3334",883,884,884,"white","age.gp3","NoTr","Trade","Group",19,1,8,5,5,0,18,1,11,8,0,19,15,4,2
"3335",926,927,927,"white","age.gp3","NoTr","NoTrade","NoGroup",6,1,3,1,1,1,4,1,4,2,0,6,5,1,2
"3336",1120,1121,1121,"other","age.gp1","NoTr","NoTrade","NoGroup",4,2,2,0,0,1,3,0,3,1,1,3,4,0,2
"3337",1135,1136,1136,"white","age.gp2","Tr","NoTrade","Group",36,3,16,10,7,7,25,4,15,21,3,33,21,15,2
"3338",1668,1669,1669,"black","age.gp1","Tr","Trade","Group",14,5,4,2,3,5,8,1,3,11,1,13,4,10,2
"3339",1738,1739,1739,"white","age.gp3","Tr","NoTrade","Group",24,4,11,5,4,4,17,3,8,16,2,22,14,10,2
"3340",1740,1741,1741,"white","age.gp3","Tr","NoTrade","Group",19,2,11,4,2,1,15,3,11,8,1,18,13,6,2
"3341",2303,2304,2304,"other","age.gp2","Tr","NoTrade","Group",10,1,5,1,3,2,8,0,6,4,0,10,7,3,2
"3342",2345,2346,2346,"black","age.gp2","NoTr","NoTrade","Group",14,1,5,6,2,9,5,0,4,10,1,13,7,7,2
"3343",2409,2410,2410,"white","age.gp3","NoTr","NoTrade","NoGroup",6,1,3,0,2,1,4,1,2,4,0,6,4,2,2
"3344",2520,2521,2521,"white","age.gp2","Tr","NoTrade","Group",30,3,15,7,5,2,24,4,13,17,2,28,19,11,2
"3345",2594,2595,2595,"white","age.gp3","NoTr","NoTrade","Group",11,0,4,2,5,1,9,1,4,7,0,11,4,7,2
"3346",2599,2600,2600,"white","age.gp3","NoTr","NoTrade","Group",25,1,14,4,6,4,19,2,10,15,0,25,18,7,2
"3347",2741,2742,2742,"white","age.gp2","Tr","NoTrade","Group",17,2,5,8,2,2,11,4,6,11,1,16,10,7,2
"3348",2797,2798,2798,"white","age.gp2","NoTr","NoTrade","NoGroup",7,1,5,1,0,0,5,2,5,2,0,7,4,3,2
"3349",2953,2954,2954,"white","age.gp2","Tr","NoTrade","Group",21,3,14,2,2,2,15,4,9,12,0,21,11,10,2
"3350",2972,2973,2973,"white","age.gp2","NoTr","NoTrade","Group",25,2,19,3,1,1,16,8,13,12,2,23,18,7,2
"3351",54,55,55,"black","age.gp2","NoTr","NoTrade","NoGroup",8,1,3,3,1,3,4,1,4,4,1,7,4,4,2
"3352",299,300,300,"white","age.gp4","NoTr","NoTrade","Group",13,0,4,1,8,1,10,2,3,10,0,13,7,6,2
"3353",833,834,834,"white","age.gp3","NoTr","NoTrade","NoGroup",8,0,3,2,3,1,7,0,2,6,1,7,6,2,2
"3354",963,964,964,"black","age.gp2","NoTr","NoTrade","Group",18,5,5,2,6,9,5,4,4,14,2,16,10,8,2
"3355",1432,1433,1433,"white","age.gp3","Tr","NoTrade","NoGroup",10,2,1,2,5,1,8,1,2,8,0,10,5,5,2
"3356",2160,2161,2161,"white","age.gp2","Tr","NoTrade","NoGroup",17,1,11,2,3,3,11,3,4,13,1,16,10,7,2
"3357",2283,2284,2284,"other","age.gp2","Tr","NoTrade","Group",10,0,7,0,3,1,9,0,4,6,2,8,7,3,2
"3358",2679,2680,2680,"black","age.gp3","NoTr","NoTrade","NoGroup",6,1,3,2,0,3,1,2,2,4,1,5,4,2,2
"3359",55,56,56,"black","age.gp2","NoTr","NoTrade","NoGroup",14,1,6,6,1,5,8,1,4,10,2,12,10,4,2
"3360",115,116,116,"white","age.gp3","NoTr","NoTrade","NoGroup",5,0,1,1,3,1,4,0,2,3,1,4,4,1,2
"3361",247,248,248,"white","age.gp2","Tr","NoTrade","Group",27,3,16,4,4,3,20,4,12,15,3,24,19,8,2
"3362",336,337,337,"white","age.gp2","Tr","NoTrade","NoGroup",14,0,8,5,1,1,11,2,5,9,2,12,10,4,2
"3363",473,474,474,"black","age.gp3","NoTr","Trade","Group",12,1,4,6,1,6,5,1,2,10,0,12,6,6,2
"3364",637,638,638,"other","age.gp1","NoTr","Trade","Group",7,4,2,1,0,2,5,0,2,5,1,6,4,3,2
"3365",1556,1557,1557,"white","age.gp3","NoTr","NoTrade","Group",14,2,4,5,3,1,13,0,5,9,1,13,12,2,2
"3366",2387,2388,2388,"white","age.gp2","Tr","NoTrade","Group",18,1,10,3,4,1,15,2,5,13,2,16,13,5,2
"3367",2705,2706,2706,"white","age.gp4","NoTr","NoTrade","Group",12,1,2,3,6,2,9,1,4,8,0,12,9,3,2
"3368",2958,2959,2959,"white","age.gp2","NoTr","NoTrade","Group",24,4,13,3,4,1,22,1,16,8,2,22,17,7,2
"3369",56,57,57,"black","age.gp2","NoTr","NoTrade","NoGroup",5,1,1,2,1,3,2,0,1,4,0,5,1,4,2
"3370",225,226,226,"black","age.gp2","NoTr","NoTrade","NoGroup",6,0,4,0,2,6,0,0,0,6,0,6,2,4,2
"3371",402,403,403,"black","age.gp4","NoTr","NoTrade","NoGroup",7,3,2,2,0,4,2,1,1,6,2,5,4,3,2
"3372",955,956,956,"white","age.gp3","Tr","NoTrade","Group",21,4,7,5,5,1,18,2,7,14,0,21,13,8,2
"3373",1261,1262,1262,"black","age.gp3","NoTr","NoTrade","NoGroup",9,2,2,3,2,5,4,0,3,6,2,7,4,5,2
"3374",1630,1631,1631,"white","age.gp1","NoTr","NoTrade","NoGroup",11,4,4,2,1,1,7,3,4,7,0,11,6,5,2
"3375",864,865,865,"other","age.gp2","Tr","NoTrade","Group",12,0,3,5,4,3,9,0,4,8,1,11,7,5,2
"3376",1386,1387,1387,"black","age.gp3","NoTr","NoTrade","NoGroup",10,1,4,4,1,9,1,0,1,9,2,8,5,5,2
"3377",2039,2040,2040,"white","age.gp4","Tr","NoTrade","Group",11,0,2,0,9,3,8,0,4,7,1,10,5,6,2
"3378",2365,2366,2366,"black","age.gp2","Tr","NoTrade","Group",21,0,7,9,5,10,10,1,7,14,1,20,10,11,2
"3379",2366,2367,2367,"black","age.gp2","Tr","NoTrade","Group",16,2,7,5,2,8,7,1,5,11,0,16,8,8,2
"3380",2408,2409,2409,"white","age.gp3","NoTr","NoTrade","NoGroup",5,1,2,1,1,1,3,1,4,1,0,5,3,2,2
"3381",58,59,59,"black","age.gp2","NoTr","NoTrade","NoGroup",7,0,3,1,3,7,0,0,1,6,1,6,5,2,2
"3382",350,351,351,"black","age.gp4","NoTr","NoTrade","NoGroup",4,0,1,1,2,3,1,0,0,4,1,3,3,1,2
"3383",453,454,454,"black","age.gp3","NoTr","NoTrade","NoGroup",10,0,3,5,2,8,1,1,0,10,1,9,2,8,2
"3384",1368,1369,1369,"black","age.gp4","NoTr","NoTrade","Group",6,1,1,2,2,2,3,1,0,6,1,5,4,2,2
"3385",2236,2237,2237,"black","age.gp4","NoTr","Trade","Group",5,0,1,1,3,2,3,0,0,5,0,5,2,3,2
"3386",2349,2350,2350,"black","age.gp2","NoTr","NoTrade","Group",23,1,12,6,4,13,9,1,5,18,1,22,13,10,2
"3387",59,60,60,"white","age.gp4","NoTr","NoTrade","Group",14,1,2,2,9,1,13,0,3,11,1,13,8,6,2
"3388",62,63,63,"white","age.gp4","NoTr","NoTrade","Group",14,0,0,4,10,3,11,0,1,13,3,11,9,5,2
"3389",692,693,693,"white","age.gp4","Tr","NoTrade","Group",21,0,1,5,15,1,20,0,10,11,0,21,15,6,2
"3390",721,722,722,"black","age.gp4","NoTr","NoTrade","NoGroup",5,1,1,0,3,1,4,0,1,4,0,5,3,2,2
"3391",1295,1296,1296,"white","age.gp4","NoTr","NoTrade","Group",8,1,4,1,2,1,5,2,2,6,0,8,5,3,2
"3392",1300,1301,1301,"white","age.gp4","NoTr","NoTrade","Group",10,0,2,0,8,2,8,0,3,7,2,8,9,1,2
"3393",2041,2042,2042,"white","age.gp4","Tr","NoTrade","Group",13,0,5,3,5,1,12,0,5,8,0,13,9,4,2
"3394",2318,2319,2319,"white","age.gp2","NoTr","NoTrade","NoGroup",12,1,4,4,3,0,12,0,8,4,1,11,9,3,2
"3395",2592,2593,2593,"white","age.gp3","NoTr","NoTrade","Group",25,3,11,3,8,0,24,1,12,13,3,22,18,7,2
"3396",2613,2614,2614,"white","age.gp4","NoTr","NoTrade","NoGroup",3,0,0,0,3,1,2,0,0,3,0,3,2,1,2
"3397",2614,2615,2615,"white","age.gp4","NoTr","NoTrade","NoGroup",4,0,2,0,2,0,4,0,1,3,1,3,4,0,2
"3398",2869,2870,2870,"white","age.gp1","NoTr","NoTrade","Group",28,21,2,2,3,3,18,7,5,23,4,24,15,13,2
"3399",70,71,71,"white","age.gp4","NoTr","NoTrade","Group",7,0,1,3,3,1,6,0,3,4,1,6,6,1,2
"3400",75,76,76,"white","age.gp4","NoTr","NoTrade","Group",10,1,3,1,5,0,9,1,5,5,0,10,7,3,2
"3401",82,83,83,"white","age.gp4","NoTr","NoTrade","Group",12,0,1,0,11,0,12,0,3,9,0,12,9,3,2
"3402",107,108,108,"white","age.gp2","NoTr","NoTrade","NoGroup",13,2,5,2,4,0,13,0,6,7,0,13,9,4,2
"3403",670,671,671,"white","age.gp4","Tr","NoTrade","Group",12,0,3,0,9,1,11,0,4,8,1,11,8,4,2
"3404",742,743,743,"white","age.gp2","Tr","NoTrade","Group",24,2,11,3,8,3,18,3,10,14,2,22,15,9,2
"3405",1125,1126,1126,"other","age.gp1","NoTr","NoTrade","NoGroup",5,0,2,0,3,0,5,0,3,2,0,5,5,0,2
"3406",1167,1168,1168,"white","age.gp4","NoTr","NoTrade","NoGroup",6,0,1,2,3,1,5,0,2,4,1,5,5,1,2
"3407",1271,1272,1272,"black","age.gp3","NoTr","NoTrade","NoGroup",9,0,4,2,3,2,7,0,2,7,0,9,9,0,2
"3408",1673,1674,1674,"white","age.gp2","Tr","NoTrade","NoGroup",7,0,4,1,2,1,5,1,3,4,1,6,5,2,2
"3409",2028,2029,2029,"white","age.gp4","Tr","NoTrade","Group",15,1,3,2,9,1,14,0,4,11,0,15,9,6,2
"3410",2509,2510,2510,"black","age.gp2","NoTr","NoTrade","NoGroup",10,0,7,1,2,5,5,0,3,7,0,10,5,5,2
"3411",2579,2580,2580,"white","age.gp4","NoTr","NoTrade","Group",10,4,0,1,5,2,7,1,2,8,1,9,5,5,2
"3412",61,62,62,"white","age.gp4","NoTr","NoTrade","Group",13,1,4,1,7,1,12,0,2,11,1,12,11,2,2
"3413",312,313,313,"white","age.gp4","NoTr","NoTrade","Group",7,0,1,3,3,0,6,1,4,3,0,7,4,3,2
"3414",313,314,314,"white","age.gp4","NoTr","NoTrade","Group",10,0,3,2,5,0,10,0,5,5,0,10,9,1,2
"3415",321,322,322,"white","age.gp4","NoTr","NoTrade","Group",3,0,1,0,2,0,3,0,1,2,0,3,2,1,2
"3416",1304,1305,1305,"white","age.gp4","NoTr","NoTrade","Group",10,1,1,2,6,0,10,0,3,7,1,9,8,2,2
"3417",1933,1934,1934,"white","age.gp4","NoTr","NoTrade","Group",10,2,3,2,3,0,10,0,3,7,0,10,5,5,2
"3418",1958,1959,1959,"white","age.gp4","NoTr","NoTrade","Group",13,0,4,0,9,1,12,0,11,2,1,12,11,2,2
"3419",2454,2455,2455,"white","age.gp4","NoTr","NoTrade","NoGroup",3,0,1,0,2,0,3,0,0,3,0,3,2,1,2
"3420",2473,2474,2474,"white","age.gp2","Tr","NoTrade","Group",20,6,10,1,3,1,15,4,7,13,2,18,8,12,2
"3421",2790,2791,2791,"white","age.gp2","NoTr","NoTrade","Group",17,1,10,4,2,0,17,0,9,8,2,15,12,5,2
"3422",2843,2844,2844,"white","age.gp2","Tr","NoTrade","Group",25,2,12,6,5,2,22,1,11,14,2,23,17,8,2
"3423",2977,2978,2978,"white","age.gp1","NoTr","NoTrade","Group",25,13,3,5,4,2,19,4,7,18,0,25,16,9,2
"3424",314,315,315,"white","age.gp4","NoTr","NoTrade","Group",11,0,3,2,6,2,9,0,4,7,2,9,7,4,2
"3425",874,875,875,"white","age.gp3","NoTr","Trade","Group",12,2,6,0,4,0,11,1,5,7,1,11,6,6,2
"3426",1262,1263,1263,"black","age.gp3","NoTr","NoTrade","NoGroup",9,0,3,3,3,5,4,0,2,7,1,8,8,1,2
"3427",1292,1293,1293,"white","age.gp4","NoTr","NoTrade","Group",16,2,1,2,11,1,14,1,5,11,1,15,8,8,2
"3428",1499,1500,1500,"white","age.gp4","NoTr","NoTrade","NoGroup",3,0,1,0,2,0,3,0,1,2,0,3,3,0,2
"3429",1510,1511,1511,"white","age.gp4","NoTr","NoTrade","NoGroup",4,0,0,0,4,0,4,0,2,2,0,4,4,0,2
"3430",1534,1535,1535,"black","age.gp4","NoTr","NoTrade","NoGroup",1,0,0,0,1,0,1,0,0,1,0,1,1,0,2
"3431",2250,2251,2251,"white","age.gp4","Tr","NoTrade","Group",10,0,6,1,3,0,10,0,4,6,0,10,6,4,2
"3432",2675,2676,2676,"white","age.gp3","NoTr","NoTrade","NoGroup",11,0,1,7,3,1,10,0,5,6,2,9,8,3,2
"3433",63,64,64,"white","age.gp4","NoTr","NoTrade","Group",16,1,5,5,5,2,12,2,7,9,3,13,13,3,2
"3434",166,167,167,"white","age.gp3","NoTr","NoTrade","NoGroup",11,3,1,4,3,2,9,0,2,9,2,9,6,5,2
"3435",300,301,301,"white","age.gp4","NoTr","NoTrade","Group",17,1,5,2,9,2,15,0,9,8,0,17,12,5,2
"3436",1019,1020,1020,"white","age.gp2","NoTr","Trade","Group",20,0,10,6,4,4,15,1,8,12,0,20,11,9,2
"3437",1078,1079,1079,"white","age.gp4","NoTr","NoTrade","Group",14,5,3,2,4,3,11,0,3,11,0,14,7,7,2
"3438",1323,1324,1324,"white","age.gp2","Tr","NoTrade","Group",16,1,10,3,2,1,13,2,7,9,2,14,14,2,2
"3439",2070,2071,2071,"white","age.gp3","Tr","NoTrade","Group",21,1,8,8,4,2,19,0,5,16,5,16,16,5,2
"3440",2246,2247,2247,"white","age.gp4","Tr","NoTrade","Group",12,0,1,5,6,1,11,0,2,10,1,11,9,3,2
"3441",2282,2283,2283,"other","age.gp2","Tr","NoTrade","Group",14,1,5,3,5,2,12,0,8,6,2,12,10,4,2
"3442",2480,2481,2481,"other","age.gp1","NoTr","NoTrade","NoGroup",7,4,0,2,1,1,5,1,1,6,2,5,3,4,2
"3443",2575,2576,2576,"white","age.gp4","NoTr","NoTrade","Group",8,1,2,0,5,0,8,0,4,4,0,8,6,2,2
"3444",2673,2674,2674,"white","age.gp3","NoTr","NoTrade","NoGroup",5,0,3,0,2,0,5,0,3,2,0,5,5,0,2
"3445",64,65,65,"white","age.gp4","NoTr","NoTrade","Group",14,0,4,6,4,3,10,1,4,10,0,14,8,6,2
"3446",163,164,164,"white","age.gp3","NoTr","NoTrade","NoGroup",12,2,7,2,1,1,7,4,6,6,1,11,8,4,2
"3447",764,765,765,"white","age.gp4","NoTr","NoTrade","NoGroup",8,0,3,0,5,0,8,0,2,6,0,8,5,3,2
"3448",949,950,950,"white","age.gp3","Tr","NoTrade","Group",18,1,4,7,6,0,18,0,10,8,1,17,13,5,2
"3449",1072,1073,1073,"white","age.gp4","NoTr","NoTrade","Group",8,1,2,0,5,0,6,2,3,5,0,8,5,3,2
"3450",1549,1550,1550,"white","age.gp3","NoTr","NoTrade","Group",23,3,8,10,2,1,20,2,11,12,2,21,16,7,2
"3451",1848,1849,1849,"black","age.gp3","NoTr","NoTrade","NoGroup",10,5,2,1,2,3,6,1,3,7,1,9,5,5,2
"3452",1954,1955,1955,"white","age.gp4","NoTr","NoTrade","Group",14,1,2,3,8,2,12,0,6,8,1,13,8,6,2
"3453",2602,2603,2603,"white","age.gp3","NoTr","NoTrade","Group",14,1,4,5,4,1,13,0,4,10,2,12,11,3,2
"3454",2740,2741,2741,"white","age.gp2","Tr","NoTrade","Group",24,2,14,5,3,2,20,2,9,15,3,21,15,9,2
"3455",2815,2816,2816,"other","age.gp2","NoTr","NoTrade","NoGroup",4,1,1,0,2,0,4,0,1,3,0,4,2,2,2
"3456",65,66,66,"white","age.gp4","NoTr","NoTrade","Group",13,3,2,3,5,1,11,1,5,8,0,13,11,2,2
"3457",231,232,232,"white","age.gp2","Tr","NoTrade","Group",16,0,9,4,3,0,14,2,4,12,0,16,11,5,2
"3458",1727,1728,1728,"white","age.gp3","Tr","NoTrade","Group",9,1,5,0,3,0,8,1,3,6,0,9,5,4,2
"3459",1798,1799,1799,"white","age.gp4","Tr","NoTrade","Group",14,0,4,2,8,0,13,1,4,10,0,14,13,1,2
"3460",1946,1947,1947,"white","age.gp4","NoTr","NoTrade","Group",14,0,4,1,9,3,11,0,3,11,1,13,10,4,2
"3461",2051,2052,2052,"white","age.gp4","Tr","NoTrade","Group",10,0,0,3,7,1,9,0,5,5,0,10,6,4,2
"3462",2710,2711,2711,"white","age.gp4","NoTr","NoTrade","Group",6,0,1,1,4,0,6,0,2,4,0,6,4,2,2
"3463",2713,2714,2714,"white","age.gp4","NoTr","NoTrade","Group",6,2,0,2,2,1,5,0,1,5,0,6,3,3,2
"3464",2780,2781,2781,"white","age.gp3","NoTr","NoTrade","Group",23,1,6,5,11,1,17,5,11,12,0,23,17,6,2
"3465",66,67,67,"white","age.gp4","NoTr","NoTrade","Group",10,0,3,2,5,4,5,1,3,7,1,9,4,6,2
"3466",395,396,396,"black","age.gp4","NoTr","NoTrade","NoGroup",3,0,0,1,2,1,2,0,0,3,0,3,2,1,2
"3467",524,525,525,"black","age.gp3","NoTr","NoTrade","NoGroup",10,3,1,1,5,4,5,1,0,10,1,9,6,4,2
"3468",842,843,843,"white","age.gp2","Tr","NoTrade","NoGroup",8,0,2,4,2,1,7,0,2,6,1,7,6,2,2
"3469",1002,1003,1003,"white","age.gp4","NoTr","NoTrade","NoGroup",5,0,0,1,4,0,5,0,1,4,0,5,4,1,2
"3470",1370,1371,1371,"black","age.gp4","NoTr","NoTrade","Group",13,0,1,2,10,6,7,0,3,10,1,12,10,3,2
"3471",1748,1749,1749,"black","age.gp4","NoTr","NoTrade","NoGroup",2,0,0,0,2,1,1,0,0,2,1,1,2,0,2
"3472",2037,2038,2038,"white","age.gp4","Tr","NoTrade","Group",15,1,6,2,6,1,13,1,4,11,3,12,11,4,2
"3473",2412,2413,2413,"white","age.gp3","NoTr","Trade","Group",15,1,5,6,3,5,9,1,4,11,1,14,10,5,2
"3474",2806,2807,2807,"other","age.gp2","NoTr","NoTrade","NoGroup",3,0,0,1,2,0,3,0,0,3,0,3,2,1,2
"3475",67,68,68,"white","age.gp4","NoTr","NoTrade","Group",8,1,2,1,4,0,8,0,4,4,1,7,7,1,2
"3476",228,229,229,"white","age.gp2","Tr","NoTrade","Group",33,2,11,13,7,3,28,2,10,23,1,32,25,8,2
"3477",461,462,462,"white","age.gp1","NoTr","NoTrade","NoGroup",19,11,2,2,4,1,12,6,5,14,3,16,11,8,2
"3478",1586,1587,1587,"white","age.gp4","Tr","NoTrade","Group",7,1,1,0,5,1,6,0,1,6,0,7,2,5,2
"3479",2243,2244,2244,"white","age.gp4","Tr","NoTrade","Group",13,2,2,2,7,2,8,3,2,11,1,12,7,6,2
"3480",2419,2420,2420,"white","age.gp3","NoTr","Trade","Group",24,3,8,6,7,0,22,2,9,15,6,18,17,7,2
"3481",2928,2929,2929,"white","age.gp4","NoTr","NoTrade","Group",15,0,3,1,11,1,11,3,4,11,0,15,11,4,2
"3482",2944,2945,2945,"white","age.gp4","NoTr","NoTrade","Group",14,0,5,2,7,2,11,1,7,7,1,13,11,3,2
"3483",68,69,69,"white","age.gp4","NoTr","NoTrade","Group",10,0,2,2,6,1,8,1,5,5,0,10,8,2,2
"3484",178,179,179,"white","age.gp3","Tr","NoTrade","NoGroup",8,1,3,1,3,0,7,1,4,4,3,5,8,0,2
"3485",296,297,297,"white","age.gp4","NoTr","NoTrade","Group",12,1,3,2,6,1,10,1,7,5,0,12,10,2,2
"3486",398,399,399,"black","age.gp4","NoTr","NoTrade","NoGroup",7,0,1,2,4,4,3,0,1,6,0,7,4,3,2
"3487",2260,2261,2261,"white","age.gp4","Tr","NoTrade","Group",11,1,2,2,6,1,9,1,3,8,1,10,7,4,2
"3488",2288,2289,2289,"other","age.gp2","Tr","NoTrade","Group",15,1,7,3,4,0,15,0,9,6,0,15,12,3,2
"3489",2925,2926,2926,"white","age.gp4","NoTr","NoTrade","Group",20,4,4,3,9,2,15,3,5,15,4,16,12,8,2
"3490",2962,2963,2963,"white","age.gp2","NoTr","NoTrade","Group",14,1,6,3,4,1,11,2,3,11,1,13,8,6,2
"3491",69,70,70,"white","age.gp4","NoTr","NoTrade","Group",10,1,1,4,4,1,9,0,2,8,0,10,6,4,2
"3492",722,723,723,"black","age.gp4","NoTr","NoTrade","NoGroup",7,0,2,2,3,5,2,0,0,7,1,6,3,4,2
"3493",758,759,759,"white","age.gp4","NoTr","NoTrade","NoGroup",9,0,1,1,7,1,8,0,3,6,0,9,7,2,2
"3494",1447,1448,1448,"white","age.gp1","NoTr","NoTrade","NoGroup",15,10,3,0,2,1,9,5,3,12,3,12,8,7,2
"3495",1554,1555,1555,"white","age.gp3","NoTr","NoTrade","Group",18,3,8,5,2,2,14,2,6,12,2,16,14,4,2
"3496",2339,2340,2340,"white","age.gp3","Tr","NoTrade","Group",18,1,7,5,5,1,16,1,6,12,0,18,17,1,2
"3497",2344,2345,2345,"white","age.gp2","Tr","NoTrade","Group",26,1,12,5,8,2,22,2,9,17,0,26,17,9,2
"3498",2427,2428,2428,"white","age.gp4","NoTr","NoTrade","NoGroup",4,0,0,2,2,1,3,0,0,4,0,4,1,3,2
"3499",2591,2592,2592,"white","age.gp3","NoTr","NoTrade","Group",26,7,8,7,4,1,18,7,9,17,0,26,16,10,2
"3500",97,98,98,"white","age.gp3","NoTr","NoTrade","Group",18,2,7,6,3,2,12,4,6,12,2,16,13,5,2
"3501",188,189,189,"white","age.gp3","Tr","NoTrade","NoGroup",12,1,2,6,3,0,12,0,3,9,1,11,9,3,2
"3502",701,702,702,"white","age.gp4","Tr","NoTrade","Group",15,2,3,1,9,4,9,2,2,13,0,15,10,5,2
"3503",1709,1710,1710,"white","age.gp2","Tr","NoTrade","Group",31,1,12,8,10,3,24,4,11,20,4,27,19,12,2
"3504",2211,2212,2212,"black","age.gp4","NoTr","Trade","Group",4,0,1,1,2,1,3,0,1,3,0,4,3,1,2
"3505",71,72,72,"white","age.gp4","NoTr","NoTrade","Group",9,0,2,1,6,0,9,0,5,4,0,9,8,1,2
"3506",93,94,94,"white","age.gp3","NoTr","NoTrade","Group",26,6,7,7,6,4,18,4,7,19,2,24,17,9,2
"3507",259,260,260,"white","age.gp4","NoTr","NoTrade","NoGroup",8,2,1,0,5,2,6,0,1,7,0,8,5,3,2
"3508",683,684,684,"white","age.gp4","Tr","NoTrade","Group",11,2,0,1,8,0,10,1,3,8,2,9,7,4,2
"3509",746,747,747,"white","age.gp2","Tr","NoTrade","Group",25,3,11,5,6,2,19,4,7,18,1,24,18,7,2
"3510",969,970,970,"white","age.gp2","Tr","NoTrade","Group",26,3,11,5,7,0,21,5,10,16,0,26,17,9,2
"3511",1276,1277,1277,"white","age.gp4","NoTr","NoTrade","Group",14,0,4,4,6,0,14,0,6,8,0,14,10,4,2
"3512",1780,1781,1781,"white","age.gp4","Tr","NoTrade","Group",6,0,3,0,3,1,5,0,2,4,0,6,4,2,2
"3513",2249,2250,2250,"white","age.gp4","Tr","NoTrade","Group",12,1,4,3,4,0,11,1,4,8,1,11,7,5,2
"3514",2560,2561,2561,"white","age.gp4","NoTr","NoTrade","Group",14,0,2,5,7,1,13,0,6,8,0,14,9,5,2
"3515",72,73,73,"white","age.gp4","NoTr","NoTrade","Group",12,1,2,2,7,1,11,0,6,6,0,12,10,2,2
"3516",154,155,155,"white","age.gp3","NoTr","NoTrade","Group",16,4,2,3,7,2,10,4,2,14,1,15,8,8,2
"3517",179,180,180,"white","age.gp3","Tr","NoTrade","NoGroup",9,1,1,4,3,2,6,1,1,8,0,9,5,4,2
"3518",309,310,310,"white","age.gp4","NoTr","NoTrade","Group",10,0,1,2,7,0,10,0,4,6,1,9,10,0,2
"3519",1777,1778,1778,"white","age.gp4","Tr","NoTrade","Group",22,1,3,3,15,1,21,0,6,16,1,21,16,6,2
"3520",2038,2039,2039,"white","age.gp4","Tr","NoTrade","Group",9,0,3,0,6,0,9,0,1,8,0,9,5,4,2
"3521",2040,2041,2041,"white","age.gp4","Tr","NoTrade","Group",15,0,5,4,6,3,12,0,6,9,1,14,11,4,2
"3522",2053,2054,2054,"white","age.gp4","Tr","NoTrade","Group",17,1,2,5,9,3,14,0,2,15,1,16,13,4,2
"3523",2393,2394,2394,"black","age.gp2","NoTr","NoTrade","NoGroup",7,0,2,2,3,5,2,0,1,6,2,5,5,2,2
"3524",2863,2864,2864,"white","age.gp2","Tr","NoTrade","Group",22,1,13,5,3,0,20,2,5,17,0,22,12,10,2
"3525",2974,2975,2975,"white","age.gp1","NoTr","NoTrade","Group",24,12,0,5,7,6,14,4,9,15,4,20,10,14,2
"3526",73,74,74,"white","age.gp4","NoTr","NoTrade","Group",8,0,0,2,6,1,7,0,3,5,1,7,6,2,2
"3527",84,85,85,"white","age.gp4","NoTr","NoTrade","Group",12,0,3,6,3,2,9,1,4,8,0,12,6,6,2
"3528",812,813,813,"white","age.gp4","NoTr","NoTrade","NoGroup",7,2,3,0,2,0,5,2,3,4,1,6,6,1,2
"3529",1570,1571,1571,"white","age.gp4","Tr","NoTrade","Group",6,0,0,1,5,0,6,0,1,5,0,6,5,1,2
"3530",1584,1585,1585,"white","age.gp4","Tr","NoTrade","Group",15,0,4,2,9,2,13,0,5,10,1,14,12,3,2
"3531",1698,1699,1699,"white","age.gp4","NoTr","Trade","NoGroup",5,0,0,2,3,0,5,0,0,5,2,3,4,1,2
"3532",2330,2331,2331,"white","age.gp3","Tr","NoTrade","Group",18,3,4,6,5,1,17,0,4,14,1,17,17,1,2
"3533",2856,2857,2857,"black","age.gp3","NoTr","NoTrade","Group",19,2,6,7,4,11,8,0,4,15,3,16,11,8,2
"3534",2939,2940,2940,"white","age.gp4","NoTr","NoTrade","Group",13,3,1,1,8,1,10,2,4,9,0,13,9,4,2
"3535",74,75,75,"white","age.gp4","NoTr","NoTrade","Group",6,1,3,1,1,1,4,1,2,4,0,6,4,2,2
"3536",87,88,88,"white","age.gp4","NoTr","NoTrade","Group",11,2,3,2,4,0,11,0,1,10,1,10,5,6,2
"3537",138,139,139,"white","age.gp2","NoTr","NoTrade","NoGroup",11,0,3,5,3,2,9,0,3,8,0,11,6,5,2
"3538",2389,2390,2390,"white","age.gp2","Tr","NoTrade","Group",18,2,6,4,6,2,15,1,5,13,0,18,12,6,2
"3539",2848,2849,2849,"black","age.gp3","NoTr","NoTrade","Group",8,1,2,3,2,1,7,0,5,3,2,6,7,1,2
"3540",871,872,872,"other","age.gp2","Tr","NoTrade","Group",10,1,5,2,2,0,10,0,2,8,1,9,7,3,2
"3541",1133,1134,1134,"white","age.gp2","Tr","NoTrade","Group",27,4,14,6,3,3,20,4,13,14,3,24,19,8,2
"3542",2612,2613,2613,"white","age.gp4","NoTr","NoTrade","NoGroup",5,0,1,0,4,0,5,0,1,4,0,5,3,2,2
"3543",2858,2859,2859,"white","age.gp1","Tr","NoTrade","NoGroup",16,10,1,3,2,2,13,1,4,12,2,14,9,7,2
"3544",2931,2932,2932,"white","age.gp4","NoTr","NoTrade","Group",13,2,2,2,7,1,10,2,2,11,1,12,6,7,2
"3545",2941,2942,2942,"white","age.gp4","NoTr","NoTrade","Group",21,4,4,2,11,4,16,1,10,11,1,20,15,6,2
"3546",76,77,77,"white","age.gp4","NoTr","NoTrade","Group",15,0,2,2,11,3,11,1,3,12,1,14,8,7,2
"3547",311,312,312,"white","age.gp4","NoTr","NoTrade","Group",15,1,3,1,10,0,15,0,4,11,0,15,7,8,2
"3548",427,428,428,"white","age.gp4","NoTr","NoTrade","NoGroup",4,1,0,2,1,0,4,0,0,4,0,4,3,1,2
"3549",607,608,608,"other","age.gp4","NoTr","NoTrade","NoGroup",5,0,0,0,5,1,4,0,0,5,1,4,2,3,2
"3550",672,673,673,"white","age.gp4","Tr","NoTrade","Group",14,0,4,3,7,2,12,0,3,11,4,10,10,4,2
"3551",724,725,725,"black","age.gp4","NoTr","NoTrade","NoGroup",5,0,2,0,3,2,3,0,0,5,1,4,4,1,2
"3552",809,810,810,"white","age.gp4","NoTr","NoTrade","NoGroup",3,0,1,0,2,0,3,0,1,2,0,3,2,1,2
"3553",814,815,815,"white","age.gp4","NoTr","NoTrade","NoGroup",4,0,1,0,3,0,4,0,2,2,0,4,3,1,2
"3554",1284,1285,1285,"white","age.gp4","NoTr","NoTrade","Group",10,2,3,2,3,2,8,0,2,8,1,9,6,4,2
"3555",1781,1782,1782,"white","age.gp4","Tr","NoTrade","Group",13,0,4,1,8,2,10,1,5,8,0,13,9,4,2
"3556",2097,2098,2098,"black","age.gp3","NoTr","NoTrade","NoGroup",5,0,1,1,3,1,4,0,2,3,1,4,3,2,2
"3557",2181,2182,2182,"white","age.gp4","NoTr","NoTrade","NoGroup",1,0,0,0,1,0,1,0,0,1,0,1,1,0,2
"3558",2239,2240,2240,"black","age.gp4","NoTr","Trade","Group",12,1,4,1,6,5,6,1,4,8,1,11,9,3,2
"3559",2647,2648,2648,"white","age.gp2","NoTr","NoTrade","Group",12,1,5,4,2,2,6,4,5,7,1,11,8,4,2
"3560",77,78,78,"white","age.gp4","NoTr","NoTrade","Group",9,1,1,2,5,2,7,0,3,6,1,8,6,3,2
"3561",100,101,101,"white","age.gp3","NoTr","NoTrade","Group",18,0,4,7,7,5,13,0,7,11,0,18,12,6,2
"3562",1256,1257,1257,"white","age.gp1","Tr","Trade","Group",25,15,1,2,7,1,16,8,4,21,1,24,12,13,2
"3563",1773,1774,1774,"white","age.gp4","Tr","NoTrade","Group",9,0,1,4,4,0,8,1,2,7,0,9,5,4,2
"3564",1945,1946,1946,"white","age.gp4","NoTr","NoTrade","Group",17,1,2,3,11,3,13,1,7,10,1,16,9,8,2
"3565",2087,2088,2088,"black","age.gp3","NoTr","NoTrade","NoGroup",9,0,4,2,3,5,3,1,2,7,0,9,5,4,2
"3566",2430,2431,2431,"white","age.gp4","NoTr","NoTrade","NoGroup",12,2,4,0,6,3,8,1,7,5,0,12,4,8,2
"3567",2841,2842,2842,"white","age.gp2","Tr","NoTrade","Group",24,1,11,4,8,3,20,1,8,16,3,21,14,10,2
"3568",2934,2935,2935,"white","age.gp4","NoTr","NoTrade","Group",9,0,2,2,5,0,9,0,4,5,0,9,5,4,2
"3569",78,79,79,"white","age.gp4","NoTr","NoTrade","Group",11,1,2,2,6,0,10,1,7,4,1,10,9,2,2
"3570",511,512,512,"white","age.gp2","Tr","NoTrade","NoGroup",10,1,8,0,1,0,8,2,4,6,0,10,3,7,2
"3571",696,697,697,"white","age.gp4","Tr","NoTrade","Group",11,2,3,1,5,0,10,1,4,7,1,10,7,4,2
"3572",877,878,878,"white","age.gp3","NoTr","Trade","Group",17,3,3,8,3,1,14,2,5,12,3,14,12,5,2
"3573",1062,1063,1063,"white","age.gp4","NoTr","NoTrade","Group",11,0,5,1,5,1,9,1,6,5,0,11,8,3,2
"3574",1581,1582,1582,"white","age.gp4","Tr","NoTrade","Group",14,0,2,5,7,2,12,0,4,10,0,14,10,4,2
"3575",1792,1793,1793,"white","age.gp4","Tr","NoTrade","Group",13,2,4,3,4,2,9,2,6,7,2,11,9,4,2
"3576",2069,2070,2070,"white","age.gp3","Tr","NoTrade","Group",22,0,4,10,8,4,17,1,4,18,2,20,12,10,2
"3577",2544,2545,2545,"other","age.gp1","NoTr","NoTrade","NoGroup",7,3,2,0,2,0,7,0,3,4,0,7,6,1,2
"3578",79,80,80,"white","age.gp4","NoTr","NoTrade","Group",13,0,3,4,6,3,9,1,6,7,2,11,11,2,2
"3579",237,238,238,"white","age.gp2","Tr","NoTrade","Group",19,2,7,6,4,4,13,2,5,14,5,14,14,5,2
"3580",866,867,867,"other","age.gp2","Tr","NoTrade","Group",6,0,2,2,2,1,5,0,1,5,0,6,4,2,2
"3581",1073,1074,1074,"white","age.gp4","NoTr","NoTrade","Group",13,1,2,3,7,0,13,0,4,9,1,12,8,5,2
"3582",1414,1415,1415,"black","age.gp2","NoTr","NoTrade","NoGroup",6,0,5,0,1,3,3,0,2,4,0,6,3,3,2
"3583",1561,1562,1562,"white","age.gp4","Tr","NoTrade","Group",12,0,0,4,8,2,10,0,3,9,1,11,9,3,2
"3584",2125,2126,2126,"white","age.gp3","NoTr","NoTrade","Group",20,0,8,7,5,1,17,2,9,11,1,19,19,1,2
"3585",2232,2233,2233,"black","age.gp4","NoTr","Trade","Group",3,0,1,0,2,1,2,0,1,2,0,3,2,1,2
"3586",2233,2234,2234,"black","age.gp4","NoTr","Trade","Group",7,0,1,0,6,2,5,0,1,6,0,7,4,3,2
"3587",2329,2330,2330,"white","age.gp3","Tr","NoTrade","Group",16,1,4,5,6,2,13,1,2,14,1,15,8,8,2
"3588",2782,2783,2783,"white","age.gp3","NoTr","NoTrade","Group",20,1,10,5,4,2,16,2,7,13,3,17,12,8,2
"3589",2948,2949,2949,"white","age.gp4","NoTr","NoTrade","Group",7,2,2,1,2,0,5,2,2,5,0,7,5,2,2
"3590",817,818,818,"white","age.gp4","NoTr","NoTrade","NoGroup",7,0,2,1,4,0,7,0,5,2,0,7,5,2,2
"3591",896,897,897,"other","age.gp1","Tr","NoTrade","NoGroup",2,1,0,0,1,1,1,0,1,1,0,2,1,1,2
"3592",1283,1284,1284,"white","age.gp4","NoTr","NoTrade","Group",10,0,2,3,5,1,8,1,3,7,2,8,9,1,2
"3593",1546,1547,1547,"white","age.gp3","NoTr","NoTrade","Group",22,2,6,9,5,3,18,1,8,14,2,20,12,10,2
"3594",1783,1784,1784,"white","age.gp4","Tr","NoTrade","Group",14,2,2,4,6,2,11,1,4,10,1,13,10,4,2
"3595",1796,1797,1797,"white","age.gp4","Tr","NoTrade","Group",13,2,4,1,6,0,10,3,3,10,2,11,7,6,2
"3596",2637,2638,2638,"white","age.gp4","NoTr","NoTrade","NoGroup",5,0,1,0,4,1,4,0,2,3,0,5,4,1,2
"3597",2712,2713,2713,"white","age.gp4","NoTr","NoTrade","Group",17,0,5,5,7,3,14,0,5,12,0,17,11,6,2
"3598",81,82,82,"white","age.gp4","NoTr","NoTrade","Group",13,1,5,4,3,1,9,3,5,8,1,12,8,5,2
"3599",147,148,148,"white","age.gp3","NoTr","NoTrade","Group",18,2,7,4,5,2,14,2,4,14,2,16,10,8,2
"3600",277,278,278,"white","age.gp4","NoTr","NoTrade","NoGroup",5,0,0,2,3,1,4,0,1,4,0,5,4,1,2
"3601",306,307,307,"white","age.gp4","NoTr","NoTrade","Group",11,2,2,2,5,2,8,1,4,7,1,10,5,6,2
"3602",649,650,650,"other","age.gp1","NoTr","Trade","Group",11,4,3,1,3,2,9,0,6,5,0,11,6,5,2
"3603",1308,1309,1309,"white","age.gp2","Tr","NoTrade","NoGroup",8,0,5,1,2,1,5,2,4,4,1,7,5,3,2
"3604",1402,1403,1403,"white","age.gp3","NoTr","NoTrade","Group",14,2,3,6,3,1,12,1,8,6,2,12,12,2,2
"3605",1411,1412,1412,"white","age.gp3","NoTr","NoTrade","Group",16,0,8,2,6,0,12,4,6,10,0,16,10,6,2
"3606",2285,2286,2286,"other","age.gp2","Tr","NoTrade","Group",9,2,2,3,2,1,8,0,1,8,0,9,5,4,2
"3607",2828,2829,2829,"other","age.gp2","NoTr","NoTrade","NoGroup",6,1,1,3,1,1,5,0,2,4,0,6,2,4,2
"3608",2829,2830,2830,"white","age.gp2","Tr","NoTrade","NoGroup",8,1,2,2,3,1,7,0,2,6,0,8,5,3,2
"3609",86,87,87,"white","age.gp4","NoTr","NoTrade","Group",15,2,1,5,7,1,14,0,5,10,0,15,8,7,2
"3610",297,298,298,"white","age.gp4","NoTr","NoTrade","Group",17,2,5,2,8,0,17,0,5,12,0,17,9,8,2
"3611",301,302,302,"white","age.gp4","NoTr","NoTrade","Group",14,1,3,1,9,0,11,3,5,9,0,14,12,2,2
"3612",797,798,798,"white","age.gp4","NoTr","NoTrade","NoGroup",7,1,3,1,2,0,5,2,2,5,0,7,4,3,2
"3613",816,817,817,"white","age.gp4","NoTr","NoTrade","NoGroup",6,1,2,0,3,0,4,2,2,4,1,5,4,2,2
"3614",1213,1214,1214,"white","age.gp4","NoTr","NoTrade","NoGroup",6,0,2,2,2,1,5,0,2,4,0,6,4,2,2
"3615",1589,1590,1590,"white","age.gp4","Tr","NoTrade","Group",14,0,1,2,11,0,14,0,4,10,1,13,11,3,2
"3616",1959,1960,1960,"white","age.gp4","NoTr","NoTrade","Group",21,1,2,5,13,2,18,1,13,8,1,20,16,5,2
"3617",2269,2270,2270,"white","age.gp4","Tr","NoTrade","Group",7,0,1,0,6,1,6,0,2,5,0,7,4,3,2
"3618",2474,2475,2475,"white","age.gp2","Tr","NoTrade","Group",20,0,10,5,5,2,16,2,5,15,0,20,10,10,2
"3619",83,84,84,"white","age.gp4","NoTr","NoTrade","Group",13,0,5,1,7,0,12,1,6,7,0,13,8,5,2
"3620",1290,1291,1291,"white","age.gp4","NoTr","NoTrade","Group",10,1,2,2,5,2,7,1,2,8,0,10,4,6,2
"3621",1309,1310,1310,"white","age.gp2","Tr","NoTrade","NoGroup",15,2,4,7,2,2,12,1,6,9,0,15,10,5,2
"3622",1426,1427,1427,"white","age.gp2","Tr","NoTrade","Group",24,3,8,7,6,2,20,2,9,15,2,22,15,9,2
"3623",1482,1483,1483,"white","age.gp4","NoTr","NoTrade","NoGroup",9,2,2,1,4,1,7,1,3,6,0,9,6,3,2
"3624",1559,1560,1560,"white","age.gp3","NoTr","NoTrade","Group",13,1,2,6,4,2,11,0,4,9,1,12,11,2,2
"3625",1775,1776,1776,"white","age.gp4","Tr","NoTrade","Group",11,0,2,3,6,1,9,1,4,7,0,11,7,4,2
"3626",1908,1909,1909,"other","age.gp2","NoTr","NoTrade","NoGroup",6,0,4,1,1,1,5,0,2,4,0,6,4,2,2
"3627",1960,1961,1961,"white","age.gp4","NoTr","NoTrade","Group",12,0,2,2,8,3,9,0,2,10,0,12,6,6,2
"3628",1993,1994,1994,"white","age.gp4","Tr","NoTrade","NoGroup",3,0,0,1,2,1,2,0,0,3,1,2,2,1,2
"3629",2922,2923,2923,"white","age.gp4","NoTr","NoTrade","Group",7,0,1,3,3,0,6,1,3,4,1,6,7,0,2
"3630",2966,2967,2967,"white","age.gp2","NoTr","NoTrade","NoGroup",13,0,10,1,2,1,12,0,7,6,0,13,8,5,2
"3631",125,126,126,"white","age.gp3","NoTr","NoTrade","NoGroup",6,0,2,2,2,1,4,1,3,3,0,6,2,4,2
"3632",202,203,203,"other","age.gp2","Tr","NoTrade","NoGroup",7,0,4,0,3,1,6,0,3,4,1,6,6,1,2
"3633",1039,1040,1040,"black","age.gp4","NoTr","NoTrade","NoGroup",4,0,2,0,2,1,3,0,2,2,0,4,2,2,2
"3634",1612,1613,1613,"white","age.gp3","Tr","NoTrade","NoGroup",8,1,2,3,2,2,4,2,3,5,1,7,5,3,2
"3635",1856,1857,1857,"white","age.gp3","NoTr","NoTrade","Group",17,0,4,5,8,2,15,0,6,11,0,17,11,6,2
"3636",2066,2067,2067,"white","age.gp3","Tr","NoTrade","Group",20,4,9,6,1,1,14,5,8,12,1,19,13,7,2
"3637",2113,2114,2114,"white","age.gp2","NoTr","NoTrade","NoGroup",13,3,3,2,5,0,13,0,5,8,1,12,8,5,2
"3638",85,86,86,"white","age.gp4","NoTr","NoTrade","Group",12,0,4,3,5,2,8,2,6,6,1,11,10,2,2
"3639",679,680,680,"white","age.gp4","Tr","NoTrade","Group",10,0,5,3,2,1,9,0,3,7,0,10,9,1,2
"3640",849,850,850,"other","age.gp2","Tr","NoTrade","Group",16,0,9,2,5,0,16,0,8,8,0,16,14,2,2
"3641",953,954,954,"white","age.gp3","Tr","NoTrade","Group",14,1,4,4,5,1,13,0,3,11,1,13,11,3,2
"3642",1387,1388,1388,"black","age.gp3","NoTr","NoTrade","NoGroup",9,0,3,2,4,5,3,1,1,8,2,7,6,3,2
"3643",2047,2048,2048,"white","age.gp4","Tr","NoTrade","Group",12,0,2,3,7,2,9,1,4,8,0,12,8,4,2
"3644",2128,2129,2129,"white","age.gp3","NoTr","NoTrade","Group",15,3,5,4,3,1,12,2,5,10,0,15,9,6,2
"3645",2142,2143,2143,"other","age.gp2","NoTr","NoTrade","NoGroup",5,0,2,0,3,1,4,0,2,3,0,5,3,2,2
"3646",2263,2264,2264,"white","age.gp4","Tr","NoTrade","Group",16,3,3,4,6,2,11,3,4,12,1,15,13,3,2
"3647",2570,2571,2571,"white","age.gp4","NoTr","NoTrade","Group",8,0,3,1,4,0,8,0,5,3,0,8,6,2,2
"3648",677,678,678,"white","age.gp4","Tr","NoTrade","Group",9,0,1,0,8,2,7,0,4,5,0,9,7,2,2
"3649",827,828,828,"white","age.gp3","NoTr","NoTrade","NoGroup",6,3,0,2,1,1,4,1,1,5,0,6,1,5,2
"3650",1017,1018,1018,"white","age.gp1","NoTr","NoTrade","NoGroup",12,5,4,1,2,0,9,3,2,10,1,11,6,6,2
"3651",1853,1854,1854,"white","age.gp3","NoTr","NoTrade","Group",18,2,8,2,6,1,16,1,8,10,3,15,12,6,2
"3652",2245,2246,2246,"white","age.gp4","Tr","NoTrade","Group",10,3,1,1,5,4,6,0,3,7,1,9,5,5,2
"3653",2254,2255,2255,"white","age.gp4","Tr","NoTrade","Group",15,0,5,2,8,1,13,1,5,10,2,13,8,7,2
"3654",2362,2363,2363,"white","age.gp3","Tr","NoTrade","NoGroup",9,0,2,3,4,1,7,1,2,7,0,9,4,5,2
"3655",2402,2403,2403,"white","age.gp3","NoTr","NoTrade","NoGroup",7,1,1,2,3,0,5,2,1,6,0,7,5,2,2
"3656",2512,2513,2513,"white","age.gp1","NoTr","NoTrade","NoGroup",14,6,0,3,5,0,12,2,3,11,0,14,9,5,2
"3657",2624,2625,2625,"white","age.gp4","NoTr","NoTrade","NoGroup",6,0,1,2,3,2,4,0,0,6,0,6,6,0,2
"3658",2943,2944,2944,"white","age.gp4","NoTr","NoTrade","Group",13,2,3,2,6,0,11,2,2,11,1,12,7,6,2
"3659",114,115,115,"white","age.gp3","NoTr","NoTrade","NoGroup",13,1,5,5,2,0,13,0,4,9,4,9,11,2,2
"3660",528,529,529,"white","age.gp4","NoTr","NoTrade","NoGroup",1,0,0,0,1,0,1,0,0,1,0,1,1,0,2
"3661",836,837,837,"white","age.gp2","NoTr","NoTrade","Group",24,3,9,6,6,3,17,4,10,14,1,23,11,13,2
"3662",1237,1238,1238,"white","age.gp4","NoTr","NoTrade","NoGroup",2,0,0,0,2,0,2,0,0,2,0,2,1,1,2
"3663",1409,1410,1410,"white","age.gp3","NoTr","NoTrade","Group",16,3,10,1,2,0,13,3,6,10,1,15,10,6,2
"3664",1457,1458,1458,"white","age.gp1","NoTr","NoTrade","NoGroup",11,7,2,0,2,0,7,4,3,8,1,10,7,4,2
"3665",2170,2171,2171,"white","age.gp2","NoTr","NoTrade","Group",23,2,10,4,7,2,19,2,6,17,3,20,17,6,2
"3666",2381,2382,2382,"white","age.gp1","NoTr","NoTrade","NoGroup",7,4,0,1,2,1,5,1,1,6,0,7,4,3,2
"3667",88,89,89,"white","age.gp4","NoTr","NoTrade","Group",14,2,4,1,7,2,11,1,5,9,1,13,11,3,2
"3668",744,745,745,"white","age.gp2","Tr","NoTrade","Group",18,0,10,2,6,4,12,2,6,12,0,18,11,7,2
"3669",966,967,967,"white","age.gp2","Tr","NoTrade","Group",34,2,11,10,11,2,30,2,10,24,1,33,23,11,2
"3670",989,990,990,"white","age.gp4","NoTr","NoTrade","NoGroup",4,0,0,0,4,0,4,0,1,3,0,4,2,2,2
"3671",1296,1297,1297,"white","age.gp4","NoTr","NoTrade","Group",11,0,1,0,10,3,7,1,2,9,0,11,7,4,2
"3672",1372,1373,1373,"black","age.gp4","NoTr","NoTrade","Group",7,0,0,0,7,5,2,0,1,6,0,7,4,3,2
"3673",2273,2274,2274,"black","age.gp2","Tr","Trade","Group",17,2,6,3,6,8,8,1,5,12,1,16,9,8,2
"3674",2296,2297,2297,"other","age.gp2","Tr","NoTrade","Group",7,0,3,2,2,1,6,0,1,6,0,7,2,5,2
"3675",2646,2647,2647,"white","age.gp1","NoTr","NoTrade","NoGroup",10,3,4,1,2,1,7,2,1,9,1,9,8,2,2
"3676",2676,2677,2677,"white","age.gp3","NoTr","NoTrade","NoGroup",8,1,4,2,1,1,5,2,3,5,1,7,6,2,2
"3677",2714,2715,2715,"white","age.gp4","NoTr","NoTrade","Group",19,3,2,3,11,1,16,2,8,11,1,18,12,7,2
"3678",2872,2873,2873,"white","age.gp1","NoTr","NoTrade","Group",32,16,8,4,4,3,22,7,9,23,2,30,11,21,2
"3679",89,90,90,"white","age.gp4","NoTr","NoTrade","Group",10,2,1,3,4,3,6,1,2,8,0,10,6,4,2
"3680",168,169,169,"white","age.gp3","NoTr","NoTrade","NoGroup",15,2,4,0,9,0,13,2,6,9,0,15,9,6,2
"3681",290,291,291,"black","age.gp2","NoTr","NoTrade","Group",11,0,5,2,4,6,5,0,2,9,3,8,9,2,2
"3682",794,795,795,"white","age.gp4","NoTr","NoTrade","NoGroup",5,0,0,0,5,1,4,0,2,3,0,5,4,1,2
"3683",1093,1094,1094,"black","age.gp1","NoTr","NoTrade","NoGroup",10,2,3,3,2,4,4,2,0,10,0,10,4,6,2
"3684",1157,1158,1158,"white","age.gp4","NoTr","NoTrade","NoGroup",5,0,1,2,2,2,3,0,0,5,0,5,3,2,2
"3685",1362,1363,1363,"black","age.gp4","NoTr","NoTrade","Group",10,2,2,3,3,5,5,0,3,7,2,8,6,4,2
"3686",1894,1895,1895,"other","age.gp1","NoTr","NoTrade","Group",8,3,1,3,1,3,5,0,3,5,1,7,6,2,2
"3687",2583,2584,2584,"white","age.gp4","NoTr","NoTrade","Group",12,2,2,1,7,3,9,0,5,7,1,11,9,3,2
"3688",90,91,91,"white","age.gp4","NoTr","NoTrade","Group",12,0,6,3,3,0,12,0,10,2,0,12,9,3,2
"3689",238,239,239,"white","age.gp2","Tr","NoTrade","Group",27,3,15,3,6,4,20,3,12,15,0,27,19,8,2
"3690",437,438,438,"white","age.gp4","NoTr","NoTrade","NoGroup",5,1,2,0,2,0,4,1,1,4,0,5,4,1,2
"3691",676,677,677,"white","age.gp4","Tr","NoTrade","Group",15,0,2,6,7,0,15,0,2,13,1,14,13,2,2
"3692",1580,1581,1581,"white","age.gp4","Tr","NoTrade","Group",14,2,2,2,8,2,11,1,4,10,1,13,12,2,2
"3693",1739,1740,1740,"white","age.gp3","Tr","NoTrade","Group",21,1,5,12,3,0,21,0,6,15,3,18,17,4,2
"3694",1808,1809,1809,"white","age.gp2","Tr","NoTrade","Group",29,4,10,7,8,0,24,5,15,14,1,28,19,10,2
"3695",2355,2356,2356,"white","age.gp3","Tr","NoTrade","NoGroup",9,1,1,2,5,0,9,0,3,6,0,9,7,2,2
"3696",2742,2743,2743,"white","age.gp2","NoTr","NoTrade","Group",17,1,11,2,3,2,12,3,9,8,1,16,13,4,2
"3697",2840,2841,2841,"white","age.gp2","Tr","NoTrade","Group",27,4,10,9,4,4,18,5,4,23,2,25,17,10,2
"3698",2865,2866,2866,"white","age.gp2","Tr","NoTrade","Group",21,2,7,5,7,0,19,2,9,12,0,21,14,7,2
"3699",91,92,92,"white","age.gp3","NoTr","NoTrade","Group",23,6,9,5,3,4,17,2,10,13,0,23,11,12,2
"3700",155,156,156,"white","age.gp3","NoTr","NoTrade","Group",17,5,3,7,2,2,14,1,7,10,1,16,9,8,2
"3701",652,653,653,"black","age.gp2","NoTr","NoTrade","NoGroup",12,0,6,5,1,6,6,0,3,9,0,12,9,3,2
"3702",708,709,709,"white","age.gp2","Tr","NoTrade","Group",25,3,7,7,8,2,21,2,7,18,3,22,18,7,2
"3703",843,844,844,"white","age.gp2","Tr","NoTrade","NoGroup",12,2,8,2,0,0,10,2,4,8,0,12,8,4,2
"3704",1353,1354,1354,"black","age.gp4","NoTr","NoTrade","Group",11,1,4,4,2,4,6,1,3,8,1,10,7,4,2
"3705",1425,1426,1426,"white","age.gp2","Tr","NoTrade","Group",19,1,5,7,6,3,13,3,8,11,1,18,12,7,2
"3706",1544,1545,1545,"white","age.gp2","NoTr","NoTrade","NoGroup",9,2,2,2,3,0,9,0,4,5,0,9,7,2,2
"3707",1555,1556,1556,"white","age.gp3","NoTr","NoTrade","Group",23,0,13,7,3,3,18,2,8,15,0,23,18,5,2
"3708",1891,1892,1892,"other","age.gp1","NoTr","NoTrade","Group",7,5,0,1,1,2,5,0,4,3,2,5,3,4,2
"3709",1903,1904,1904,"black","age.gp1","NoTr","NoTrade","NoGroup",8,3,1,4,0,4,3,1,2,6,3,5,4,4,2
"3710",1983,1984,1984,"white","age.gp4","Tr","NoTrade","NoGroup",7,0,0,2,5,1,6,0,1,6,0,7,4,3,2
"3711",2115,2116,2116,"white","age.gp2","NoTr","NoTrade","NoGroup",8,0,3,5,0,2,5,1,1,7,1,7,6,2,2
"3712",2322,2323,2323,"white","age.gp1","NoTr","NoTrade","NoGroup",14,7,2,3,2,2,9,3,3,11,1,13,11,3,2
"3713",2630,2631,2631,"white","age.gp4","NoTr","NoTrade","NoGroup",7,0,0,3,4,1,6,0,3,4,0,7,5,2,2
"3714",136,137,137,"white","age.gp2","NoTr","NoTrade","NoGroup",17,1,8,7,1,0,15,2,7,10,1,16,9,8,2
"3715",472,473,473,"black","age.gp3","NoTr","Trade","Group",11,1,4,6,0,7,4,0,2,9,0,11,6,5,2
"3716",936,937,937,"white","age.gp3","NoTr","NoTrade","NoGroup",4,0,1,2,1,0,3,1,1,3,0,4,2,2,2
"3717",1004,1005,1005,"white","age.gp1","Tr","NoTrade","Group",30,13,7,8,2,0,21,9,11,19,0,30,20,10,2
"3718",1006,1007,1007,"white","age.gp1","Tr","NoTrade","Group",26,13,4,5,4,1,19,6,3,23,4,22,13,13,2
"3719",1431,1432,1432,"white","age.gp3","Tr","NoTrade","NoGroup",13,2,6,4,1,0,12,1,3,10,2,11,10,3,2
"3720",1493,1494,1494,"white","age.gp4","NoTr","NoTrade","NoGroup",3,0,1,1,1,0,2,1,0,3,0,3,2,1,2
"3721",1550,1551,1551,"white","age.gp3","NoTr","NoTrade","Group",17,5,3,5,4,0,15,2,5,12,0,17,10,7,2
"3722",1734,1735,1735,"white","age.gp3","Tr","NoTrade","Group",17,1,6,4,6,1,15,1,6,11,2,15,12,5,2
"3723",1858,1859,1859,"white","age.gp3","NoTr","NoTrade","Group",17,2,3,5,7,2,14,1,3,14,0,17,10,7,2
"3724",1892,1893,1893,"other","age.gp1","NoTr","NoTrade","Group",14,8,3,2,1,2,12,0,5,9,0,14,7,7,2
"3725",2354,2355,2355,"white","age.gp3","Tr","NoTrade","NoGroup",10,0,6,3,1,0,9,1,3,7,0,10,6,4,2
"3726",2424,2425,2425,"white","age.gp3","NoTr","Trade","Group",10,1,3,5,1,1,7,2,2,8,1,9,8,2,2
"3727",2511,2512,2512,"white","age.gp1","NoTr","NoTrade","NoGroup",7,3,1,1,2,0,4,3,0,7,1,6,3,4,2
"3728",2738,2739,2739,"white","age.gp2","Tr","NoTrade","Group",24,1,13,4,6,1,18,5,10,14,0,24,18,6,2
"3729",410,411,411,"white","age.gp2","Tr","Trade","Group",27,3,11,7,6,1,20,6,9,18,0,27,14,13,2
"3730",534,535,535,"white","age.gp4","NoTr","NoTrade","NoGroup",2,0,0,1,1,0,2,0,0,2,0,2,2,0,2
"3731",635,636,636,"other","age.gp1","NoTr","Trade","Group",4,1,0,3,0,0,4,0,1,3,0,4,4,0,2
"3732",664,665,665,"white","age.gp2","NoTr","NoTrade","Group",22,1,7,9,5,1,20,1,5,17,1,21,15,7,2
"3733",705,706,706,"white","age.gp2","NoTr","NoTrade","Group",20,1,11,7,1,1,18,1,11,9,0,20,15,5,2
"3734",1119,1120,1120,"other","age.gp1","NoTr","NoTrade","NoGroup",7,3,0,1,3,0,7,0,2,5,0,7,4,3,2
"3735",1246,1247,1247,"white","age.gp1","NoTr","NoTrade","NoGroup",10,5,1,2,2,1,7,2,0,10,2,8,3,7,2
"3736",1322,1323,1323,"white","age.gp2","Tr","NoTrade","Group",26,2,9,11,4,3,21,2,5,21,1,25,20,6,2
"3737",1357,1358,1358,"black","age.gp4","NoTr","NoTrade","Group",14,1,1,2,10,9,5,0,0,14,2,12,7,7,2
"3738",1802,1803,1803,"white","age.gp4","Tr","NoTrade","Group",13,1,2,4,6,3,9,1,5,8,0,13,7,6,2
"3739",1849,1850,1850,"black","age.gp3","NoTr","NoTrade","NoGroup",8,0,2,3,3,6,2,0,0,8,0,8,3,5,2
"3740",1876,1877,1877,"other","age.gp1","NoTr","NoTrade","Group",16,8,5,3,0,2,14,0,4,12,1,15,9,7,2
"3741",2083,2084,2084,"black","age.gp3","NoTr","NoTrade","NoGroup",6,0,1,5,0,4,2,0,0,6,1,5,4,2,2
"3742",2117,2118,2118,"white","age.gp3","NoTr","NoTrade","Group",13,4,4,2,3,1,9,3,4,9,0,13,7,6,2
"3743",2325,2326,2326,"white","age.gp3","Tr","NoTrade","Group",20,3,10,4,3,1,17,2,7,13,2,18,12,8,2
"3744",2557,2558,2558,"other","age.gp1","NoTr","NoTrade","NoGroup",5,4,0,1,0,0,5,0,2,3,0,5,2,3,2
"3745",2636,2637,2637,"white","age.gp4","NoTr","NoTrade","NoGroup",4,0,1,1,2,1,3,0,2,2,0,4,3,1,2
"3746",94,95,95,"white","age.gp3","NoTr","NoTrade","Group",16,0,9,4,3,0,16,0,10,6,0,16,14,2,2
"3747",164,165,165,"white","age.gp3","NoTr","NoTrade","NoGroup",8,1,4,2,1,0,7,1,3,5,0,8,4,4,2
"3748",283,284,284,"white","age.gp2","Tr","NoTrade","Group",36,3,14,11,8,4,27,5,10,26,1,35,23,13,2
"3749",743,744,744,"white","age.gp2","Tr","NoTrade","Group",19,1,8,6,4,3,16,0,4,15,2,17,15,4,2
"3750",837,838,838,"white","age.gp2","NoTr","NoTrade","Group",21,4,7,3,7,2,16,3,8,13,1,20,16,5,2
"3751",934,935,935,"white","age.gp3","NoTr","NoTrade","NoGroup",8,0,4,3,1,1,5,2,4,4,1,7,6,2,2
"3752",2103,2104,2104,"white","age.gp2","Tr","NoTrade","Group",23,2,8,7,6,2,19,2,9,14,1,22,16,7,2
"3753",2104,2105,2105,"white","age.gp2","Tr","NoTrade","Group",22,1,9,9,3,1,19,2,11,11,2,20,15,7,2
"3754",2264,2265,2265,"white","age.gp4","Tr","NoTrade","Group",16,3,4,3,6,0,14,2,5,11,2,14,12,4,2
"3755",2588,2589,2589,"white","age.gp4","NoTr","NoTrade","Group",10,0,2,1,7,0,10,0,3,7,0,10,9,1,2
"3756",779,780,780,"white","age.gp2","NoTr","NoTrade","NoGroup",9,0,2,6,1,3,5,1,3,6,1,8,6,3,2
"3757",1210,1211,1211,"white","age.gp4","NoTr","NoTrade","NoGroup",12,0,1,2,9,0,12,0,5,7,0,12,9,3,2
"3758",1725,1726,1726,"white","age.gp1","Tr","NoTrade","NoGroup",7,4,0,3,0,2,4,1,3,4,2,5,4,3,2
"3759",1735,1736,1736,"white","age.gp3","Tr","NoTrade","Group",17,0,1,9,7,0,17,0,6,11,0,17,13,4,2
"3760",2394,2395,2395,"black","age.gp2","NoTr","NoTrade","NoGroup",5,0,2,2,1,2,3,0,1,4,0,5,4,1,2
"3761",2717,2718,2718,"white","age.gp4","NoTr","NoTrade","Group",7,0,1,3,3,0,7,0,4,3,0,7,5,2,2
"3762",2920,2921,2921,"white","age.gp1","NoTr","NoTrade","NoGroup",10,6,1,2,1,0,9,1,3,7,1,9,5,5,2
"3763",2929,2930,2930,"white","age.gp4","NoTr","NoTrade","Group",20,1,6,8,5,1,18,1,13,7,3,17,18,2,2
"3764",331,332,332,"white","age.gp1","NoTr","NoTrade","NoGroup",11,6,2,3,0,1,7,3,1,10,5,6,9,2,2
"3765",332,333,333,"white","age.gp2","Tr","NoTrade","NoGroup",18,2,8,6,2,2,14,2,7,11,1,17,8,10,2
"3766",901,902,902,"other","age.gp1","Tr","NoTrade","NoGroup",5,2,1,2,0,1,4,0,2,3,0,5,3,2,2
"3767",968,969,969,"white","age.gp2","Tr","NoTrade","Group",29,4,11,7,7,0,25,4,9,20,2,27,23,6,2
"3768",1404,1405,1405,"white","age.gp3","NoTr","NoTrade","Group",18,2,4,7,5,2,14,2,6,12,0,18,13,5,2
"3769",1710,1711,1711,"white","age.gp2","Tr","NoTrade","Group",24,3,5,10,6,1,20,3,10,14,1,23,14,10,2
"3770",1711,1712,1712,"white","age.gp2","Tr","NoTrade","Group",27,2,12,7,6,0,22,5,10,17,2,25,16,11,2
"3771",2032,2033,2033,"white","age.gp4","Tr","NoTrade","Group",11,0,1,4,6,3,8,0,1,10,0,11,8,3,2
"3772",2072,2073,2073,"white","age.gp3","Tr","NoTrade","Group",17,1,6,7,3,2,14,1,8,9,0,17,12,5,2
"3773",2336,2337,2337,"white","age.gp3","Tr","NoTrade","Group",23,3,6,8,6,2,19,2,10,13,2,21,13,10,2
"3774",2391,2392,2392,"black","age.gp2","NoTr","NoTrade","NoGroup",7,1,2,1,3,3,3,1,0,7,0,7,2,5,2
"3775",823,824,824,"white","age.gp3","NoTr","NoTrade","NoGroup",9,0,3,3,3,1,8,0,3,6,0,9,5,4,2
"3776",876,877,877,"white","age.gp3","NoTr","Trade","Group",18,2,2,11,3,0,17,1,6,12,3,15,14,4,2
"3777",1055,1056,1056,"white","age.gp4","NoTr","NoTrade","Group",11,0,3,5,3,0,10,1,3,8,1,10,7,4,2
"3778",1464,1465,1465,"white","age.gp2","NoTr","Trade","Group",13,4,3,5,1,0,9,4,4,9,1,12,8,5,2
"3779",1873,1874,1874,"other","age.gp1","NoTr","NoTrade","Group",12,5,3,3,1,2,10,0,4,8,1,11,5,7,2
"3780",1893,1894,1894,"other","age.gp1","NoTr","NoTrade","Group",11,5,1,2,3,1,10,0,4,7,1,10,4,7,2
"3781",2333,2334,2334,"white","age.gp3","Tr","NoTrade","Group",24,4,10,5,5,2,19,3,6,18,1,23,20,4,2
"3782",2519,2520,2520,"black","age.gp2","NoTr","NoTrade","Group",17,0,6,10,1,8,9,0,7,10,1,16,12,5,2
"3783",2777,2778,2778,"white","age.gp3","NoTr","NoTrade","Group",16,1,5,7,3,0,14,2,8,8,1,15,13,3,2
"3784",98,99,99,"white","age.gp3","NoTr","NoTrade","Group",19,2,7,6,4,4,15,0,9,10,2,17,11,8,2
"3785",167,168,168,"white","age.gp3","NoTr","NoTrade","NoGroup",8,0,4,2,2,0,7,1,3,5,0,8,8,0,2
"3786",186,187,187,"white","age.gp3","Tr","NoTrade","NoGroup",7,1,2,3,1,0,7,0,1,6,1,6,5,2,2
"3787",655,656,656,"white","age.gp2","Tr","NoTrade","NoGroup",10,1,4,3,2,2,7,1,3,7,0,10,6,4,2
"3788",948,949,949,"white","age.gp3","Tr","NoTrade","Group",16,1,8,5,2,0,14,2,5,11,0,16,12,4,2
"3789",1007,1008,1008,"white","age.gp1","Tr","NoTrade","Group",30,11,9,8,2,2,25,3,9,21,2,28,18,12,2
"3790",1471,1472,1472,"white","age.gp1","NoTr","NoTrade","NoGroup",13,7,3,2,1,1,11,1,3,10,1,12,7,6,2
"3791",1565,1566,1566,"white","age.gp4","Tr","NoTrade","Group",16,1,2,5,8,2,11,3,2,14,0,16,9,7,2
"3792",1601,1602,1602,"white","age.gp2","Tr","NoTrade","NoGroup",14,0,5,3,6,2,11,1,3,11,2,12,9,5,2
"3793",2063,2064,2064,"white","age.gp3","Tr","NoTrade","Group",22,2,9,8,3,4,17,1,7,15,1,21,17,5,2
"3794",2237,2238,2238,"black","age.gp4","NoTr","Trade","Group",9,1,1,1,6,3,6,0,3,6,0,9,6,3,2
"3795",2623,2624,2624,"white","age.gp4","NoTr","NoTrade","NoGroup",7,0,2,3,2,0,7,0,2,5,0,7,7,0,2
"3796",1857,1858,1858,"white","age.gp3","NoTr","NoTrade","Group",15,5,2,5,3,0,14,1,5,10,0,15,9,6,2
"3797",2327,2328,2328,"white","age.gp3","Tr","NoTrade","Group",16,1,8,1,6,1,12,3,7,9,1,15,11,5,2
"3798",2582,2583,2583,"white","age.gp4","NoTr","NoTrade","Group",12,0,5,5,2,2,10,0,3,9,2,10,10,2,2
"3799",2817,2818,2818,"other","age.gp2","NoTr","NoTrade","NoGroup",7,1,1,4,1,1,6,0,0,7,0,7,3,4,2
"3800",2969,2970,2970,"white","age.gp2","NoTr","NoTrade","Group",22,0,11,6,5,1,19,2,13,9,0,22,15,7,2
"3801",363,364,364,"black","age.gp4","NoTr","NoTrade","NoGroup",2,0,1,1,0,1,1,0,0,2,0,2,2,0,2
"3802",556,557,557,"white","age.gp4","NoTr","NoTrade","NoGroup",1,0,0,1,0,0,1,0,0,1,0,1,1,0,2
"3803",710,711,711,"white","age.gp2","Tr","NoTrade","Group",20,2,6,8,4,3,14,3,4,16,1,19,9,11,2
"3804",942,943,943,"white","age.gp3","Tr","NoTrade","Group",14,1,6,4,3,0,13,1,4,10,0,14,9,5,2
"3805",1050,1051,1051,"black","age.gp4","NoTr","NoTrade","NoGroup",3,0,0,1,2,1,2,0,0,3,0,3,2,1,2
"3806",2649,2650,2650,"white","age.gp2","NoTr","NoTrade","Group",18,1,6,8,3,2,15,1,10,8,1,17,15,3,2
"3807",2786,2787,2787,"white","age.gp3","NoTr","NoTrade","Group",16,1,4,9,2,2,14,0,5,11,1,15,8,8,2
"3808",101,102,102,"white","age.gp3","NoTr","NoTrade","Group",17,2,6,7,2,1,14,2,9,8,3,14,9,8,2
"3809",622,623,623,"other","age.gp1","NoTr","Trade","Group",13,3,5,3,2,1,12,0,5,8,0,13,7,6,2
"3810",709,710,710,"white","age.gp2","Tr","NoTrade","Group",27,6,5,9,7,4,20,3,10,17,4,23,18,9,2
"3811",1137,1138,1138,"white","age.gp2","Tr","NoTrade","Group",23,2,11,7,3,2,16,5,6,17,2,21,13,10,2
"3812",1333,1334,1334,"white","age.gp3","NoTr","NoTrade","NoGroup",7,0,2,2,3,1,6,0,4,3,1,6,5,2,2
"3813",1600,1601,1601,"white","age.gp2","Tr","NoTrade","NoGroup",14,2,7,2,3,1,11,2,4,10,3,11,9,5,2
"3814",2154,2155,2155,"other","age.gp2","NoTr","NoTrade","NoGroup",5,1,1,2,1,0,5,0,1,4,0,5,3,2,2
"3815",2426,2427,2427,"white","age.gp4","NoTr","NoTrade","NoGroup",4,1,0,2,1,0,4,0,1,3,0,4,2,2,2
"3816",2686,2687,2687,"black","age.gp3","NoTr","NoTrade","NoGroup",4,0,2,1,1,1,3,0,2,2,0,4,2,2,2
"3817",102,103,103,"white","age.gp3","NoTr","NoTrade","Group",13,2,8,2,1,0,10,3,6,7,1,12,7,6,2
"3818",667,668,668,"white","age.gp2","Tr","NoTrade","NoGroup",8,0,5,2,1,0,8,0,7,1,0,8,5,3,2
"3819",854,855,855,"other","age.gp2","Tr","NoTrade","Group",4,0,2,1,1,0,4,0,1,3,0,4,3,1,2
"3820",1721,1722,1722,"white","age.gp2","NoTr","NoTrade","Group",18,1,9,6,2,3,14,1,11,7,1,17,15,3,2
"3821",1986,1987,1987,"white","age.gp4","Tr","NoTrade","NoGroup",2,1,0,1,0,0,2,0,0,2,0,2,1,1,2
"3822",2114,2115,2115,"white","age.gp2","NoTr","NoTrade","NoGroup",11,0,7,3,1,0,11,0,7,4,1,10,8,3,2
"3823",2321,2322,2322,"white","age.gp1","NoTr","NoTrade","NoGroup",13,5,5,3,0,1,7,5,2,11,1,12,5,8,2
"3824",2475,2476,2476,"white","age.gp2","Tr","NoTrade","Group",17,1,10,6,0,3,12,2,5,12,0,17,11,6,2
"3825",2535,2536,2536,"other","age.gp1","NoTr","NoTrade","NoGroup",9,3,4,2,0,1,8,0,5,4,2,7,6,3,2
"3826",2827,2828,2828,"other","age.gp2","NoTr","NoTrade","NoGroup",5,0,1,2,2,0,5,0,3,2,0,5,5,0,2
"3827",334,335,335,"white","age.gp2","Tr","NoTrade","NoGroup",9,1,5,3,0,1,6,2,3,6,0,9,7,2,2
"3828",754,755,755,"white","age.gp4","NoTr","NoTrade","NoGroup",9,2,1,2,4,1,8,0,4,5,0,9,5,4,2
"3829",1028,1029,1029,"black","age.gp4","NoTr","NoTrade","NoGroup",4,0,2,1,1,2,2,0,0,4,1,3,2,2,2
"3830",1058,1059,1059,"white","age.gp4","NoTr","NoTrade","Group",15,0,2,3,10,1,14,0,5,10,0,15,14,1,2
"3831",1203,1204,1204,"white","age.gp4","Tr","NoTrade","NoGroup",5,0,0,3,2,1,4,0,0,5,0,5,3,2,2
"3832",1247,1248,1248,"white","age.gp1","NoTr","NoTrade","NoGroup",9,5,2,1,1,0,9,0,2,7,1,8,4,5,2
"3833",1605,1606,1606,"white","age.gp3","Tr","NoTrade","NoGroup",7,1,1,3,2,0,7,0,2,5,1,6,7,0,2
"3834",1715,1716,1716,"white","age.gp1","Tr","NoTrade","NoGroup",9,3,2,2,2,0,7,2,4,5,0,9,5,4,2
"3835",1724,1725,1725,"white","age.gp1","Tr","NoTrade","NoGroup",9,5,0,2,2,1,6,2,1,8,1,8,4,5,2
"3836",2111,2112,2112,"white","age.gp2","NoTr","NoTrade","NoGroup",10,1,5,3,1,1,8,1,4,6,0,10,7,3,2
"3837",2126,2127,2127,"white","age.gp3","NoTr","NoTrade","Group",19,1,12,4,2,1,17,1,13,6,0,19,12,7,2
"3838",2289,2290,2290,"other","age.gp2","Tr","NoTrade","Group",9,0,3,5,1,1,8,0,1,8,2,7,7,2,2
"3839",2337,2338,2338,"white","age.gp3","Tr","NoTrade","Group",19,3,3,5,8,1,17,1,3,16,2,17,12,7,2
"3840",2528,2529,2529,"white","age.gp2","NoTr","NoTrade","Group",19,4,7,5,3,1,14,4,10,9,0,19,14,5,2
"3841",2597,2598,2598,"white","age.gp3","NoTr","NoTrade","Group",29,3,15,9,2,5,22,2,14,15,3,26,20,9,2
"3842",104,105,105,"white","age.gp3","NoTr","NoTrade","Group",19,1,6,6,6,0,15,4,7,12,0,19,10,9,2
"3843",210,211,211,"other","age.gp2","Tr","NoTrade","NoGroup",4,1,0,2,1,0,4,0,1,3,0,4,3,1,2
"3844",845,846,846,"white","age.gp2","Tr","NoTrade","NoGroup",7,1,2,3,1,0,6,1,1,6,0,7,2,5,2
"3845",922,923,923,"white","age.gp2","NoTr","NoTrade","NoGroup",11,0,5,2,4,0,11,0,9,2,0,11,10,1,2
"3846",1288,1289,1289,"white","age.gp4","NoTr","NoTrade","Group",15,2,2,4,7,0,15,0,4,11,0,15,12,3,2
"3847",1607,1608,1608,"white","age.gp3","Tr","NoTrade","NoGroup",10,1,2,3,4,1,8,1,2,8,0,10,7,3,2
"3848",1864,1865,1865,"white","age.gp3","NoTr","NoTrade","Group",18,3,8,4,3,4,12,2,10,8,1,17,11,7,2
"3849",1906,1907,1907,"other","age.gp2","NoTr","NoTrade","NoGroup",5,1,1,2,1,1,4,0,2,3,0,5,3,2,2
"3850",2055,2056,2056,"white","age.gp4","Tr","NoTrade","Group",15,2,3,5,5,1,11,3,6,9,0,15,7,8,2
"3851",2171,2172,2172,"white","age.gp2","NoTr","NoTrade","Group",20,4,10,4,2,1,16,3,11,9,1,19,15,5,2
"3852",2401,2402,2402,"white","age.gp3","NoTr","NoTrade","NoGroup",11,0,5,5,1,2,7,2,4,7,1,10,6,5,2
"3853",2908,2909,2909,"other","age.gp1","NoTr","NoTrade","NoGroup",3,0,0,3,0,1,2,0,0,3,0,3,1,2,2
"3854",105,106,106,"white","age.gp3","NoTr","NoTrade","Group",16,3,6,6,1,1,12,3,6,10,2,14,7,9,2
"3855",851,852,852,"other","age.gp2","Tr","NoTrade","Group",9,0,4,3,2,0,9,0,3,6,0,9,6,3,2
"3856",875,876,876,"white","age.gp3","NoTr","Trade","Group",24,4,8,6,6,2,18,4,7,17,2,22,14,10,2
"3857",1178,1179,1179,"white","age.gp4","Tr","NoTrade","NoGroup",7,0,2,3,2,0,6,1,3,4,0,7,5,2,2
"3858",1344,1345,1345,"white","age.gp1","Tr","NoTrade","NoGroup",14,9,0,1,4,0,12,2,3,11,2,12,8,6,2
"3859",1389,1390,1390,"black","age.gp3","NoTr","NoTrade","NoGroup",5,2,1,2,0,1,4,0,0,5,0,5,3,2,2
"3860",2145,2146,2146,"other","age.gp2","NoTr","NoTrade","NoGroup",4,1,1,2,0,0,4,0,2,2,0,4,4,0,2
"3861",2549,2550,2550,"other","age.gp1","NoTr","NoTrade","NoGroup",2,0,0,1,1,0,2,0,0,2,0,2,2,0,2
"3862",2881,2882,2882,"white","age.gp2","NoTr","NoTrade","NoGroup",13,0,9,3,1,1,10,2,6,7,0,13,11,2,2
"3863",2975,2976,2976,"white","age.gp1","NoTr","NoTrade","Group",19,7,6,3,3,2,13,4,10,9,0,19,12,7,2
"3864",106,107,107,"white","age.gp2","NoTr","NoTrade","NoGroup",7,0,5,2,0,0,5,2,3,4,0,7,6,1,2
"3865",198,199,199,"other","age.gp2","Tr","NoTrade","NoGroup",6,0,4,1,1,0,6,0,1,5,0,6,3,3,2
"3866",703,704,704,"white","age.gp2","NoTr","NoTrade","Group",24,3,14,5,2,2,19,3,11,13,0,24,15,9,2
"3867",1399,1400,1400,"white","age.gp3","NoTr","NoTrade","Group",19,4,5,5,5,2,14,3,7,12,0,19,13,6,2
"3868",2287,2288,2288,"other","age.gp2","Tr","NoTrade","Group",9,0,4,3,2,0,9,0,3,6,0,9,4,5,2
"3869",2476,2477,2477,"white","age.gp2","Tr","NoTrade","Group",26,4,13,6,3,2,19,5,10,16,1,25,15,11,2
"3870",2601,2602,2602,"white","age.gp3","NoTr","NoTrade","Group",22,2,8,9,3,2,19,1,8,14,3,19,18,4,2
"3871",2971,2972,2972,"white","age.gp2","NoTr","NoTrade","Group",17,2,9,5,1,3,14,0,5,12,4,13,12,5,2
"3872",174,175,175,"white","age.gp3","NoTr","NoTrade","NoGroup",8,1,2,2,3,0,7,1,3,5,0,8,3,5,2
"3873",689,690,690,"white","age.gp4","Tr","NoTrade","Group",13,1,4,2,6,3,9,1,7,6,2,11,10,3,2
"3874",1142,1143,1143,"white","age.gp1","NoTr","NoTrade","NoGroup",8,6,1,0,1,1,5,2,0,8,0,8,1,7,2
"3875",1419,1420,1420,"white","age.gp2","NoTr","NoTrade","Group",27,5,11,8,3,2,23,2,11,16,1,26,16,11,2
"3876",1567,1568,1568,"white","age.gp4","Tr","NoTrade","Group",12,0,4,2,6,0,10,2,6,6,0,12,8,4,2
"3877",2173,2174,2174,"white","age.gp2","NoTr","NoTrade","Group",34,3,23,4,4,1,31,2,17,17,0,34,23,11,2
"3878",2873,2874,2874,"white","age.gp1","NoTr","NoTrade","NoGroup",10,4,2,3,1,1,6,3,4,6,1,9,6,4,2
"3879",108,109,109,"white","age.gp2","NoTr","NoTrade","NoGroup",10,2,2,4,2,3,7,0,3,7,1,9,4,6,2
"3880",514,515,515,"black","age.gp3","NoTr","NoTrade","NoGroup",5,1,2,1,1,2,3,0,1,4,0,5,2,3,2
"3881",1057,1058,1058,"white","age.gp4","NoTr","NoTrade","Group",7,2,1,1,3,1,6,0,2,5,0,7,4,3,2
"3882",1258,1259,1259,"white","age.gp1","Tr","Trade","Group",24,11,6,3,4,2,17,5,6,18,2,22,11,13,2
"3883",1338,1339,1339,"white","age.gp3","NoTr","NoTrade","NoGroup",7,0,5,1,1,0,6,1,4,3,0,7,4,3,2
"3884",1671,1672,1672,"white","age.gp2","Tr","NoTrade","NoGroup",10,0,6,2,2,1,8,1,6,4,0,10,7,3,2
"3885",2513,2514,2514,"white","age.gp1","NoTr","NoTrade","NoGroup",6,1,2,2,1,0,6,0,4,2,0,6,3,3,2
"3886",2725,2726,2726,"black","age.gp3","NoTr","NoTrade","NoGroup",10,0,5,3,2,3,7,0,5,5,1,9,6,4,2
"3887",109,110,110,"white","age.gp2","NoTr","NoTrade","NoGroup",4,1,2,0,1,0,2,2,3,1,0,4,2,2,2
"3888",897,898,898,"other","age.gp1","Tr","NoTrade","NoGroup",7,2,4,1,0,1,6,0,1,6,0,7,3,4,2
"3889",2267,2268,2268,"white","age.gp4","Tr","NoTrade","Group",14,0,2,3,9,3,9,2,3,11,0,14,7,7,2
"3890",110,111,111,"white","age.gp2","NoTr","NoTrade","NoGroup",16,0,13,1,2,1,13,2,10,6,0,16,10,6,2
"3891",656,657,657,"white","age.gp2","Tr","NoTrade","NoGroup",10,3,4,1,2,0,8,2,1,9,0,10,5,5,2
"3892",658,659,659,"white","age.gp2","Tr","NoTrade","NoGroup",7,1,2,1,3,1,5,1,3,4,0,7,4,3,2
"3893",688,689,689,"white","age.gp4","Tr","NoTrade","Group",19,1,4,5,9,0,18,1,8,11,1,18,10,9,2
"3894",1099,1100,1100,"white","age.gp2","NoTr","NoTrade","Group",26,2,12,7,5,3,20,3,8,18,1,25,15,11,2
"3895",1317,1318,1318,"white","age.gp2","NoTr","NoTrade","NoGroup",12,2,8,2,0,1,9,2,5,7,1,11,6,6,2
"3896",1652,1653,1653,"other","age.gp2","NoTr","NoTrade","NoGroup",5,0,3,1,1,0,5,0,2,3,1,4,4,1,2
"3897",2198,2199,2199,"white","age.gp4","NoTr","NoTrade","NoGroup",5,1,2,2,0,0,3,2,1,4,2,3,2,3,2
"3898",2343,2344,2344,"white","age.gp2","Tr","NoTrade","Group",26,3,13,4,6,6,18,2,9,17,2,24,15,11,2
"3899",2957,2958,2958,"white","age.gp2","Tr","NoTrade","Group",20,1,7,10,2,2,18,0,6,14,0,20,12,8,2
"3900",111,112,112,"white","age.gp3","NoTr","NoTrade","NoGroup",6,1,3,2,0,0,5,1,5,1,0,6,3,3,2
"3901",1441,1442,1442,"white","age.gp3","Tr","NoTrade","NoGroup",6,0,3,2,1,0,5,1,1,5,0,6,3,3,2
"3902",2956,2957,2957,"white","age.gp2","Tr","NoTrade","Group",32,6,12,5,9,3,22,7,10,22,4,28,22,10,2
"3903",112,113,113,"white","age.gp3","NoTr","NoTrade","NoGroup",7,0,3,2,2,1,6,0,3,4,1,6,4,3,2
"3904",1957,1958,1958,"white","age.gp4","NoTr","NoTrade","Group",14,1,1,4,8,1,12,1,2,12,1,13,9,5,2
"3905",2310,2311,2311,"white","age.gp2","Tr","NoTrade","NoGroup",10,1,5,4,0,1,9,0,5,5,0,10,8,2,2
"3906",113,114,114,"white","age.gp3","NoTr","NoTrade","NoGroup",6,1,3,2,0,0,5,1,3,3,0,6,6,0,2
"3907",2060,2061,2061,"white","age.gp3","Tr","NoTrade","Group",18,3,3,4,8,2,14,2,7,11,0,18,9,9,2
"3908",2955,2956,2956,"white","age.gp2","Tr","NoTrade","Group",22,3,11,4,4,1,18,3,9,13,0,22,14,8,2
"3909",240,241,241,"white","age.gp2","Tr","NoTrade","Group",24,4,10,4,6,2,19,3,7,17,3,21,17,7,2
"3910",885,886,886,"white","age.gp3","NoTr","Trade","Group",12,1,4,5,2,1,11,0,5,7,1,11,9,3,2
"3911",917,918,918,"white","age.gp1","NoTr","Trade","NoGroup",16,5,5,4,2,1,11,4,4,12,2,14,7,9,2
"3912",935,936,936,"white","age.gp3","NoTr","NoTrade","NoGroup",10,2,4,1,3,1,6,3,4,6,0,10,5,5,2
"3913",2340,2341,2341,"white","age.gp2","Tr","NoTrade","Group",17,2,5,3,7,2,14,1,6,11,3,14,9,8,2
"3914",2242,2243,2243,"white","age.gp4","Tr","NoTrade","Group",14,2,2,3,7,1,11,2,5,9,0,14,7,7,2
"3915",2585,2586,2586,"white","age.gp4","NoTr","NoTrade","Group",9,2,1,3,3,0,8,1,2,7,3,6,6,3,2
"3916",116,117,117,"white","age.gp3","NoTr","NoTrade","NoGroup",5,0,2,2,1,0,4,1,3,2,0,5,4,1,2
"3917",1429,1430,1430,"white","age.gp3","Tr","NoTrade","NoGroup",11,2,4,2,3,0,9,2,5,6,1,10,6,5,2
"3918",2842,2843,2843,"white","age.gp2","Tr","NoTrade","Group",14,1,5,6,2,2,11,1,2,12,1,13,9,5,2
"3919",117,118,118,"white","age.gp3","NoTr","NoTrade","NoGroup",5,1,3,1,0,1,2,2,1,4,2,3,4,1,2
"3920",640,641,641,"other","age.gp1","NoTr","Trade","Group",10,2,6,2,0,2,8,0,5,5,1,9,6,4,2
"3921",848,849,849,"other","age.gp2","Tr","NoTrade","Group",7,0,3,2,2,0,7,0,2,5,0,7,5,2,2
"3922",2375,2376,2376,"white","age.gp2","NoTr","NoTrade","NoGroup",14,1,6,7,0,0,12,2,7,7,1,13,10,4,2
"3923",118,119,119,"white","age.gp3","NoTr","NoTrade","NoGroup",1,1,0,0,0,0,1,0,1,0,0,1,0,1,2
"3924",119,120,120,"white","age.gp3","NoTr","NoTrade","NoGroup",7,2,1,2,2,0,6,1,4,3,1,6,5,2,2
"3925",1790,1791,1791,"white","age.gp4","Tr","NoTrade","Group",14,0,4,2,8,2,11,1,4,10,0,14,9,5,2
"3926",1951,1952,1952,"white","age.gp4","NoTr","NoTrade","Group",17,1,1,3,12,4,13,0,5,12,2,15,8,9,2
"3927",2465,2466,2466,"white","age.gp1","Tr","NoTrade","NoGroup",14,3,4,4,3,1,11,2,4,10,0,14,6,8,2
"3928",2832,2833,2833,"white","age.gp2","Tr","NoTrade","NoGroup",7,1,2,2,2,0,7,0,3,4,1,6,4,3,2
"3929",120,121,121,"white","age.gp3","NoTr","NoTrade","NoGroup",10,0,3,4,3,3,7,0,2,8,4,6,6,4,2
"3930",381,382,382,"black","age.gp4","NoTr","NoTrade","NoGroup",7,0,1,2,4,3,3,1,2,5,0,7,3,4,2
"3931",886,887,887,"white","age.gp3","NoTr","Trade","Group",12,1,4,4,3,1,11,0,6,6,0,12,8,4,2
"3932",1989,1990,1990,"white","age.gp4","Tr","NoTrade","NoGroup",5,0,2,2,1,1,4,0,1,4,1,4,4,1,2
"3933",2108,2109,2109,"white","age.gp2","NoTr","NoTrade","NoGroup",13,3,5,1,4,1,8,4,6,7,1,12,9,4,2
"3934",2410,2411,2411,"white","age.gp3","NoTr","Trade","Group",13,0,5,5,3,0,13,0,2,11,1,12,10,3,2
"3935",2563,2564,2564,"white","age.gp4","NoTr","NoTrade","Group",11,1,3,2,5,1,10,0,3,8,0,11,6,5,2
"3936",2776,2777,2777,"white","age.gp3","NoTr","NoTrade","Group",18,2,6,6,4,2,15,1,8,10,4,14,12,6,2
"3937",121,122,122,"white","age.gp3","NoTr","NoTrade","NoGroup",6,3,1,2,0,2,4,0,3,3,1,5,1,5,2
"3938",327,328,328,"white","age.gp1","NoTr","NoTrade","NoGroup",14,9,1,4,0,0,9,5,5,9,1,13,4,10,2
"3939",1597,1598,1598,"black","age.gp1","Tr","Trade","NoGroup",9,2,3,3,1,3,5,1,2,7,1,8,6,3,2
"3940",1613,1614,1614,"white","age.gp3","Tr","NoTrade","NoGroup",6,0,3,1,2,0,5,1,2,4,0,6,3,3,2
"3941",2771,2772,2772,"white","age.gp1","NoTr","NoTrade","NoGroup",11,5,3,3,0,1,5,5,3,8,0,11,5,6,2
"3942",122,123,123,"white","age.gp3","NoTr","NoTrade","NoGroup",13,4,5,1,3,0,9,4,5,8,3,10,6,7,2
"3943",132,133,133,"white","age.gp2","NoTr","NoTrade","NoGroup",12,3,4,3,2,0,10,2,4,8,2,10,9,3,2
"3944",408,409,409,"white","age.gp2","Tr","Trade","Group",23,2,12,8,1,1,21,1,8,15,1,22,15,8,2
"3945",846,847,847,"other","age.gp2","Tr","NoTrade","Group",11,0,5,3,3,1,10,0,5,6,0,11,7,4,2
"3946",1697,1698,1698,"white","age.gp4","NoTr","Trade","NoGroup",4,0,2,1,1,0,4,0,2,2,0,4,2,2,2
"3947",2284,2285,2285,"other","age.gp2","Tr","NoTrade","Group",9,0,4,5,0,1,8,0,3,6,0,9,6,3,2
"3948",2438,2439,2439,"white","age.gp4","NoTr","NoTrade","NoGroup",2,0,1,1,0,0,2,0,1,1,0,2,0,2,2
"3949",2467,2468,2468,"white","age.gp1","NoTr","NoTrade","NoGroup",12,5,2,4,1,0,10,2,6,6,2,10,6,6,2
"3950",2478,2479,2479,"other","age.gp1","NoTr","NoTrade","NoGroup",7,4,0,2,1,0,7,0,1,6,2,5,4,3,2
"3951",2919,2920,2920,"white","age.gp1","NoTr","NoTrade","NoGroup",12,4,1,7,0,1,10,1,4,8,2,10,7,5,2
"3952",123,124,124,"white","age.gp3","NoTr","NoTrade","NoGroup",4,1,1,1,1,0,3,1,2,2,1,3,3,1,2
"3953",628,629,629,"other","age.gp1","NoTr","Trade","Group",1,0,0,1,0,0,1,0,0,1,0,1,0,1,2
"3954",124,125,125,"white","age.gp3","NoTr","NoTrade","NoGroup",6,0,2,3,1,0,6,0,3,3,1,5,6,0,2
"3955",691,692,692,"white","age.gp4","Tr","NoTrade","Group",12,1,4,4,3,0,11,1,4,8,0,12,5,7,2
"3956",2960,2961,2961,"white","age.gp2","NoTr","NoTrade","Group",16,0,12,4,0,1,11,4,8,8,4,12,11,5,2
"3957",219,220,220,"other","age.gp2","Tr","NoTrade","NoGroup",4,0,1,1,2,1,3,0,2,2,1,3,2,2,2
"3958",824,825,825,"white","age.gp3","NoTr","NoTrade","NoGroup",3,0,1,2,0,0,2,1,1,2,0,3,1,2,2
"3959",2724,2725,2725,"black","age.gp3","NoTr","NoTrade","NoGroup",7,1,1,3,2,3,3,1,2,5,0,7,4,3,2
"3960",126,127,127,"white","age.gp1","NoTr","NoTrade","NoGroup",7,3,3,1,0,0,7,0,3,4,3,4,5,2,2
"3961",1254,1255,1255,"white","age.gp1","Tr","Trade","Group",32,18,5,4,5,4,23,5,6,26,1,31,18,14,2
"3962",1463,1464,1464,"white","age.gp1","NoTr","NoTrade","NoGroup",12,8,4,0,0,0,9,3,1,11,2,10,5,7,2
"3963",2643,2644,2644,"white","age.gp1","NoTr","NoTrade","NoGroup",15,9,2,3,1,0,12,3,5,10,4,11,10,5,2
"3964",127,128,128,"white","age.gp1","NoTr","NoTrade","NoGroup",13,7,4,1,1,3,7,3,4,9,3,10,8,5,2
"3965",641,642,642,"other","age.gp1","NoTr","Trade","Group",10,5,2,3,0,0,9,1,3,7,0,10,5,5,2
"3966",715,716,716,"black","age.gp4","NoTr","NoTrade","NoGroup",3,1,0,1,1,1,2,0,1,2,0,3,1,2,2
"3967",1138,1139,1139,"white","age.gp1","NoTr","NoTrade","NoGroup",10,5,1,1,3,2,8,0,1,9,0,10,4,6,2
"3968",1380,1381,1381,"white","age.gp1","NoTr","NoTrade","NoGroup",16,10,2,2,2,1,11,4,2,14,2,14,4,12,2
"3969",1644,1645,1645,"other","age.gp2","NoTr","NoTrade","NoGroup",7,1,4,1,1,1,6,0,3,4,0,7,4,3,2
"3970",1667,1668,1668,"black","age.gp1","Tr","Trade","Group",13,6,3,3,1,7,5,1,2,11,1,12,5,8,2
"3971",2326,2327,2327,"white","age.gp3","Tr","NoTrade","Group",20,2,4,10,4,2,16,2,6,14,3,17,12,8,2
"3972",2457,2458,2458,"black","age.gp1","NoTr","NoTrade","NoGroup",6,2,3,0,1,2,2,2,1,5,0,6,1,5,2
"3973",128,129,129,"white","age.gp1","NoTr","NoTrade","NoGroup",10,4,4,0,2,0,8,2,4,6,0,10,4,6,2
"3974",286,287,287,"white","age.gp1","NoTr","NoTrade","NoGroup",12,7,3,1,1,1,8,3,2,10,2,10,8,4,2
"3975",509,510,510,"white","age.gp2","Tr","NoTrade","NoGroup",7,1,4,1,1,0,7,0,2,5,0,7,5,2,2
"3976",1012,1013,1013,"white","age.gp1","Tr","NoTrade","NoGroup",13,7,3,2,1,0,11,2,3,10,0,13,5,8,2
"3977",2255,2256,2256,"white","age.gp4","Tr","NoTrade","Group",12,4,1,1,6,3,7,2,4,8,0,12,6,6,2
"3978",2807,2808,2808,"other","age.gp2","NoTr","NoTrade","NoGroup",4,1,0,1,2,0,4,0,0,4,0,4,3,1,2
"3979",2897,2898,2898,"other","age.gp1","NoTr","NoTrade","NoGroup",4,2,1,1,0,0,4,0,1,3,0,4,2,2,2
"3980",2949,2950,2950,"white","age.gp4","NoTr","NoTrade","Group",8,1,4,1,2,0,7,1,4,4,0,8,6,2,2
"3981",129,130,130,"white","age.gp1","NoTr","NoTrade","NoGroup",6,3,0,0,3,1,5,0,3,3,1,5,1,5,2
"3982",1191,1192,1192,"white","age.gp4","Tr","NoTrade","NoGroup",4,1,0,1,2,1,3,0,0,4,1,3,2,2,2
"3983",1201,1202,1202,"white","age.gp4","Tr","NoTrade","NoGroup",4,1,1,0,2,1,3,0,0,4,0,4,2,2,2
"3984",1340,1341,1341,"white","age.gp1","Tr","NoTrade","NoGroup",9,5,1,1,2,0,8,1,3,6,0,9,4,5,2
"3985",1478,1479,1479,"black","age.gp1","NoTr","NoTrade","NoGroup",10,5,1,3,1,3,6,1,5,5,0,10,2,8,2
"3986",1706,1707,1707,"white","age.gp4","NoTr","Trade","NoGroup",5,1,2,1,1,1,4,0,1,4,0,5,1,4,2
"3987",2976,2977,2977,"white","age.gp1","NoTr","NoTrade","Group",19,8,5,3,3,2,15,2,9,10,2,17,10,9,2
"3988",130,131,131,"white","age.gp1","NoTr","NoTrade","NoGroup",11,7,3,1,0,2,8,1,4,7,1,10,5,6,2
"3989",1315,1316,1316,"white","age.gp2","NoTr","NoTrade","NoGroup",13,1,6,2,4,2,11,0,5,8,1,12,10,3,2
"3990",1324,1325,1325,"white","age.gp2","Tr","NoTrade","Group",20,5,9,4,2,4,13,3,6,14,4,16,12,8,2
"3991",1449,1450,1450,"black","age.gp1","NoTr","NoTrade","NoGroup",11,5,5,1,0,6,5,0,3,8,1,10,5,6,2
"3992",1737,1738,1738,"white","age.gp3","Tr","NoTrade","Group",19,2,9,3,5,2,14,3,5,14,3,16,9,10,2
"3993",1902,1903,1903,"black","age.gp1","NoTr","NoTrade","NoGroup",5,1,0,2,2,2,2,1,0,5,1,4,2,3,2
"3994",2470,2471,2471,"white","age.gp1","NoTr","NoTrade","NoGroup",12,4,5,2,1,1,10,1,2,10,2,10,7,5,2
"3995",131,132,132,"white","age.gp2","NoTr","NoTrade","NoGroup",12,2,6,3,1,0,12,0,5,7,2,10,10,2,2
"3996",236,237,237,"white","age.gp2","Tr","NoTrade","Group",18,2,7,5,4,1,16,1,9,9,2,16,12,6,2
"3997",546,547,547,"white","age.gp4","NoTr","NoTrade","NoGroup",5,1,2,1,1,0,5,0,2,3,0,5,3,2,2
"3998",1005,1006,1006,"white","age.gp1","Tr","NoTrade","Group",24,9,5,4,6,2,19,3,4,20,3,21,13,11,2
"3999",1435,1436,1436,"white","age.gp3","Tr","NoTrade","NoGroup",8,1,4,0,3,1,7,0,5,3,0,8,6,2,2
"4000",1466,1467,1467,"white","age.gp2","NoTr","Trade","Group",19,1,10,3,5,1,15,3,8,11,1,18,10,9,2
"4001",1736,1737,1737,"white","age.gp3","Tr","NoTrade","Group",20,3,8,5,4,1,18,1,6,14,1,19,13,7,2
"4002",2651,2652,2652,"white","age.gp2","NoTr","NoTrade","Group",12,1,7,2,2,2,10,0,5,7,0,12,6,6,2
"4003",288,289,289,"white","age.gp1","NoTr","NoTrade","NoGroup",9,3,4,0,2,1,6,2,4,5,1,8,4,5,2
"4004",638,639,639,"other","age.gp1","NoTr","Trade","Group",11,4,2,2,3,1,10,0,1,10,0,11,5,6,2
"4005",1408,1409,1409,"white","age.gp3","NoTr","NoTrade","Group",11,1,6,3,1,2,8,1,7,4,0,11,3,8,2
"4006",1939,1940,1940,"white","age.gp4","NoTr","NoTrade","Group",16,0,6,3,7,2,13,1,7,9,2,14,12,4,2
"4007",2910,2911,2911,"other","age.gp1","NoTr","NoTrade","NoGroup",5,1,2,1,1,0,5,0,0,5,0,5,2,3,2
"4008",133,134,134,"white","age.gp2","NoTr","NoTrade","NoGroup",12,2,8,1,1,0,12,0,6,6,1,11,9,3,2
"4009",693,694,694,"white","age.gp4","Tr","NoTrade","Group",9,0,1,1,7,2,7,0,3,6,0,9,4,5,2
"4010",1708,1709,1709,"white","age.gp2","Tr","NoTrade","Group",23,2,14,2,5,3,17,3,9,14,2,21,17,6,2
"4011",2307,2308,2308,"white","age.gp2","NoTr","NoTrade","NoGroup",6,1,2,2,1,0,5,1,2,4,0,6,4,2,2
"4012",2788,2789,2789,"white","age.gp2","NoTr","NoTrade","Group",25,5,10,8,2,2,19,4,12,13,1,24,17,8,2
"4013",134,135,135,"white","age.gp2","NoTr","NoTrade","NoGroup",10,0,9,1,0,0,9,1,6,4,1,9,8,2,2
"4014",1707,1708,1708,"white","age.gp2","Tr","NoTrade","Group",26,3,12,6,5,2,21,3,10,16,3,23,18,8,2
"4015",2131,2132,2132,"white","age.gp3","NoTr","NoTrade","Group",17,4,4,7,2,0,14,3,7,10,2,15,10,7,2
"4016",135,136,136,"white","age.gp2","NoTr","NoTrade","NoGroup",11,1,4,3,3,0,11,0,6,5,0,11,7,4,2
"4017",342,343,343,"white","age.gp2","NoTr","NoTrade","Group",24,1,14,5,4,3,17,4,9,15,1,23,12,12,2
"4018",1602,1603,1603,"white","age.gp2","Tr","NoTrade","NoGroup",13,1,6,4,2,2,10,1,4,9,1,12,9,4,2
"4019",1978,1979,1979,"white","age.gp4","Tr","NoTrade","NoGroup",4,0,1,2,1,0,4,0,1,3,1,3,1,3,2
"4020",2061,2062,2062,"white","age.gp3","Tr","NoTrade","Group",20,3,5,5,7,1,17,2,8,12,0,20,8,12,2
"4021",2573,2574,2574,"white","age.gp4","NoTr","NoTrade","Group",11,1,4,1,5,2,9,0,7,4,1,10,8,3,2
"4022",208,209,209,"other","age.gp2","Tr","NoTrade","NoGroup",10,1,5,1,3,4,5,1,2,8,1,9,5,5,2
"4023",1273,1274,1274,"white","age.gp4","NoTr","NoTrade","Group",14,1,1,4,8,3,11,0,4,10,0,14,10,4,2
"4024",1331,1332,1332,"white","age.gp3","NoTr","NoTrade","NoGroup",9,1,5,2,1,1,7,1,2,7,1,8,4,5,2
"4025",1860,1861,1861,"white","age.gp3","NoTr","NoTrade","Group",15,2,5,4,4,1,12,2,6,9,0,15,7,8,2
"4026",2132,2133,2133,"other","age.gp2","NoTr","NoTrade","NoGroup",2,0,2,0,0,0,2,0,1,1,0,2,1,1,2
"4027",2314,2315,2315,"white","age.gp2","Tr","NoTrade","NoGroup",12,0,8,3,1,0,12,0,5,7,0,12,7,5,2
"4028",2358,2359,2359,"white","age.gp3","Tr","NoTrade","NoGroup",10,0,6,2,2,1,9,0,5,5,0,10,5,5,2
"4029",2670,2671,2671,"white","age.gp3","NoTr","NoTrade","NoGroup",9,2,4,2,1,0,8,1,2,7,1,8,3,6,2
"4030",2746,2747,2747,"white","age.gp2","NoTr","NoTrade","Group",21,3,10,4,4,0,18,3,9,12,1,20,15,6,2
"4031",1335,1336,1336,"white","age.gp3","NoTr","NoTrade","NoGroup",3,0,1,1,1,0,3,0,1,2,0,3,2,1,2
"4032",2248,2249,2249,"white","age.gp4","Tr","NoTrade","Group",18,1,6,2,9,1,16,1,4,14,1,17,11,7,2
"4033",2648,2649,2649,"white","age.gp2","NoTr","NoTrade","Group",18,2,12,3,1,2,12,4,8,10,1,17,12,6,2
"4034",150,151,151,"white","age.gp3","NoTr","NoTrade","Group",26,3,10,6,7,3,21,2,11,15,0,26,18,8,2
"4035",229,230,230,"white","age.gp2","Tr","NoTrade","Group",25,0,16,5,4,3,18,4,10,15,3,22,14,11,2
"4036",1265,1266,1266,"black","age.gp3","NoTr","NoTrade","NoGroup",5,0,2,1,2,3,2,0,1,4,0,5,3,2,2
"4037",2177,2178,2178,"white","age.gp4","NoTr","NoTrade","NoGroup",11,1,4,1,5,2,9,0,3,8,0,11,4,7,2
"4038",2425,2426,2426,"white","age.gp4","NoTr","NoTrade","NoGroup",6,0,2,2,2,1,4,1,1,5,1,5,3,3,2
"4039",2763,2764,2764,"black","age.gp2","NoTr","NoTrade","NoGroup",8,1,3,2,2,3,4,1,2,6,0,8,3,5,2
"4040",2784,2785,2785,"white","age.gp3","NoTr","NoTrade","Group",18,1,7,9,1,0,15,3,6,12,2,16,13,5,2
"4041",139,140,140,"white","age.gp2","NoTr","NoTrade","NoGroup",11,2,2,6,1,0,10,1,8,3,0,11,8,3,2
"4042",148,149,149,"white","age.gp3","NoTr","NoTrade","Group",19,1,7,6,5,1,16,2,8,11,0,19,14,5,2
"4043",943,944,944,"white","age.gp3","Tr","NoTrade","Group",16,1,6,3,6,2,12,2,4,12,1,15,6,10,2
"4044",2265,2266,2266,"white","age.gp4","Tr","NoTrade","Group",13,0,4,3,6,1,12,0,6,7,3,10,8,5,2
"4045",1407,1408,1408,"white","age.gp3","NoTr","NoTrade","Group",15,0,9,4,2,1,11,3,8,7,0,15,8,7,2
"4046",1465,1466,1466,"white","age.gp2","NoTr","Trade","Group",23,5,13,3,2,0,21,2,11,12,1,22,13,10,2
"4047",1820,1821,1821,"black","age.gp4","NoTr","NoTrade","NoGroup",4,1,1,2,0,1,3,0,0,4,0,4,2,2,2
"4048",2805,2806,2806,"other","age.gp2","NoTr","NoTrade","NoGroup",10,0,7,3,0,2,8,0,4,6,1,9,7,3,2
"4049",141,142,142,"white","age.gp3","NoTr","NoTrade","Group",14,2,9,2,1,1,8,5,8,6,2,12,8,6,2
"4050",284,285,285,"white","age.gp2","Tr","NoTrade","Group",17,1,8,4,4,2,13,2,7,10,0,17,12,5,2
"4051",909,910,910,"other","age.gp1","Tr","NoTrade","NoGroup",4,1,0,3,0,1,3,0,1,3,0,4,3,1,2
"4052",1670,1671,1671,"white","age.gp2","Tr","NoTrade","NoGroup",12,0,5,6,1,2,9,1,3,9,1,11,8,4,2
"4053",1801,1802,1802,"white","age.gp4","Tr","NoTrade","Group",8,0,1,3,4,0,8,0,3,5,0,8,7,1,2
"4054",1855,1856,1856,"white","age.gp3","NoTr","NoTrade","Group",19,3,4,6,6,2,16,1,7,12,3,16,11,8,2
"4055",2533,2534,2534,"other","age.gp1","NoTr","NoTrade","NoGroup",5,3,1,1,0,0,5,0,2,3,0,5,3,2,2
"4056",2810,2811,2811,"other","age.gp2","NoTr","NoTrade","NoGroup",5,0,3,2,0,1,4,0,1,4,1,4,5,0,2
"4057",2968,2969,2969,"white","age.gp2","NoTr","NoTrade","Group",22,3,5,6,8,3,15,4,7,15,1,21,12,10,2
"4058",432,433,433,"white","age.gp4","NoTr","NoTrade","NoGroup",7,0,1,1,5,0,6,1,0,7,0,7,5,2,2
"4059",695,696,696,"white","age.gp4","Tr","NoTrade","Group",16,1,5,3,7,1,13,2,5,11,1,15,13,3,2
"4060",1077,1078,1078,"white","age.gp4","NoTr","NoTrade","Group",11,0,2,4,5,0,11,0,4,7,1,10,8,3,2
"4061",1862,1863,1863,"white","age.gp3","NoTr","NoTrade","Group",16,3,4,4,5,2,13,1,4,12,1,15,8,8,2
"4062",1919,1920,1920,"other","age.gp2","NoTr","NoTrade","NoGroup",8,0,3,2,3,0,8,0,3,5,1,7,5,3,2
"4063",2022,2023,2023,"black","age.gp4","NoTr","NoTrade","NoGroup",3,0,0,3,0,1,2,0,0,3,1,2,3,0,2
"4064",2122,2123,2123,"white","age.gp3","NoTr","NoTrade","Group",19,4,6,4,5,0,18,1,7,12,1,18,11,8,2
"4065",143,144,144,"white","age.gp3","NoTr","NoTrade","Group",21,4,6,7,4,2,14,5,6,15,2,19,14,7,2
"4066",175,176,176,"white","age.gp3","NoTr","NoTrade","NoGroup",9,1,6,1,1,0,6,3,4,5,1,8,7,2,2
"4067",645,646,646,"other","age.gp1","NoTr","Trade","Group",10,5,2,3,0,0,10,0,4,6,1,9,5,5,2
"4068",961,962,962,"black","age.gp2","NoTr","NoTrade","Group",12,3,5,3,1,7,5,0,2,10,1,11,7,5,2
"4069",1069,1070,1070,"white","age.gp4","NoTr","NoTrade","Group",7,0,0,3,4,1,6,0,2,5,1,6,5,2,2
"4070",1169,1170,1170,"white","age.gp4","NoTr","NoTrade","NoGroup",7,0,0,2,5,1,6,0,2,5,0,7,4,3,2
"4071",1886,1887,1887,"other","age.gp1","NoTr","NoTrade","Group",11,3,1,3,4,3,8,0,3,8,2,9,7,4,2
"4072",2112,2113,2113,"white","age.gp2","NoTr","NoTrade","NoGroup",4,1,2,1,0,0,4,0,0,4,0,4,3,1,2
"4073",2878,2879,2879,"white","age.gp2","NoTr","NoTrade","NoGroup",13,0,7,3,3,0,12,1,7,6,0,13,11,2,2
"4074",144,145,145,"white","age.gp3","NoTr","NoTrade","Group",13,1,3,5,4,0,12,1,5,8,0,13,8,5,2
"4075",185,186,186,"white","age.gp3","Tr","NoTrade","NoGroup",7,0,2,1,4,0,7,0,3,4,1,6,7,0,2
"4076",597,598,598,"other","age.gp4","NoTr","NoTrade","NoGroup",6,0,1,2,3,0,6,0,2,4,0,6,4,2,2
"4077",680,681,681,"white","age.gp4","Tr","NoTrade","Group",6,0,0,3,3,0,6,0,2,4,0,6,5,1,2
"4078",1552,1553,1553,"white","age.gp3","NoTr","NoTrade","Group",11,1,5,4,1,1,6,4,4,7,1,10,8,3,2
"4079",1598,1599,1599,"white","age.gp2","Tr","NoTrade","NoGroup",10,0,3,5,2,1,9,0,3,7,1,9,6,4,2
"4080",1716,1717,1717,"white","age.gp1","Tr","NoTrade","NoGroup",4,2,0,2,0,0,4,0,1,3,0,4,2,2,2
"4081",2257,2258,2258,"white","age.gp4","Tr","NoTrade","Group",9,0,0,4,5,3,6,0,0,9,2,7,6,3,2
"4082",2700,2701,2701,"white","age.gp4","NoTr","NoTrade","Group",12,1,3,2,6,1,11,0,4,8,1,11,9,3,2
"4083",2753,2754,2754,"white","age.gp3","NoTr","NoTrade","NoGroup",12,2,5,2,3,0,7,5,6,6,1,11,8,4,2
"4084",2787,2788,2788,"white","age.gp2","NoTr","NoTrade","Group",21,0,12,6,3,2,18,1,11,10,4,17,19,2,2
"4085",145,146,146,"white","age.gp3","NoTr","NoTrade","Group",16,1,6,6,3,1,12,3,9,7,2,14,10,6,2
"4086",149,150,150,"white","age.gp3","NoTr","NoTrade","Group",16,3,5,7,1,3,12,1,7,9,1,15,10,6,2
"4087",187,188,188,"white","age.gp3","Tr","NoTrade","NoGroup",5,0,2,3,0,0,5,0,2,3,0,5,5,0,2
"4088",927,928,928,"white","age.gp3","NoTr","NoTrade","NoGroup",5,1,1,2,1,0,4,1,4,1,0,5,4,1,2
"4089",950,951,951,"white","age.gp3","Tr","NoTrade","Group",20,1,5,8,6,4,16,0,7,13,2,18,15,5,2
"4090",1063,1064,1064,"white","age.gp4","NoTr","NoTrade","Group",11,0,1,3,7,1,10,0,3,8,0,11,7,4,2
"4091",1279,1280,1280,"white","age.gp4","NoTr","NoTrade","Group",11,1,0,4,6,0,11,0,7,4,0,11,9,2,2
"4092",1609,1610,1610,"white","age.gp3","Tr","NoTrade","NoGroup",14,3,3,4,4,1,12,1,4,10,0,14,9,5,2
"4093",2313,2314,2314,"white","age.gp2","Tr","NoTrade","NoGroup",12,0,6,3,3,1,9,2,7,5,0,12,8,4,2
"4094",2472,2473,2473,"white","age.gp2","Tr","NoTrade","Group",16,0,7,7,2,1,13,2,6,10,1,15,12,4,2
"4095",2562,2563,2563,"white","age.gp4","NoTr","NoTrade","Group",9,0,2,3,4,0,9,0,6,3,0,9,4,5,2
"4096",146,147,147,"white","age.gp3","NoTr","NoTrade","Group",18,3,6,6,3,1,16,1,6,12,2,16,14,4,2
"4097",232,233,233,"white","age.gp2","Tr","NoTrade","Group",23,2,8,8,5,3,20,0,8,15,1,22,16,7,2
"4098",631,632,632,"other","age.gp1","NoTr","Trade","Group",13,8,1,1,3,1,12,0,3,10,1,12,5,8,2
"4099",879,880,880,"white","age.gp3","NoTr","Trade","Group",18,3,7,4,4,3,13,2,7,11,0,18,12,6,2
"4100",944,945,945,"white","age.gp3","Tr","NoTrade","Group",20,3,5,8,4,1,17,2,7,13,0,20,13,7,2
"4101",1277,1278,1278,"white","age.gp4","NoTr","NoTrade","Group",10,0,1,3,6,0,10,0,5,5,0,10,8,2,2
"4102",1314,1315,1315,"white","age.gp1","NoTr","NoTrade","NoGroup",15,5,6,4,0,0,13,2,9,6,0,15,5,10,2
"4103",1325,1326,1326,"white","age.gp3","NoTr","NoTrade","NoGroup",12,1,3,7,1,1,11,0,2,10,2,10,9,3,2
"4104",2054,2055,2055,"white","age.gp4","Tr","NoTrade","Group",12,0,1,2,9,0,12,0,4,8,0,12,9,3,2
"4105",2110,2111,2111,"white","age.gp2","NoTr","NoTrade","NoGroup",9,0,4,2,3,1,8,0,4,5,2,7,6,3,2
"4106",2603,2604,2604,"white","age.gp3","NoTr","NoTrade","Group",17,2,1,8,6,3,13,1,6,11,0,17,11,6,2
"4107",2833,2834,2834,"white","age.gp2","Tr","NoTrade","NoGroup",12,0,4,4,4,2,9,1,5,7,0,12,9,3,2
"4108",2885,2886,2886,"white","age.gp1","NoTr","NoTrade","Group",24,13,3,6,2,1,20,3,8,16,3,21,13,11,2
"4109",452,453,453,"black","age.gp3","NoTr","NoTrade","NoGroup",6,0,2,3,1,3,2,1,1,5,0,6,4,2,2
"4110",1021,1022,1022,"white","age.gp2","NoTr","Trade","Group",16,1,9,5,1,0,13,3,6,10,1,15,8,8,2
"4111",1134,1135,1135,"white","age.gp2","Tr","NoTrade","Group",28,3,16,3,6,0,21,7,12,16,1,27,24,4,2
"4112",1950,1951,1951,"white","age.gp4","NoTr","NoTrade","Group",16,1,0,4,11,0,15,1,4,12,0,16,9,7,2
"4113",2107,2108,2108,"white","age.gp2","NoTr","NoTrade","NoGroup",12,1,5,1,5,1,11,0,3,9,1,11,9,3,2
"4114",2109,2110,2110,"white","age.gp2","NoTr","NoTrade","NoGroup",7,0,3,4,0,0,7,0,4,3,0,7,5,2,2
"4115",2119,2120,2120,"white","age.gp3","NoTr","NoTrade","Group",20,3,5,5,7,2,15,3,5,15,4,16,15,5,2
"4116",2482,2483,2483,"other","age.gp1","NoTr","NoTrade","NoGroup",4,2,0,1,1,0,4,0,0,4,0,4,2,2,2
"4117",2514,2515,2515,"white","age.gp1","NoTr","NoTrade","NoGroup",9,2,1,3,3,2,6,1,2,7,1,8,4,5,2
"4118",707,708,708,"white","age.gp2","Tr","NoTrade","Group",21,2,10,8,1,3,13,5,7,14,0,21,11,10,2
"4119",1151,1152,1152,"white","age.gp4","NoTr","NoTrade","NoGroup",6,0,2,1,3,1,5,0,3,3,0,6,5,1,2
"4120",1774,1775,1775,"white","age.gp4","Tr","NoTrade","Group",10,0,1,2,7,2,7,1,4,6,1,9,6,4,2
"4121",1788,1789,1789,"white","age.gp4","Tr","NoTrade","Group",10,1,3,1,5,1,9,0,3,7,1,9,6,4,2
"4122",2062,2063,2063,"white","age.gp3","Tr","NoTrade","Group",17,5,4,5,3,0,17,0,4,13,2,15,15,2,2
"4123",2439,2440,2440,"white","age.gp4","NoTr","NoTrade","NoGroup",8,2,1,2,3,0,7,1,3,5,0,8,5,3,2
"4124",2783,2784,2784,"white","age.gp3","NoTr","NoTrade","Group",21,2,8,7,4,3,16,2,7,14,2,19,13,8,2
"4125",2875,2876,2876,"white","age.gp1","NoTr","NoTrade","NoGroup",9,3,2,3,1,1,5,3,2,7,1,8,6,3,2
"4126",2924,2925,2925,"white","age.gp4","NoTr","NoTrade","Group",12,1,3,2,6,0,11,1,6,6,0,12,8,4,2
"4127",465,466,466,"black","age.gp3","NoTr","Trade","Group",13,1,4,6,2,4,7,2,4,9,1,12,7,6,2
"4128",826,827,827,"white","age.gp3","NoTr","NoTrade","NoGroup",12,1,4,2,5,2,10,0,5,7,1,11,8,4,2
"4129",1053,1054,1054,"white","age.gp4","NoTr","NoTrade","Group",11,1,2,4,4,1,9,1,3,8,0,11,7,4,2
"4130",1272,1273,1273,"black","age.gp3","NoTr","NoTrade","NoGroup",10,1,2,5,2,5,4,1,3,7,2,8,4,6,2
"4131",1616,1617,1617,"white","age.gp3","Tr","NoTrade","NoGroup",9,0,5,2,2,0,8,1,4,5,1,8,7,2,2
"4132",1807,1808,1808,"white","age.gp2","Tr","NoTrade","Group",21,1,8,7,5,2,16,3,10,11,3,18,18,3,2
"4133",2517,2518,2518,"black","age.gp2","NoTr","NoTrade","Group",16,0,9,5,2,8,7,1,1,15,3,13,11,5,2
"4134",2876,2877,2877,"white","age.gp1","NoTr","NoTrade","NoGroup",8,3,2,1,2,0,8,0,2,6,0,8,6,2,2
"4135",211,212,212,"other","age.gp2","Tr","NoTrade","NoGroup",10,2,4,4,0,1,9,0,2,8,0,10,7,3,2
"4136",346,347,347,"white","age.gp2","NoTr","NoTrade","Group",23,3,10,5,5,3,18,2,6,17,1,22,17,6,2
"4137",557,558,558,"white","age.gp4","NoTr","NoTrade","NoGroup",3,1,1,1,0,0,1,2,1,2,0,3,2,1,2
"4138",1253,1254,1254,"white","age.gp2","Tr","NoTrade","Group",31,3,14,9,5,3,21,7,10,21,1,30,21,10,2
"4139",1394,1395,1395,"black","age.gp3","NoTr","NoTrade","NoGroup",7,0,4,3,0,4,2,1,1,6,1,6,4,3,2
"4140",1446,1447,1447,"white","age.gp1","NoTr","NoTrade","NoGroup",12,4,3,3,2,1,9,2,3,9,2,10,10,2,2
"4141",1585,1586,1586,"white","age.gp4","Tr","NoTrade","Group",14,0,2,1,11,0,14,0,3,11,0,14,13,1,2
"4142",1884,1885,1885,"other","age.gp1","NoTr","NoTrade","Group",8,4,1,2,1,0,8,0,3,5,0,8,3,5,2
"4143",1941,1942,1942,"white","age.gp4","NoTr","NoTrade","Group",8,0,2,3,3,0,8,0,3,5,0,8,6,2,2
"4144",2105,2106,2106,"white","age.gp2","Tr","NoTrade","Group",31,4,17,4,6,2,24,5,14,17,1,30,21,10,2
"4145",2270,2271,2271,"white","age.gp4","Tr","NoTrade","Group",14,2,3,4,5,1,11,2,6,8,2,12,10,4,2
"4146",2335,2336,2336,"white","age.gp3","Tr","NoTrade","Group",13,1,8,3,1,0,11,2,5,8,1,12,7,6,2
"4147",2392,2393,2393,"black","age.gp2","NoTr","NoTrade","NoGroup",7,1,3,2,1,3,3,1,0,7,3,4,7,0,2
"4148",2449,2450,2450,"white","age.gp4","NoTr","NoTrade","NoGroup",5,0,2,2,1,1,4,0,3,2,0,5,5,0,2
"4149",151,152,152,"white","age.gp3","NoTr","NoTrade","Group",16,0,8,5,3,2,14,0,8,8,2,14,12,4,2
"4150",777,778,778,"white","age.gp4","NoTr","NoTrade","NoGroup",9,0,2,3,4,1,8,0,3,6,0,9,8,1,2
"4151",1393,1394,1394,"black","age.gp3","NoTr","NoTrade","NoGroup",4,0,0,3,1,2,2,0,1,3,1,3,4,0,2
"4152",1971,1972,1972,"white","age.gp4","Tr","NoTrade","NoGroup",11,1,3,1,6,2,7,2,2,9,0,11,5,6,2
"4153",2524,2525,2525,"white","age.gp2","Tr","NoTrade","Group",17,0,12,2,3,1,14,2,6,11,1,16,13,4,2
"4154",2709,2710,2710,"white","age.gp4","NoTr","NoTrade","Group",14,2,4,5,3,0,12,2,4,10,1,13,5,9,2
"4155",152,153,153,"white","age.gp3","NoTr","NoTrade","Group",14,2,3,5,4,1,13,0,5,9,2,12,9,5,2
"4156",171,172,172,"white","age.gp3","NoTr","NoTrade","NoGroup",6,1,3,1,1,1,3,2,4,2,0,6,4,2,2
"4157",337,338,338,"white","age.gp1","NoTr","Trade","Group",12,6,2,2,2,2,7,3,4,8,1,11,7,5,2
"4158",929,930,930,"white","age.gp3","NoTr","NoTrade","NoGroup",9,1,3,4,1,0,7,2,3,6,0,9,8,1,2
"4159",2231,2232,2232,"black","age.gp4","NoTr","Trade","Group",6,2,1,1,2,3,3,0,0,6,2,4,4,2,2
"4160",153,154,154,"white","age.gp3","NoTr","NoTrade","Group",16,4,7,2,3,1,13,2,6,10,3,13,10,6,2
"4161",341,342,342,"white","age.gp1","NoTr","Trade","Group",13,10,0,1,2,0,9,4,0,13,0,13,6,7,2
"4162",1628,1629,1629,"white","age.gp1","NoTr","NoTrade","NoGroup",15,6,4,4,1,0,15,0,5,10,1,14,9,6,2
"4163",1654,1655,1655,"other","age.gp2","NoTr","NoTrade","NoGroup",5,1,1,3,0,1,4,0,2,3,0,5,4,1,2
"4164",2031,2032,2032,"white","age.gp4","Tr","NoTrade","Group",23,1,5,5,12,4,17,2,6,17,3,20,13,10,2
"4165",2130,2131,2131,"white","age.gp3","NoTr","NoTrade","Group",20,2,4,7,7,2,16,2,6,14,0,20,15,5,2
"4166",2469,2470,2470,"white","age.gp1","NoTr","NoTrade","NoGroup",16,8,3,4,1,0,15,1,6,10,0,16,9,7,2
"4167",2804,2805,2805,"other","age.gp2","NoTr","NoTrade","NoGroup",8,1,4,3,0,0,8,0,4,4,0,8,5,3,2
"4168",212,213,213,"other","age.gp2","Tr","NoTrade","NoGroup",7,1,2,2,2,0,7,0,2,5,0,7,5,2,2
"4169",320,321,321,"white","age.gp4","NoTr","NoTrade","Group",10,0,1,3,6,1,7,2,2,8,0,10,5,5,2
"4170",601,602,602,"other","age.gp4","NoTr","NoTrade","NoGroup",3,0,0,2,1,0,3,0,2,1,0,3,2,1,2
"4171",675,676,676,"white","age.gp4","Tr","NoTrade","Group",9,0,1,2,6,0,9,0,2,7,0,9,7,2,2
"4172",1942,1943,1943,"white","age.gp4","NoTr","NoTrade","Group",10,0,1,2,7,0,10,0,3,7,0,10,7,3,2
"4173",2212,2213,2213,"black","age.gp4","NoTr","Trade","Group",2,1,0,1,0,1,1,0,0,2,0,2,1,1,2
"4174",2399,2400,2400,"white","age.gp3","NoTr","NoTrade","NoGroup",11,1,4,4,2,1,10,0,5,6,1,10,6,5,2
"4175",2491,2492,2492,"other","age.gp1","NoTr","NoTrade","NoGroup",4,3,0,1,0,0,4,0,1,3,0,4,2,2,2
"4176",2665,2666,2666,"white","age.gp3","NoTr","NoTrade","NoGroup",16,3,6,4,3,2,14,0,4,12,1,15,7,9,2
"4177",2703,2704,2704,"white","age.gp4","NoTr","NoTrade","Group",8,0,1,4,3,0,8,0,2,6,1,7,5,3,2
"4178",2877,2878,2878,"white","age.gp1","NoTr","NoTrade","NoGroup",10,6,1,2,1,0,8,2,2,8,1,9,5,5,2
"4179",2891,2892,2892,"other","age.gp1","NoTr","NoTrade","NoGroup",6,1,1,2,2,2,4,0,2,4,0,6,3,3,2
"4180",1038,1039,1039,"black","age.gp4","NoTr","NoTrade","NoGroup",6,0,2,2,2,4,2,0,1,5,1,5,2,4,2
"4181",1342,1343,1343,"white","age.gp1","Tr","NoTrade","NoGroup",18,11,4,1,2,2,10,6,4,14,0,18,5,13,2
"4182",2049,2050,2050,"white","age.gp4","Tr","NoTrade","Group",11,2,1,1,7,1,9,1,4,7,1,10,7,4,2
"4183",2129,2130,2130,"white","age.gp3","NoTr","NoTrade","Group",13,0,3,6,4,0,13,0,6,7,1,12,9,4,2
"4184",2728,2729,2729,"black","age.gp3","NoTr","NoTrade","NoGroup",6,0,3,1,2,3,3,0,1,5,0,6,3,3,2
"4185",308,309,309,"white","age.gp4","NoTr","NoTrade","Group",15,2,3,6,4,2,11,2,5,10,2,13,11,4,2
"4186",338,339,339,"white","age.gp1","NoTr","Trade","Group",24,11,7,2,4,4,16,4,7,17,2,22,13,11,2
"4187",1113,1114,1114,"other","age.gp1","NoTr","NoTrade","NoGroup",2,2,0,0,0,0,1,1,0,2,1,1,2,0,2
"4188",1128,1129,1129,"other","age.gp1","NoTr","NoTrade","NoGroup",2,1,0,1,0,0,2,0,1,1,0,2,2,0,2
"4189",1248,1249,1249,"white","age.gp1","NoTr","NoTrade","NoGroup",7,5,0,1,1,0,4,3,1,6,2,5,3,4,2
"4190",1310,1311,1311,"white","age.gp1","NoTr","NoTrade","NoGroup",12,9,2,1,0,2,7,3,6,6,3,9,7,5,2
"4191",1444,1445,1445,"white","age.gp1","NoTr","NoTrade","NoGroup",10,6,1,1,2,1,8,1,3,7,1,9,7,3,2
"4192",1469,1470,1470,"white","age.gp1","NoTr","NoTrade","NoGroup",12,10,2,0,0,0,11,1,3,9,2,10,7,5,2
"4193",1665,1666,1666,"black","age.gp1","Tr","Trade","Group",13,6,4,2,1,5,8,0,4,9,3,10,5,8,2
"4194",1888,1889,1889,"other","age.gp1","NoTr","NoTrade","Group",7,6,0,1,0,2,5,0,1,6,0,7,3,4,2
"4195",2135,2136,2136,"other","age.gp2","NoTr","NoTrade","NoGroup",5,2,2,1,0,1,4,0,2,3,0,5,4,1,2
"4196",2334,2335,2335,"white","age.gp3","Tr","NoTrade","Group",25,5,7,8,5,4,17,4,9,16,4,21,16,9,2
"4197",2380,2381,2381,"white","age.gp1","NoTr","NoTrade","NoGroup",9,4,2,1,2,1,8,0,4,5,0,9,5,4,2
"4198",2752,2753,2753,"white","age.gp3","NoTr","NoTrade","NoGroup",14,3,6,1,4,0,13,1,7,7,1,13,9,5,2
"4199",2768,2769,2769,"white","age.gp1","NoTr","NoTrade","NoGroup",10,5,3,1,1,0,9,1,5,5,2,8,6,4,2
"4200",2773,2774,2774,"white","age.gp3","NoTr","NoTrade","Group",13,2,3,4,4,3,9,1,5,8,2,11,8,5,2
"4201",2830,2831,2831,"white","age.gp2","Tr","NoTrade","NoGroup",10,1,5,3,1,1,9,0,2,8,1,9,8,2,2
"4202",157,158,158,"white","age.gp1","NoTr","NoTrade","Group",24,9,5,6,4,5,17,2,10,14,1,23,14,10,2
"4203",1714,1715,1715,"white","age.gp1","Tr","NoTrade","NoGroup",15,11,0,4,0,2,12,1,4,11,1,14,9,6,2
"4204",1878,1879,1879,"other","age.gp1","NoTr","NoTrade","Group",5,2,3,0,0,0,5,0,1,4,0,5,4,1,2
"4205",1897,1898,1898,"white","age.gp1","Tr","NoTrade","NoGroup",16,9,2,2,3,1,10,5,4,12,1,15,7,9,2
"4206",2030,2031,2031,"white","age.gp4","Tr","NoTrade","Group",14,1,6,3,4,1,11,2,6,8,0,14,8,6,2
"4207",2312,2313,2313,"white","age.gp2","Tr","NoTrade","NoGroup",7,1,1,3,2,0,7,0,3,4,0,7,3,4,2
"4208",2350,2351,2351,"white","age.gp3","Tr","NoTrade","NoGroup",6,3,2,0,1,1,5,0,1,5,0,6,4,2,2
"4209",2600,2601,2601,"white","age.gp3","NoTr","NoTrade","Group",16,2,6,4,4,1,11,4,10,6,0,16,12,4,2
"4210",2652,2653,2653,"black","age.gp1","NoTr","NoTrade","NoGroup",7,2,1,1,3,2,5,0,2,5,1,6,6,1,2
"4211",2800,2801,2801,"white","age.gp2","NoTr","NoTrade","NoGroup",12,1,8,2,1,0,11,1,7,5,1,11,7,5,2
"4212",2868,2869,2869,"white","age.gp1","NoTr","NoTrade","Group",32,14,6,7,5,3,23,6,11,21,3,29,17,15,2
"4213",2900,2901,2901,"other","age.gp1","NoTr","NoTrade","NoGroup",6,3,2,0,1,0,6,0,3,3,0,6,3,3,2
"4214",158,159,159,"white","age.gp1","NoTr","NoTrade","Group",27,16,4,2,5,0,22,5,6,21,7,20,19,8,2
"4215",159,160,160,"white","age.gp1","NoTr","NoTrade","Group",20,10,2,2,6,2,13,5,6,14,1,19,10,10,2
"4216",295,296,296,"white","age.gp4","NoTr","NoTrade","Group",14,1,4,2,7,1,12,1,6,8,0,14,7,7,2
"4217",339,340,340,"white","age.gp1","NoTr","Trade","Group",17,10,5,2,0,2,9,6,6,11,1,16,10,7,2
"4218",340,341,341,"white","age.gp1","NoTr","Trade","Group",26,12,5,7,2,3,19,4,9,17,3,23,14,12,2
"4219",343,344,344,"white","age.gp2","NoTr","NoTrade","Group",26,4,13,6,3,3,21,2,10,16,1,25,19,7,2
"4220",441,442,442,"white","age.gp4","NoTr","NoTrade","NoGroup",3,1,0,1,1,0,3,0,0,3,0,3,2,1,2
"4221",1195,1196,1196,"white","age.gp4","Tr","NoTrade","NoGroup",5,2,0,0,3,1,4,0,0,5,2,3,3,2,2
"4222",1883,1884,1884,"other","age.gp1","NoTr","NoTrade","Group",10,5,1,2,2,1,9,0,4,6,2,8,8,2,2
"4223",1889,1890,1890,"other","age.gp1","NoTr","NoTrade","Group",9,5,3,1,0,0,9,0,4,5,1,8,6,3,2
"4224",2027,2028,2028,"white","age.gp4","Tr","NoTrade","Group",10,1,1,3,5,0,9,1,4,6,0,10,7,3,2
"4225",2383,2384,2384,"white","age.gp1","NoTr","NoTrade","NoGroup",8,3,2,3,0,0,6,2,3,5,0,8,4,4,2
"4226",2489,2490,2490,"other","age.gp1","NoTr","NoTrade","NoGroup",3,1,0,1,1,0,3,0,1,2,0,3,1,2,2
"4227",981,982,982,"white","age.gp4","NoTr","NoTrade","NoGroup",8,1,3,1,3,0,7,1,5,3,0,8,6,2,2
"4228",1094,1095,1095,"black","age.gp1","NoTr","NoTrade","NoGroup",10,4,0,3,3,5,5,0,1,9,1,9,5,5,2
"4229",1458,1459,1459,"white","age.gp1","NoTr","NoTrade","NoGroup",4,2,2,0,0,1,3,0,0,4,0,4,2,2,2
"4230",1504,1505,1505,"white","age.gp4","NoTr","NoTrade","NoGroup",8,1,1,1,5,0,8,0,4,4,0,8,8,0,2
"4231",1771,1772,1772,"black","age.gp4","NoTr","NoTrade","NoGroup",4,1,0,1,2,1,3,0,1,3,0,4,1,3,2
"4232",1900,1901,1901,"white","age.gp1","Tr","NoTrade","NoGroup",8,2,1,2,3,0,8,0,2,6,1,7,6,2,2
"4233",2707,2708,2708,"white","age.gp4","NoTr","NoTrade","Group",6,1,0,2,3,0,6,0,2,4,0,6,3,3,2
"4234",2888,2889,2889,"other","age.gp1","NoTr","NoTrade","NoGroup",5,4,0,0,1,0,5,0,2,3,0,5,3,2,2
"4235",2893,2894,2894,"other","age.gp1","NoTr","NoTrade","NoGroup",2,2,0,0,0,0,2,0,0,2,0,2,2,0,2
"4236",2917,2918,2918,"white","age.gp1","NoTr","NoTrade","NoGroup",11,5,1,3,2,2,8,1,4,7,1,10,5,6,2
"4237",160,161,161,"white","age.gp1","NoTr","NoTrade","Group",20,9,5,5,1,2,13,5,5,15,1,19,9,11,2
"4238",285,286,286,"white","age.gp1","NoTr","NoTrade","NoGroup",13,9,1,0,3,0,10,3,4,9,1,12,9,4,2
"4239",512,513,513,"black","age.gp3","NoTr","NoTrade","NoGroup",9,3,2,3,1,3,5,1,2,7,1,8,4,5,2
"4240",646,647,647,"other","age.gp1","NoTr","Trade","Group",9,7,0,2,0,1,8,0,2,7,0,9,2,7,2
"4241",1015,1016,1016,"white","age.gp1","NoTr","NoTrade","NoGroup",10,5,1,2,2,0,9,1,0,10,0,10,4,6,2
"4242",1267,1268,1268,"black","age.gp3","NoTr","NoTrade","NoGroup",9,1,2,3,3,4,5,0,2,7,0,9,6,3,2
"4243",1882,1883,1883,"other","age.gp1","NoTr","NoTrade","Group",9,3,1,3,2,2,7,0,2,7,1,8,4,5,2
"4244",1926,1927,1927,"other","age.gp2","NoTr","NoTrade","NoGroup",5,2,2,1,0,0,5,0,3,2,0,5,4,1,2
"4245",2445,2446,2446,"white","age.gp4","NoTr","NoTrade","NoGroup",6,1,2,0,3,1,5,0,1,5,0,6,4,2,2
"4246",161,162,162,"white","age.gp3","NoTr","NoTrade","NoGroup",6,1,2,2,1,1,4,1,4,2,0,6,2,4,2
"4247",894,895,895,"other","age.gp1","Tr","NoTrade","NoGroup",5,2,0,2,1,0,5,0,2,3,1,4,3,2,2
"4248",1153,1154,1154,"white","age.gp4","NoTr","NoTrade","NoGroup",5,0,0,2,3,1,4,0,0,5,0,5,2,3,2
"4249",2084,2085,2085,"black","age.gp3","NoTr","NoTrade","NoGroup",3,0,1,1,1,1,2,0,1,2,0,3,2,1,2
"4250",162,163,163,"white","age.gp3","NoTr","NoTrade","NoGroup",11,0,4,4,3,2,7,2,5,6,0,11,7,4,2
"4251",1166,1167,1167,"white","age.gp4","NoTr","NoTrade","NoGroup",1,0,0,1,0,0,1,0,0,1,0,1,0,1,2
"4252",1523,1524,1524,"black","age.gp4","NoTr","NoTrade","NoGroup",6,0,0,2,4,3,3,0,0,6,0,6,3,3,2
"4253",1866,1867,1867,"white","age.gp3","NoTr","NoTrade","Group",14,0,6,4,4,1,13,0,8,6,1,13,9,5,2
"4254",2281,2282,2282,"other","age.gp2","Tr","NoTrade","Group",16,0,8,4,4,0,15,1,6,10,1,15,11,5,2
"4255",2300,2301,2301,"other","age.gp2","Tr","NoTrade","Group",11,1,3,5,2,0,11,0,2,9,0,11,7,4,2
"4256",206,207,207,"other","age.gp2","Tr","NoTrade","NoGroup",6,0,3,3,0,0,6,0,3,3,0,6,4,2,2
"4257",702,703,703,"white","age.gp2","NoTr","NoTrade","Group",27,4,8,9,6,2,25,0,9,18,3,24,15,12,2
"4258",1726,1727,1727,"white","age.gp1","Tr","NoTrade","NoGroup",6,2,1,2,1,1,3,2,1,5,2,4,3,3,2
"4259",2395,2396,2396,"white","age.gp3","NoTr","NoTrade","NoGroup",13,0,6,3,4,0,13,0,7,6,2,11,10,3,2
"4260",2551,2552,2552,"other","age.gp1","NoTr","NoTrade","NoGroup",7,4,2,1,0,0,7,0,4,3,1,6,3,4,2
"4261",458,459,459,"white","age.gp1","NoTr","NoTrade","NoGroup",19,11,3,5,0,0,17,2,10,9,2,17,6,13,2
"4262",781,782,782,"white","age.gp2","NoTr","NoTrade","NoGroup",11,1,5,5,0,1,9,1,4,7,1,10,6,5,2
"4263",805,806,806,"white","age.gp4","NoTr","NoTrade","NoGroup",3,0,0,1,2,1,1,1,0,3,0,3,1,2,2
"4264",870,871,871,"other","age.gp2","Tr","NoTrade","Group",10,1,4,3,2,1,9,0,3,7,1,9,5,5,2
"4265",2664,2665,2665,"white","age.gp3","NoTr","NoTrade","NoGroup",10,1,3,5,1,2,8,0,3,7,2,8,6,4,2
"4266",165,166,166,"white","age.gp3","NoTr","NoTrade","NoGroup",8,1,2,2,3,0,6,2,1,7,0,8,4,4,2
"4267",939,940,940,"white","age.gp3","NoTr","NoTrade","NoGroup",7,1,2,2,2,1,5,1,2,5,2,5,4,3,2
"4268",1219,1220,1220,"white","age.gp4","NoTr","NoTrade","NoGroup",6,2,0,1,3,0,5,1,1,5,1,5,4,2,2
"4269",1640,1641,1641,"other","age.gp2","NoTr","NoTrade","NoGroup",4,0,1,2,1,0,4,0,2,2,0,4,3,1,2
"4270",1869,1870,1870,"other","age.gp1","NoTr","NoTrade","Group",8,2,1,2,3,1,7,0,4,4,0,8,4,4,2
"4271",1937,1938,1938,"white","age.gp4","NoTr","NoTrade","Group",12,0,4,1,7,3,9,0,3,9,1,11,8,4,2
"4272",2954,2955,2955,"white","age.gp2","Tr","NoTrade","Group",13,0,8,4,1,0,13,0,9,4,0,13,10,3,2
"4273",317,318,318,"white","age.gp4","NoTr","NoTrade","Group",11,0,5,1,5,0,10,1,6,5,0,11,7,4,2
"4274",850,851,851,"other","age.gp2","Tr","NoTrade","Group",5,0,3,1,1,1,4,0,2,3,0,5,4,1,2
"4275",1252,1253,1253,"white","age.gp2","Tr","NoTrade","Group",28,3,14,6,5,6,19,3,9,19,4,24,17,11,2
"4276",2961,2962,2962,"white","age.gp2","NoTr","NoTrade","Group",29,3,15,8,3,3,22,4,12,17,3,26,14,15,2
"4277",217,218,218,"other","age.gp2","Tr","NoTrade","NoGroup",5,0,1,4,0,2,3,0,1,4,0,5,3,2,2
"4278",257,258,258,"white","age.gp4","NoTr","NoTrade","NoGroup",1,0,0,1,0,0,1,0,0,1,0,1,0,1,2
"4279",699,700,700,"white","age.gp4","Tr","NoTrade","Group",17,2,5,3,7,3,14,0,6,11,0,17,10,7,2
"4280",1305,1306,1306,"white","age.gp2","Tr","NoTrade","NoGroup",6,2,0,3,1,1,5,0,1,5,2,4,3,3,2
"4281",2701,2702,2702,"white","age.gp4","NoTr","NoTrade","Group",17,1,1,3,12,1,15,1,5,12,0,17,9,8,2
"4282",2927,2928,2928,"white","age.gp4","NoTr","NoTrade","Group",7,1,1,1,4,0,6,1,2,5,1,6,4,3,2
"4283",169,170,170,"white","age.gp3","NoTr","NoTrade","NoGroup",11,0,7,2,2,0,11,0,6,5,0,11,8,3,2
"4284",1423,1424,1424,"white","age.gp2","NoTr","NoTrade","Group",14,1,5,3,5,0,13,1,7,7,0,14,11,3,2
"4285",1490,1491,1491,"white","age.gp4","NoTr","NoTrade","NoGroup",4,0,2,2,0,0,4,0,3,1,0,4,2,2,2
"4286",2342,2343,2343,"white","age.gp2","Tr","NoTrade","Group",23,0,13,2,8,2,17,4,7,16,1,22,14,9,2
"4287",2663,2664,2664,"white","age.gp3","NoTr","NoTrade","NoGroup",7,1,1,5,0,0,7,0,0,7,2,5,5,2,2
"4288",170,171,171,"white","age.gp3","NoTr","NoTrade","NoGroup",12,0,4,6,2,2,10,0,7,5,0,12,9,3,2
"4289",1088,1089,1089,"black","age.gp2","Tr","NoTrade","NoGroup",11,2,4,3,2,4,7,0,3,8,2,9,6,5,2
"4290",1434,1435,1435,"white","age.gp3","Tr","NoTrade","NoGroup",9,0,3,3,3,0,6,3,4,5,0,9,3,6,2
"4291",1551,1552,1552,"white","age.gp3","NoTr","NoTrade","Group",11,2,4,3,2,0,10,1,5,6,0,11,5,6,2
"4292",1619,1620,1620,"white","age.gp2","Tr","NoTrade","Group",23,2,8,7,6,1,19,3,9,14,2,21,14,9,2
"4293",2627,2628,2628,"white","age.gp4","NoTr","NoTrade","NoGroup",4,0,1,1,2,0,4,0,2,2,0,4,1,3,2
"4294",1898,1899,1899,"white","age.gp1","Tr","NoTrade","NoGroup",10,5,2,1,2,1,7,2,4,6,0,10,4,6,2
"4295",2824,2825,2825,"other","age.gp2","NoTr","NoTrade","NoGroup",8,0,3,4,1,1,7,0,3,5,0,8,4,4,2
"4296",172,173,173,"white","age.gp3","NoTr","NoTrade","NoGroup",6,3,0,2,1,0,4,2,3,3,1,5,2,4,2
"4297",884,885,885,"white","age.gp3","NoTr","Trade","Group",25,6,9,4,6,3,18,4,9,16,3,22,14,11,2
"4298",1105,1106,1106,"other","age.gp1","NoTr","NoTrade","NoGroup",3,1,1,1,0,0,3,0,2,1,0,3,1,2,2
"4299",1204,1205,1205,"white","age.gp4","Tr","NoTrade","NoGroup",7,0,0,1,6,0,7,0,3,4,0,7,4,3,2
"4300",2464,2465,2465,"white","age.gp1","Tr","NoTrade","NoGroup",7,1,3,2,1,1,6,0,2,5,0,7,5,2,2
"4301",2542,2543,2543,"other","age.gp1","NoTr","NoTrade","NoGroup",4,0,0,3,1,1,3,0,0,4,0,4,1,3,2
"4302",173,174,174,"white","age.gp3","NoTr","NoTrade","NoGroup",10,2,4,1,3,1,8,1,3,7,0,10,5,5,2
"4303",682,683,683,"white","age.gp4","Tr","NoTrade","Group",9,1,2,1,5,0,9,0,2,7,0,9,2,7,2
"4304",808,809,809,"white","age.gp4","NoTr","NoTrade","NoGroup",8,0,4,1,3,1,5,2,4,4,1,7,3,5,2
"4305",1642,1643,1643,"other","age.gp2","NoTr","NoTrade","NoGroup",7,0,4,1,2,1,6,0,2,5,0,7,3,4,2
"4306",2405,2406,2406,"white","age.gp3","NoTr","NoTrade","NoGroup",13,1,8,2,2,0,13,0,8,5,0,13,11,2,2
"4307",2942,2943,2943,"white","age.gp4","NoTr","NoTrade","Group",13,1,0,3,9,0,12,1,3,10,0,13,8,5,2
"4308",189,190,190,"white","age.gp3","Tr","NoTrade","NoGroup",7,0,3,4,0,1,6,0,2,5,1,6,4,3,2
"4309",1437,1438,1438,"white","age.gp3","Tr","NoTrade","NoGroup",14,0,4,7,3,2,12,0,3,11,0,14,8,6,2
"4310",1776,1777,1777,"white","age.gp4","Tr","NoTrade","Group",13,2,5,1,5,1,10,2,3,10,0,13,4,9,2
"4311",2808,2809,2809,"other","age.gp2","NoTr","NoTrade","NoGroup",4,0,1,2,1,0,4,0,3,1,0,4,2,2,2
"4312",2940,2941,2941,"white","age.gp4","NoTr","NoTrade","Group",7,1,2,2,2,1,4,2,1,6,1,6,2,5,2
"4313",856,857,857,"other","age.gp2","Tr","NoTrade","Group",7,0,4,1,2,2,5,0,1,6,1,6,4,3,2
"4314",1106,1107,1107,"other","age.gp1","NoTr","NoTrade","NoGroup",2,1,0,1,0,1,1,0,0,2,0,2,0,2,2
"4315",1575,1576,1576,"white","age.gp4","Tr","NoTrade","Group",10,0,3,1,6,2,8,0,4,6,0,10,5,5,2
"4316",176,177,177,"white","age.gp3","Tr","NoTrade","NoGroup",8,1,3,2,2,1,7,0,2,6,0,8,5,3,2
"4317",423,424,424,"white","age.gp4","NoTr","NoTrade","NoGroup",3,0,1,1,1,0,2,1,2,1,0,3,1,2,2
"4318",1013,1014,1014,"white","age.gp1","NoTr","NoTrade","NoGroup",11,2,2,4,3,1,10,0,3,8,1,10,6,5,2
"4319",1968,1969,1969,"white","age.gp4","Tr","NoTrade","NoGroup",4,0,1,1,2,0,4,0,1,3,0,4,0,4,2
"4320",2348,2349,2349,"black","age.gp2","NoTr","NoTrade","Group",24,3,11,8,2,12,12,0,12,12,5,19,10,14,2
"4321",177,178,178,"white","age.gp3","Tr","NoTrade","NoGroup",13,2,4,3,4,0,12,1,3,10,0,13,10,3,2
"4322",326,327,327,"white","age.gp4","NoTr","NoTrade","Group",9,0,0,4,5,1,8,0,4,5,1,8,6,3,2
"4323",435,436,436,"white","age.gp4","NoTr","NoTrade","NoGroup",5,1,2,1,1,0,4,1,3,2,0,5,3,2,2
"4324",937,938,938,"white","age.gp3","NoTr","NoTrade","NoGroup",7,0,3,3,1,0,6,1,6,1,0,7,3,4,2
"4325",1456,1457,1457,"white","age.gp1","NoTr","NoTrade","NoGroup",13,5,3,4,1,2,9,2,5,8,2,11,4,9,2
"4326",1887,1888,1888,"other","age.gp1","NoTr","NoTrade","Group",9,4,1,1,3,2,7,0,6,3,1,8,3,6,2
"4327",233,234,234,"white","age.gp2","Tr","NoTrade","Group",26,2,15,4,5,3,20,3,12,14,2,24,16,10,2
"4328",630,631,631,"other","age.gp1","NoTr","Trade","Group",7,0,3,2,2,1,6,0,3,4,0,7,4,3,2
"4329",2866,2867,2867,"white","age.gp2","Tr","NoTrade","Group",29,6,15,6,2,1,25,3,8,21,4,25,17,12,2
"4330",1484,1485,1485,"white","age.gp4","NoTr","NoTrade","NoGroup",5,1,2,1,1,1,3,1,3,2,0,5,2,3,2
"4331",2005,2006,2006,"black","age.gp4","NoTr","NoTrade","NoGroup",3,0,1,1,1,2,1,0,1,2,1,2,1,2,2
"4332",180,181,181,"white","age.gp3","Tr","NoTrade","NoGroup",3,0,1,0,2,0,2,1,2,1,0,3,2,1,2
"4333",687,688,688,"white","age.gp4","Tr","NoTrade","Group",11,2,2,3,4,3,8,0,5,6,3,8,5,6,2
"4334",803,804,804,"white","age.gp4","NoTr","NoTrade","NoGroup",5,0,1,2,2,1,4,0,2,3,1,4,3,2,2
"4335",1879,1880,1880,"other","age.gp1","NoTr","NoTrade","Group",6,4,0,2,0,0,6,0,3,3,1,5,2,4,2
"4336",2199,2200,2200,"white","age.gp4","NoTr","NoTrade","NoGroup",1,0,0,1,0,0,1,0,1,0,0,1,0,1,2
"4337",2316,2317,2317,"white","age.gp2","NoTr","NoTrade","NoGroup",14,1,8,4,1,1,12,1,4,10,0,14,9,5,2
"4338",2379,2380,2380,"white","age.gp2","NoTr","NoTrade","NoGroup",15,2,5,6,2,2,9,4,9,6,2,13,10,5,2
"4339",2536,2537,2537,"other","age.gp1","NoTr","NoTrade","NoGroup",2,0,0,1,1,0,2,0,2,0,0,2,1,1,2
"4340",182,183,183,"white","age.gp3","Tr","NoTrade","NoGroup",9,0,3,3,3,1,8,0,2,7,0,9,6,3,2
"4341",1236,1237,1237,"white","age.gp4","NoTr","NoTrade","NoGroup",1,0,0,1,0,0,1,0,1,0,0,1,0,1,2
"4342",1400,1401,1401,"white","age.gp3","NoTr","NoTrade","Group",21,1,10,5,5,3,15,3,6,15,1,20,11,10,2
"4343",1812,1813,1813,"black","age.gp4","NoTr","NoTrade","NoGroup",7,0,1,3,3,3,4,0,2,5,1,6,4,3,2
"4344",2068,2069,2069,"white","age.gp3","Tr","NoTrade","Group",13,1,6,3,3,0,11,2,7,6,2,11,9,4,2
"4345",2118,2119,2119,"white","age.gp3","NoTr","NoTrade","Group",19,2,6,2,9,0,19,0,10,9,0,19,12,7,2
"4346",2377,2378,2378,"white","age.gp2","NoTr","NoTrade","NoGroup",9,1,5,3,0,0,8,1,5,4,0,9,6,3,2
"4347",183,184,184,"white","age.gp3","Tr","NoTrade","NoGroup",9,2,3,1,3,3,6,0,2,7,1,8,7,2,2
"4348",1505,1506,1506,"white","age.gp4","NoTr","NoTrade","NoGroup",4,0,1,2,1,1,3,0,3,1,1,3,2,2,2
"4349",1574,1575,1575,"white","age.gp4","Tr","NoTrade","Group",17,2,6,6,3,1,13,3,6,11,1,16,11,6,2
"4350",2718,2719,2719,"white","age.gp4","NoTr","NoTrade","Group",20,0,4,8,8,2,18,0,8,12,1,19,10,10,2
"4351",184,185,185,"white","age.gp3","Tr","NoTrade","NoGroup",10,1,1,6,2,3,7,0,1,9,2,8,7,3,2
"4352",1291,1292,1292,"white","age.gp4","NoTr","NoTrade","Group",7,1,1,2,3,0,6,1,5,2,0,7,6,1,2
"4353",1303,1304,1304,"white","age.gp4","NoTr","NoTrade","Group",11,0,2,3,6,0,10,1,6,5,0,11,8,3,2
"4354",2680,2681,2681,"black","age.gp3","NoTr","NoTrade","NoGroup",10,2,3,3,2,8,2,0,3,7,2,8,4,6,2
"4355",2846,2847,2847,"black","age.gp3","NoTr","NoTrade","Group",8,0,2,4,2,4,4,0,4,4,1,7,4,4,2
"4356",2861,2862,2862,"white","age.gp1","Tr","NoTrade","NoGroup",15,3,3,5,4,1,14,0,2,13,0,15,5,10,2
"4357",1095,1096,1096,"white","age.gp2","NoTr","NoTrade","Group",19,2,8,8,1,2,17,0,12,7,1,18,11,8,2
"4358",1785,1786,1786,"white","age.gp4","Tr","NoTrade","Group",16,0,4,2,10,1,14,1,3,13,0,16,11,5,2
"4359",2567,2568,2568,"white","age.gp4","NoTr","NoTrade","Group",12,0,4,4,4,0,12,0,4,8,1,11,9,3,2
"4360",928,929,929,"white","age.gp3","NoTr","NoTrade","NoGroup",8,0,3,3,2,2,6,0,4,4,1,7,5,3,2
"4361",1420,1421,1421,"white","age.gp2","NoTr","NoTrade","Group",15,2,8,2,3,0,11,4,7,8,0,15,8,7,2
"4362",2650,2651,2651,"white","age.gp2","NoTr","NoTrade","Group",28,2,16,5,5,1,25,2,15,13,2,26,17,11,2
"4363",2252,2253,2253,"white","age.gp4","Tr","NoTrade","Group",11,1,3,2,5,2,9,0,4,7,0,11,7,4,2
"4364",2272,2273,2273,"white","age.gp4","Tr","NoTrade","Group",10,0,2,3,5,1,8,1,2,8,0,10,7,3,2
"4365",2417,2418,2418,"white","age.gp3","NoTr","Trade","Group",21,1,7,6,7,0,20,1,13,8,0,21,18,3,2
"4366",190,191,191,"white","age.gp3","Tr","NoTrade","NoGroup",8,0,2,2,4,1,7,0,4,4,1,7,7,1,2
"4367",673,674,674,"white","age.gp4","Tr","NoTrade","Group",5,0,2,2,1,1,4,0,2,3,0,5,3,2,2
"4368",750,751,751,"white","age.gp4","NoTr","NoTrade","NoGroup",6,1,2,1,2,0,5,1,3,3,0,6,4,2,2
"4369",1548,1549,1549,"white","age.gp3","NoTr","NoTrade","Group",21,2,5,7,7,0,19,2,8,13,0,21,14,7,2
"4370",1655,1656,1656,"other","age.gp2","NoTr","NoTrade","NoGroup",4,0,2,2,0,0,4,0,2,2,0,4,1,3,2
"4371",2294,2295,2295,"other","age.gp2","Tr","NoTrade","Group",17,0,8,4,5,2,15,0,7,10,1,16,11,6,2
"4372",2429,2430,2430,"white","age.gp4","NoTr","NoTrade","NoGroup",3,0,1,1,1,0,3,0,1,2,1,2,2,1,2
"4373",2778,2779,2779,"white","age.gp3","NoTr","NoTrade","Group",11,1,5,4,1,2,8,1,5,6,1,10,5,6,2
"4374",2970,2971,2971,"white","age.gp2","NoTr","NoTrade","Group",29,9,13,3,4,1,25,3,10,19,2,27,18,11,2
"4375",192,193,193,"white","age.gp2","Tr","NoTrade","NoGroup",9,1,3,3,2,0,6,3,1,8,0,9,5,4,2
"4376",1657,1658,1658,"other","age.gp2","NoTr","NoTrade","NoGroup",4,0,3,1,0,0,4,0,2,2,1,3,3,1,2
"4377",1877,1878,1878,"other","age.gp1","NoTr","NoTrade","Group",10,4,4,2,0,0,10,0,5,5,0,10,2,8,2
"4378",2140,2141,2141,"other","age.gp2","NoTr","NoTrade","NoGroup",4,0,3,0,1,0,4,0,2,2,1,3,2,2,2
"4379",2186,2187,2187,"white","age.gp4","NoTr","NoTrade","NoGroup",8,0,1,2,5,2,6,0,5,3,0,8,3,5,2
"4380",2774,2775,2775,"white","age.gp3","NoTr","NoTrade","Group",16,2,9,4,1,2,10,4,8,8,1,15,8,8,2
"4381",2882,2883,2883,"white","age.gp2","NoTr","NoTrade","NoGroup",9,2,2,3,2,2,7,0,4,5,1,8,6,3,2
"4382",193,194,194,"white","age.gp2","Tr","NoTrade","NoGroup",11,0,8,2,1,1,9,1,7,4,0,11,8,3,2
"4383",1620,1621,1621,"white","age.gp2","Tr","NoTrade","Group",20,3,6,7,4,2,16,2,6,14,3,17,13,7,2
"4384",2839,2840,2840,"white","age.gp2","Tr","NoTrade","Group",23,1,13,5,4,1,18,4,10,13,3,20,14,9,2
"4385",2851,2852,2852,"black","age.gp3","NoTr","NoTrade","Group",16,2,4,5,5,10,6,0,3,13,3,13,8,8,2
"4386",194,195,195,"white","age.gp2","Tr","NoTrade","NoGroup",11,2,2,5,2,1,10,0,3,8,1,10,6,5,2
"4387",255,256,256,"white","age.gp4","NoTr","NoTrade","NoGroup",5,1,1,0,3,0,5,0,3,2,0,5,3,2,2
"4388",323,324,324,"white","age.gp4","NoTr","NoTrade","Group",9,0,3,0,6,2,6,1,2,7,0,9,5,4,2
"4389",1847,1848,1848,"black","age.gp3","NoTr","NoTrade","NoGroup",8,1,4,2,1,3,3,2,3,5,1,7,3,5,2
"4390",2510,2511,2511,"white","age.gp1","NoTr","NoTrade","NoGroup",13,6,3,2,2,0,10,3,5,8,0,13,4,9,2
"4391",2754,2755,2755,"white","age.gp3","NoTr","NoTrade","NoGroup",9,1,3,4,1,0,8,1,4,5,0,9,6,3,2
"4392",195,196,196,"white","age.gp2","Tr","NoTrade","NoGroup",14,1,9,2,2,2,12,0,4,10,1,13,6,8,2
"4393",668,669,669,"white","age.gp2","Tr","NoTrade","NoGroup",8,0,5,2,1,0,8,0,3,5,0,8,6,2,2
"4394",1599,1600,1600,"white","age.gp2","Tr","NoTrade","NoGroup",8,1,3,3,1,1,7,0,4,4,0,8,4,4,2
"4395",2092,2093,2093,"black","age.gp3","NoTr","NoTrade","NoGroup",7,0,2,2,3,5,2,0,2,5,1,6,3,4,2
"4396",2657,2658,2658,"white","age.gp2","NoTr","NoTrade","Group",20,3,11,4,2,3,14,3,9,11,0,20,9,11,2
"4397",2729,2730,2730,"black","age.gp3","NoTr","NoTrade","NoGroup",9,1,4,1,3,3,5,1,4,5,1,8,6,3,2
"4398",2916,2917,2917,"white","age.gp1","NoTr","NoTrade","NoGroup",3,1,1,1,0,0,3,0,2,1,1,2,1,2,2
"4399",196,197,197,"other","age.gp2","Tr","NoTrade","NoGroup",4,0,3,1,0,0,4,0,3,1,1,3,4,0,2
"4400",745,746,746,"white","age.gp2","Tr","NoTrade","Group",15,0,4,8,3,1,11,3,5,10,1,14,11,4,2
"4401",197,198,198,"other","age.gp2","Tr","NoTrade","NoGroup",5,1,4,0,0,1,4,0,2,3,0,5,4,1,2
"4402",2655,2656,2656,"black","age.gp1","NoTr","NoTrade","NoGroup",10,3,2,2,3,4,4,2,5,5,2,8,5,5,2
"4403",199,200,200,"other","age.gp2","Tr","NoTrade","NoGroup",3,0,2,1,0,0,3,0,2,1,0,3,3,0,2
"4404",1741,1742,1742,"white","age.gp3","Tr","NoTrade","Group",20,1,13,2,4,5,12,3,8,12,1,19,15,5,2
"4405",200,201,201,"other","age.gp2","Tr","NoTrade","NoGroup",7,0,4,2,1,1,6,0,3,4,0,7,5,2,2
"4406",1104,1105,1105,"black","age.gp2","NoTr","NoTrade","NoGroup",7,0,2,2,3,3,3,1,2,5,1,6,3,4,2
"4407",2604,2605,2605,"white","age.gp3","NoTr","NoTrade","Group",22,1,12,3,6,0,17,5,10,12,1,21,16,6,2
"4408",201,202,202,"other","age.gp2","Tr","NoTrade","NoGroup",4,0,3,0,1,0,4,0,1,3,0,4,4,0,2
"4409",1280,1281,1281,"white","age.gp4","NoTr","NoTrade","Group",10,2,4,0,4,0,8,2,6,4,0,10,7,3,2
"4410",2275,2276,2276,"black","age.gp2","Tr","Trade","Group",12,3,4,3,2,8,3,1,4,8,0,12,3,9,2
"4411",203,204,204,"other","age.gp2","Tr","NoTrade","NoGroup",3,0,0,1,2,1,2,0,0,3,0,3,2,1,2
"4412",1759,1760,1760,"black","age.gp4","NoTr","NoTrade","NoGroup",5,0,2,1,2,1,2,2,2,3,0,5,4,1,2
"4413",204,205,205,"other","age.gp2","Tr","NoTrade","NoGroup",4,0,2,2,0,0,4,0,3,1,0,4,4,0,2
"4414",205,206,206,"other","age.gp2","Tr","NoTrade","NoGroup",6,0,0,1,5,1,5,0,2,4,0,6,4,2,2
"4415",717,718,718,"black","age.gp4","NoTr","NoTrade","NoGroup",5,0,1,1,3,2,2,1,2,3,1,4,2,3,2
"4416",1074,1075,1075,"white","age.gp4","NoTr","NoTrade","Group",19,1,4,3,11,3,14,2,7,12,1,18,12,7,2
"4417",2195,2196,2196,"white","age.gp4","NoTr","NoTrade","NoGroup",3,0,1,1,1,0,2,1,1,2,0,3,2,1,2
"4418",207,208,208,"other","age.gp2","Tr","NoTrade","NoGroup",8,0,4,2,2,1,7,0,4,4,1,7,6,2,2
"4419",2009,2010,2010,"black","age.gp4","NoTr","NoTrade","NoGroup",1,0,1,0,0,0,0,1,1,0,0,1,0,1,2
"4420",2422,2423,2423,"white","age.gp3","NoTr","Trade","Group",14,2,7,2,3,1,10,3,4,10,1,13,7,7,2
"4421",376,377,377,"black","age.gp4","NoTr","NoTrade","NoGroup",6,0,3,2,1,3,2,1,1,5,1,5,3,3,2
"4422",1371,1372,1372,"black","age.gp4","NoTr","NoTrade","Group",6,1,1,3,1,4,1,1,2,4,0,6,1,5,2
"4423",2166,2167,2167,"black","age.gp2","NoTr","NoTrade","NoGroup",7,2,3,1,1,3,3,1,5,2,0,7,1,6,2
"4424",2192,2193,2193,"white","age.gp4","NoTr","NoTrade","NoGroup",1,0,1,0,0,0,0,1,1,0,0,1,0,1,2
"4425",2291,2292,2292,"other","age.gp2","Tr","NoTrade","Group",9,1,5,1,2,2,6,1,4,5,1,8,6,3,2
"4426",2388,2389,2389,"white","age.gp2","Tr","NoTrade","Group",28,3,14,6,5,2,23,3,9,19,2,26,15,13,2
"4427",2415,2416,2416,"white","age.gp3","NoTr","Trade","Group",13,3,5,0,5,1,11,1,3,10,1,12,8,5,2
"4428",2653,2654,2654,"black","age.gp1","NoTr","NoTrade","NoGroup",13,8,2,3,0,9,1,3,4,9,2,11,5,8,2
"4429",209,210,210,"other","age.gp2","Tr","NoTrade","NoGroup",7,1,0,5,1,1,6,0,2,5,0,7,4,3,2
"4430",1455,1456,1456,"white","age.gp1","NoTr","NoTrade","NoGroup",13,5,4,2,2,2,6,5,6,7,3,10,9,4,2
"4431",2052,2053,2053,"white","age.gp4","Tr","NoTrade","Group",11,0,2,3,6,0,10,1,7,4,0,11,7,4,2
"4432",661,662,662,"white","age.gp2","NoTr","NoTrade","Group",21,3,10,6,2,2,17,2,11,10,1,20,12,9,2
"4433",1451,1452,1452,"black","age.gp1","NoTr","NoTrade","NoGroup",5,1,2,0,2,2,1,2,2,3,0,5,3,2,2
"4434",2397,2398,2398,"white","age.gp3","NoTr","NoTrade","NoGroup",11,3,5,1,2,1,8,2,5,6,0,11,5,6,2
"4435",316,317,317,"white","age.gp4","NoTr","NoTrade","Group",11,1,2,3,5,1,8,2,4,7,2,9,6,5,2
"4436",431,432,432,"white","age.gp4","NoTr","NoTrade","NoGroup",1,0,1,0,0,0,0,1,1,0,0,1,0,1,2
"4437",1723,1724,1724,"white","age.gp1","Tr","NoTrade","NoGroup",9,2,1,4,2,1,6,2,2,7,0,9,6,3,2
"4438",213,214,214,"other","age.gp2","Tr","NoTrade","NoGroup",4,0,2,0,2,0,4,0,2,2,0,4,2,2,2
"4439",531,532,532,"white","age.gp4","NoTr","NoTrade","NoGroup",1,0,1,0,0,0,0,1,1,0,0,1,0,1,2
"4440",214,215,215,"other","age.gp2","Tr","NoTrade","NoGroup",4,0,0,2,2,0,4,0,0,4,0,4,2,2,2
"4441",324,325,325,"white","age.gp4","NoTr","NoTrade","Group",10,0,2,2,6,0,8,2,4,6,1,9,8,2,2
"4442",215,216,216,"other","age.gp2","Tr","NoTrade","NoGroup",4,0,2,1,1,0,4,0,3,1,0,4,3,1,2
"4443",304,305,305,"white","age.gp4","NoTr","NoTrade","Group",18,1,5,5,7,0,16,2,7,11,0,18,13,5,2
"4444",216,217,217,"other","age.gp2","Tr","NoTrade","NoGroup",6,0,1,4,1,1,5,0,2,4,1,5,4,2,2
"4445",318,319,319,"white","age.gp4","NoTr","NoTrade","Group",13,0,3,1,9,1,9,3,5,8,0,13,5,8,2
"4446",1332,1333,1333,"white","age.gp3","NoTr","NoTrade","NoGroup",10,0,4,1,5,0,8,2,6,4,0,10,6,4,2
"4447",218,219,219,"other","age.gp2","Tr","NoTrade","NoGroup",4,1,1,0,2,0,4,0,1,3,0,4,0,4,2
"4448",1343,1344,1344,"white","age.gp1","Tr","NoTrade","NoGroup",10,4,2,3,1,2,5,3,3,7,2,8,5,5,2
"4449",2309,2310,2310,"white","age.gp2","NoTr","NoTrade","NoGroup",9,2,6,1,0,0,5,4,5,4,0,9,5,4,2
"4450",220,221,221,"other","age.gp2","Tr","NoTrade","NoGroup",2,0,1,1,0,0,2,0,2,0,0,2,1,1,2
"4451",235,236,236,"white","age.gp2","Tr","NoTrade","Group",20,3,11,3,3,1,14,5,6,14,2,18,13,7,2
"4452",221,222,222,"other","age.gp2","Tr","NoTrade","NoGroup",6,2,2,1,1,0,6,0,3,3,1,5,5,1,2
"4453",1626,1627,1627,"white","age.gp1","NoTr","NoTrade","NoGroup",6,1,4,0,1,0,5,1,3,3,0,6,3,3,2
"4454",2256,2257,2257,"white","age.gp4","Tr","NoTrade","Group",9,0,3,3,3,2,5,2,5,4,1,8,5,4,2
"4455",2870,2871,2871,"white","age.gp1","NoTr","NoTrade","Group",28,14,7,5,2,3,20,5,11,17,2,26,14,14,2
"4456",222,223,223,"other","age.gp2","Tr","NoTrade","NoGroup",2,0,1,1,0,0,2,0,1,1,0,2,1,1,2
"4457",223,224,224,"black","age.gp2","NoTr","NoTrade","NoGroup",7,0,3,3,1,5,2,0,1,6,1,6,4,3,2
"4458",2090,2091,2091,"black","age.gp3","NoTr","NoTrade","NoGroup",7,1,3,3,0,3,4,0,2,5,0,7,4,3,2
"4459",224,225,225,"black","age.gp2","NoTr","NoTrade","NoGroup",9,1,6,2,0,4,4,1,2,7,1,8,2,7,2
"4460",460,461,461,"white","age.gp1","NoTr","NoTrade","NoGroup",16,10,3,3,0,2,9,5,7,9,2,14,5,11,2
"4461",1263,1264,1264,"black","age.gp3","NoTr","NoTrade","NoGroup",6,2,4,0,0,2,3,1,3,3,0,6,2,4,2
"4462",2138,2139,2139,"other","age.gp2","NoTr","NoTrade","NoGroup",4,0,3,1,0,1,3,0,1,3,0,4,3,1,2
"4463",2163,2164,2164,"white","age.gp2","Tr","NoTrade","NoGroup",8,0,3,3,2,3,5,0,2,6,2,6,3,5,2
"4464",2765,2766,2766,"black","age.gp2","NoTr","NoTrade","NoGroup",7,1,4,1,1,1,5,1,2,5,0,7,3,4,2
"4465",2965,2966,2966,"white","age.gp2","NoTr","NoTrade","NoGroup",7,1,2,1,3,1,6,0,3,4,0,7,3,4,2
"4466",1274,1275,1275,"white","age.gp4","NoTr","NoTrade","Group",6,1,1,2,2,3,3,0,3,3,2,4,4,2,2
"4467",2293,2294,2294,"other","age.gp2","Tr","NoTrade","Group",10,1,4,4,1,2,8,0,2,8,1,9,8,2,2
"4468",365,366,366,"black","age.gp4","NoTr","NoTrade","NoGroup",6,0,2,1,3,4,2,0,1,5,0,6,3,3,2
"4469",1963,1964,1964,"white","age.gp4","NoTr","NoTrade","Group",7,0,2,1,4,2,5,0,2,5,0,7,4,3,2
"4470",2605,2606,2606,"black","age.gp2","NoTr","NoTrade","Group",22,3,9,6,4,17,5,0,1,21,4,18,11,11,2
"4471",2835,2836,2836,"black","age.gp2","NoTr","NoTrade","NoGroup",11,1,4,5,1,5,6,0,3,8,1,10,6,5,2
"4472",241,242,242,"white","age.gp2","Tr","NoTrade","Group",20,2,9,8,1,1,18,1,8,12,1,19,10,10,2
"4473",962,963,963,"black","age.gp2","NoTr","NoTrade","Group",21,2,7,8,4,9,11,1,5,16,1,20,11,10,2
"4474",1102,1103,1103,"black","age.gp2","NoTr","NoTrade","NoGroup",6,0,4,0,2,1,5,0,3,3,1,5,5,1,2
"4475",2453,2454,2454,"white","age.gp4","NoTr","NoTrade","NoGroup",7,0,3,0,4,1,6,0,4,3,1,6,6,1,2
"4476",2572,2573,2573,"white","age.gp4","NoTr","NoTrade","Group",15,1,6,3,5,1,13,1,7,8,1,14,12,3,2
"4477",2683,2684,2684,"black","age.gp3","NoTr","NoTrade","NoGroup",7,1,2,0,4,1,5,1,4,3,0,7,4,3,2
"4478",2781,2782,2782,"white","age.gp3","NoTr","NoTrade","Group",13,1,7,1,4,0,13,0,9,4,1,12,7,6,2
"4479",310,311,311,"white","age.gp4","NoTr","NoTrade","Group",10,1,2,2,5,0,9,1,6,4,0,10,9,1,2
"4480",358,359,359,"black","age.gp4","NoTr","NoTrade","NoGroup",8,1,3,0,4,3,5,0,3,5,2,6,6,2,2
"4481",407,408,408,"white","age.gp2","Tr","Trade","Group",18,4,10,2,2,1,15,2,6,12,1,17,10,8,2
"4482",535,536,536,"white","age.gp4","NoTr","NoTrade","NoGroup",4,0,2,0,2,0,4,0,3,1,0,4,4,0,2
"4483",831,832,832,"white","age.gp3","NoTr","NoTrade","NoGroup",5,0,1,3,1,0,5,0,3,2,0,5,3,2,2
"4484",957,958,958,"black","age.gp2","Tr","NoTrade","NoGroup",8,0,3,4,1,4,4,0,4,4,0,8,5,3,2
"4485",1622,1623,1623,"white","age.gp2","Tr","NoTrade","Group",13,0,7,5,1,1,11,1,6,7,1,12,10,3,2
"4486",1909,1910,1910,"other","age.gp2","NoTr","NoTrade","NoGroup",7,0,1,4,2,1,6,0,4,3,0,7,3,4,2
"4487",2120,2121,2121,"white","age.gp3","NoTr","NoTrade","Group",17,1,6,4,6,0,16,1,6,11,0,17,11,6,2
"4488",345,346,346,"white","age.gp2","NoTr","NoTrade","Group",15,0,11,3,1,1,12,2,7,8,0,15,13,2,2
"4489",855,856,856,"other","age.gp2","Tr","NoTrade","Group",12,0,6,4,2,0,12,0,7,5,2,10,10,2,2
"4490",1239,1240,1240,"white","age.gp2","Tr","NoTrade","NoGroup",4,0,2,2,0,0,4,0,2,2,0,4,3,1,2
"4491",1729,1730,1730,"white","age.gp3","Tr","NoTrade","Group",24,0,15,8,1,2,21,1,12,12,3,21,19,5,2
"4492",2521,2522,2522,"white","age.gp2","Tr","NoTrade","Group",20,0,11,3,6,0,18,2,8,12,2,18,16,4,2
"4493",2666,2667,2667,"white","age.gp3","NoTr","NoTrade","NoGroup",4,0,4,0,0,0,4,0,3,1,0,4,4,0,2
"4494",543,544,544,"white","age.gp4","NoTr","NoTrade","NoGroup",1,0,1,0,0,0,1,0,1,0,0,1,1,0,2
"4495",581,582,582,"other","age.gp4","NoTr","NoTrade","NoGroup",2,0,1,0,1,0,2,0,1,1,0,2,2,0,2
"4496",945,946,946,"white","age.gp3","Tr","NoTrade","Group",13,0,5,2,6,2,11,0,5,8,1,12,10,3,2
"4497",1319,1320,1320,"white","age.gp2","NoTr","NoTrade","NoGroup",10,0,7,3,0,1,7,2,3,7,1,9,5,5,2
"4498",2590,2591,2591,"white","age.gp3","NoTr","NoTrade","Group",13,1,6,3,3,1,11,1,8,5,1,12,8,5,2
"4499",2660,2661,2661,"white","age.gp2","NoTr","NoTrade","Group",27,2,13,8,4,4,21,2,11,16,1,26,20,7,2
"4500",832,833,833,"white","age.gp3","NoTr","NoTrade","NoGroup",9,0,5,4,0,0,9,0,6,3,2,7,7,2,2
"4501",1266,1267,1267,"black","age.gp3","NoTr","NoTrade","NoGroup",7,3,2,0,2,4,2,1,2,5,0,7,3,4,2
"4502",1413,1414,1414,"white","age.gp3","NoTr","NoTrade","Group",27,2,9,6,10,2,24,1,8,19,4,23,22,5,2
"4503",2508,2509,2509,"black","age.gp2","NoTr","NoTrade","NoGroup",13,1,9,1,2,8,5,0,4,9,0,13,5,8,2
"4504",2938,2939,2939,"white","age.gp4","NoTr","NoTrade","Group",7,2,2,0,3,0,7,0,2,5,0,7,6,1,2
"4505",839,840,840,"white","age.gp2","NoTr","NoTrade","Group",19,1,13,3,2,1,17,1,12,7,1,18,12,7,2
"4506",872,873,873,"other","age.gp2","Tr","NoTrade","Group",16,1,12,1,2,1,14,1,7,9,0,16,8,8,2
"4507",986,987,987,"white","age.gp4","NoTr","NoTrade","NoGroup",3,0,1,0,2,0,3,0,2,1,0,3,2,1,2
"4508",1376,1377,1377,"black","age.gp2","NoTr","NoTrade","NoGroup",6,0,3,1,2,4,2,0,1,5,0,6,3,3,2
"4509",1805,1806,1806,"white","age.gp2","Tr","NoTrade","Group",26,2,14,3,7,1,21,4,14,12,0,26,17,9,2
"4510",1949,1950,1950,"white","age.gp4","NoTr","NoTrade","Group",11,1,2,2,6,0,10,1,2,9,1,10,9,2,2
"4511",2161,2162,2162,"white","age.gp2","Tr","NoTrade","NoGroup",8,2,5,1,0,1,6,1,3,5,0,8,6,2,2
"4512",859,860,860,"other","age.gp2","Tr","NoTrade","Group",8,0,3,4,1,0,8,0,3,5,0,8,6,2,2
"4513",1312,1313,1313,"white","age.gp1","NoTr","NoTrade","NoGroup",12,5,6,0,1,0,9,3,7,5,0,12,6,6,2
"4514",1498,1499,1499,"white","age.gp4","NoTr","NoTrade","NoGroup",1,0,1,0,0,0,1,0,1,0,0,1,1,0,2
"4515",2297,2298,2298,"other","age.gp2","Tr","NoTrade","Group",9,0,6,3,0,0,9,0,4,5,1,8,9,0,2
"4516",2529,2530,2530,"white","age.gp2","NoTr","NoTrade","Group",24,3,9,5,7,2,20,2,6,18,2,22,15,9,2
"4517",294,295,295,"black","age.gp2","NoTr","NoTrade","Group",17,2,9,3,3,6,11,0,6,11,1,16,12,5,2
"4518",438,439,439,"white","age.gp4","NoTr","NoTrade","NoGroup",1,0,1,0,0,0,1,0,1,0,0,1,1,0,2
"4519",634,635,635,"other","age.gp1","NoTr","Trade","Group",9,5,2,1,1,1,8,0,3,6,1,8,6,3,2
"4520",1424,1425,1425,"white","age.gp2","Tr","NoTrade","Group",19,1,9,4,5,2,16,1,6,13,1,18,15,4,2
"4521",1648,1649,1649,"other","age.gp2","NoTr","NoTrade","NoGroup",5,1,2,2,0,0,5,0,2,3,1,4,2,3,2
"4522",2923,2924,2924,"white","age.gp4","NoTr","NoTrade","Group",14,1,3,4,6,1,13,0,7,7,1,13,9,5,2
"4523",2935,2936,2936,"white","age.gp4","NoTr","NoTrade","Group",10,0,5,1,4,1,9,0,3,7,2,8,6,4,2
"4524",1403,1404,1404,"white","age.gp3","NoTr","NoTrade","Group",12,1,5,5,1,0,12,0,5,7,1,11,9,3,2
"4525",1572,1573,1573,"white","age.gp4","Tr","NoTrade","Group",14,0,4,2,8,0,12,2,7,7,2,12,12,2,2
"4526",1591,1592,1592,"white","age.gp4","Tr","NoTrade","Group",10,1,3,3,3,1,8,1,6,4,0,10,7,3,2
"4527",1944,1945,1945,"white","age.gp4","NoTr","NoTrade","Group",17,1,5,4,7,1,16,0,10,7,1,16,14,3,2
"4528",2159,2160,2160,"white","age.gp2","Tr","NoTrade","NoGroup",9,1,4,0,4,1,8,0,3,6,0,9,6,3,2
"4529",2671,2672,2672,"white","age.gp3","NoTr","NoTrade","NoGroup",1,0,1,0,0,0,1,0,1,0,0,1,1,0,2
"4530",2751,2752,2752,"white","age.gp3","NoTr","NoTrade","NoGroup",7,3,2,0,2,1,5,1,2,5,1,6,4,3,2
"4531",2822,2823,2823,"other","age.gp2","NoTr","NoTrade","NoGroup",7,1,2,2,2,1,6,0,4,3,2,5,6,1,2
"4532",840,841,841,"white","age.gp2","NoTr","NoTrade","Group",24,3,12,7,2,1,20,3,13,11,3,21,19,5,2
"4533",912,913,913,"other","age.gp1","Tr","NoTrade","NoGroup",4,1,2,0,1,1,3,0,2,2,0,4,4,0,2
"4534",998,999,999,"white","age.gp4","NoTr","NoTrade","NoGroup",3,1,1,0,1,0,2,1,1,2,0,3,2,1,2
"4535",1568,1569,1569,"white","age.gp4","Tr","NoTrade","Group",16,3,2,5,6,1,14,1,7,9,1,15,9,7,2
"4536",1643,1644,1644,"other","age.gp2","NoTr","NoTrade","NoGroup",5,0,4,0,1,1,4,0,2,3,0,5,2,3,2
"4537",2164,2165,2165,"black","age.gp2","NoTr","NoTrade","NoGroup",1,0,1,0,0,0,1,0,1,0,0,1,1,0,2
"4538",239,240,240,"white","age.gp2","Tr","NoTrade","Group",13,1,5,4,3,1,11,1,4,9,1,12,10,3,2
"4539",507,508,508,"white","age.gp2","Tr","NoTrade","NoGroup",8,0,6,1,1,0,6,2,3,5,1,7,5,3,2
"4540",838,839,839,"white","age.gp2","NoTr","NoTrade","Group",16,2,7,2,5,1,15,0,8,8,1,15,10,6,2
"4541",1092,1093,1093,"black","age.gp1","NoTr","NoTrade","NoGroup",4,1,1,1,1,2,2,0,2,2,1,3,2,2,2
"4542",1299,1300,1300,"white","age.gp4","NoTr","NoTrade","Group",12,1,4,2,5,2,9,1,4,8,3,9,9,3,2
"4543",1770,1771,1771,"black","age.gp4","NoTr","NoTrade","NoGroup",7,0,2,1,4,3,4,0,3,4,0,7,3,4,2
"4544",1842,1843,1843,"black","age.gp3","NoTr","NoTrade","NoGroup",4,1,2,1,0,2,1,1,2,2,0,4,1,3,2
"4545",2121,2122,2122,"white","age.gp3","NoTr","NoTrade","Group",16,3,6,3,4,1,14,1,7,9,0,16,11,5,2
"4546",2127,2128,2128,"white","age.gp3","NoTr","NoTrade","Group",11,2,2,4,3,1,9,1,4,7,2,9,7,4,2
"4547",2531,2532,2532,"other","age.gp1","NoTr","NoTrade","NoGroup",5,2,2,1,0,1,3,1,3,2,0,5,3,2,2
"4548",417,418,418,"white","age.gp4","NoTr","NoTrade","NoGroup",6,0,2,0,4,1,5,0,2,4,0,6,5,1,2
"4549",954,955,955,"white","age.gp3","Tr","NoTrade","Group",14,4,1,5,4,1,13,0,6,8,1,13,9,5,2
"4550",1868,1869,1869,"other","age.gp1","NoTr","NoTrade","Group",10,7,1,2,0,0,10,0,1,9,2,8,6,4,2
"4551",2595,2596,2596,"white","age.gp3","NoTr","NoTrade","Group",12,1,6,5,0,0,12,0,6,6,0,12,11,1,2
"4552",2669,2670,2670,"white","age.gp3","NoTr","NoTrade","NoGroup",3,0,3,0,0,0,2,1,2,1,0,3,1,2,2
"4553",1214,1215,1215,"white","age.gp4","NoTr","NoTrade","NoGroup",1,0,1,0,0,0,1,0,1,0,0,1,1,0,2
"4554",1428,1429,1429,"white","age.gp2","Tr","NoTrade","Group",20,2,8,6,4,2,17,1,4,16,1,19,11,9,2
"4555",2540,2541,2541,"other","age.gp1","NoTr","NoTrade","NoGroup",2,1,1,0,0,0,2,0,2,0,0,2,1,1,2
"4556",2574,2575,2575,"white","age.gp4","NoTr","NoTrade","Group",11,0,2,3,6,0,11,0,6,5,1,10,9,2,2
"4557",2692,2693,2693,"white","age.gp4","NoTr","NoTrade","Group",15,1,5,2,7,3,9,3,3,12,3,12,9,6,2
"4558",2814,2815,2815,"other","age.gp2","NoTr","NoTrade","NoGroup",5,0,2,0,3,0,5,0,2,3,0,5,3,2,2
"4559",2883,2884,2884,"white","age.gp1","NoTr","NoTrade","Group",26,14,6,3,3,1,20,5,6,20,1,25,15,11,2
"4560",2945,2946,2946,"white","age.gp4","NoTr","NoTrade","Group",13,0,6,3,4,1,10,2,8,5,2,11,12,1,2
"4561",1326,1327,1327,"white","age.gp3","NoTr","NoTrade","NoGroup",8,1,5,0,2,0,8,0,5,3,0,8,5,3,2
"4562",2153,2154,2154,"other","age.gp2","NoTr","NoTrade","NoGroup",5,0,3,0,2,0,5,0,4,1,0,5,3,2,2
"4563",2320,2321,2321,"white","age.gp1","NoTr","NoTrade","NoGroup",11,8,2,0,1,2,6,3,3,8,3,8,5,6,2
"4564",2328,2329,2329,"white","age.gp3","Tr","NoTrade","Group",18,2,5,7,4,2,15,1,7,11,1,17,13,5,2
"4565",698,699,699,"white","age.gp4","Tr","NoTrade","Group",11,0,2,3,6,0,10,1,6,5,1,10,9,2,2
"4566",844,845,845,"white","age.gp2","Tr","NoTrade","NoGroup",11,1,3,3,4,1,9,1,2,9,2,9,7,4,2
"4567",1061,1062,1062,"white","age.gp4","NoTr","NoTrade","Group",14,1,4,2,7,2,9,3,4,10,0,14,8,6,2
"4568",1904,1905,1905,"black","age.gp1","NoTr","NoTrade","NoGroup",12,7,3,0,2,1,8,3,4,8,2,10,7,5,2
"4569",2021,2022,2022,"black","age.gp4","NoTr","NoTrade","NoGroup",4,0,1,0,3,0,4,0,2,2,0,4,4,0,2
"4570",2413,2414,2414,"white","age.gp3","NoTr","Trade","Group",16,2,5,6,3,1,15,0,7,9,1,15,11,5,2
"4571",2545,2546,2546,"other","age.gp1","NoTr","NoTrade","NoGroup",3,1,1,0,1,0,3,0,1,2,0,3,1,2,2
"4572",2616,2617,2617,"white","age.gp4","NoTr","NoTrade","NoGroup",7,0,2,3,2,0,7,0,3,4,1,6,6,1,2
"4573",269,270,270,"white","age.gp4","NoTr","NoTrade","NoGroup",6,0,1,2,3,0,6,0,2,4,0,6,4,2,2
"4574",1170,1171,1171,"white","age.gp4","NoTr","NoTrade","NoGroup",1,0,1,0,0,0,1,0,1,0,0,1,1,0,2
"4575",1255,1256,1256,"white","age.gp1","Tr","Trade","Group",15,7,4,2,2,1,12,2,7,8,2,13,9,6,2
"4576",1307,1308,1308,"white","age.gp2","Tr","NoTrade","NoGroup",15,1,8,3,3,2,12,1,6,9,2,13,11,4,2
"4577",1543,1544,1544,"white","age.gp2","NoTr","NoTrade","NoGroup",14,3,6,4,1,4,9,1,8,6,2,12,9,5,2
"4578",2308,2309,2309,"white","age.gp2","NoTr","NoTrade","NoGroup",13,0,8,3,2,1,12,0,4,9,2,11,12,1,2
"4579",2750,2751,2751,"white","age.gp3","NoTr","NoTrade","NoGroup",4,0,3,0,1,1,3,0,3,1,0,4,3,1,2
"4580",2767,2768,2768,"white","age.gp1","NoTr","NoTrade","NoGroup",10,4,1,1,4,1,8,1,4,6,0,10,5,5,2
"4581",2795,2796,2796,"white","age.gp2","Tr","NoTrade","NoGroup",9,1,6,1,1,0,9,0,6,3,1,8,8,1,2
"4582",469,470,470,"black","age.gp3","NoTr","Trade","Group",9,2,3,0,4,5,2,2,3,6,3,6,5,4,2
"4583",940,941,941,"white","age.gp3","NoTr","NoTrade","NoGroup",8,1,3,2,2,0,8,0,5,3,0,8,6,2,2
"4584",1096,1097,1097,"white","age.gp2","NoTr","NoTrade","Group",22,2,13,4,3,2,18,2,13,9,4,18,16,6,2
"4585",1840,1841,1841,"black","age.gp3","NoTr","NoTrade","NoGroup",5,1,2,0,2,2,3,0,2,3,2,3,5,0,2
"4586",2133,2134,2134,"other","age.gp2","NoTr","NoTrade","NoGroup",5,1,2,0,2,0,5,0,2,3,1,4,3,2,2
"4587",2694,2695,2695,"white","age.gp4","NoTr","NoTrade","Group",9,1,1,1,6,1,8,0,3,6,0,9,4,5,2
"4588",2737,2738,2738,"white","age.gp2","Tr","NoTrade","Group",18,1,11,4,2,2,14,2,8,10,0,18,11,7,2
"4589",2912,2913,2913,"other","age.gp1","NoTr","NoTrade","NoGroup",4,3,1,0,0,0,4,0,1,3,1,3,1,3,2
"4590",632,633,633,"other","age.gp1","NoTr","Trade","Group",7,1,3,3,0,1,6,0,1,6,2,5,6,1,2
"4591",987,988,988,"white","age.gp4","NoTr","NoTrade","NoGroup",7,0,2,2,3,0,6,1,2,5,0,7,4,3,2
"4592",1020,1021,1021,"white","age.gp2","NoTr","Trade","Group",20,4,7,6,3,2,16,2,8,12,2,18,12,8,2
"4593",1287,1288,1288,"white","age.gp4","NoTr","NoTrade","Group",10,1,2,1,6,0,10,0,5,5,1,9,8,2,2
"4594",1701,1702,1702,"white","age.gp4","NoTr","Trade","NoGroup",4,0,3,0,1,0,4,0,3,1,0,4,4,0,2
"4595",1935,1936,1936,"white","age.gp4","NoTr","NoTrade","Group",11,1,3,1,6,1,9,1,5,6,2,9,9,2,2
"4596",2632,2633,2633,"white","age.gp4","NoTr","NoTrade","NoGroup",4,0,1,0,3,0,4,0,1,3,0,4,3,1,2
"4597",2898,2899,2899,"other","age.gp1","NoTr","NoTrade","NoGroup",5,3,1,0,1,1,4,0,1,4,1,4,3,2,2
"4598",636,637,637,"other","age.gp1","NoTr","Trade","Group",8,4,1,0,3,1,7,0,2,6,0,8,3,5,2
"4599",1328,1329,1329,"white","age.gp3","NoTr","NoTrade","NoGroup",10,1,4,3,2,1,8,1,4,6,1,9,8,2,2
"4600",1438,1439,1439,"white","age.gp3","Tr","NoTrade","NoGroup",6,0,3,1,2,2,4,0,2,4,0,6,4,2,2
"4601",1915,1916,1916,"other","age.gp2","NoTr","NoTrade","NoGroup",3,0,3,0,0,0,3,0,3,0,0,3,3,0,2
"4602",2151,2152,2152,"other","age.gp2","NoTr","NoTrade","NoGroup",4,0,3,0,1,0,4,0,3,1,0,4,3,1,2
"4603",915,916,916,"other","age.gp1","Tr","NoTrade","NoGroup",2,0,2,0,0,0,2,0,1,1,0,2,2,0,2
"4604",925,926,926,"white","age.gp2","NoTr","NoTrade","NoGroup",13,1,8,4,0,1,10,2,7,6,1,12,9,4,2
"4605",1532,1533,1533,"black","age.gp4","NoTr","NoTrade","NoGroup",5,0,3,0,2,0,3,2,2,3,0,5,3,2,2
"4606",1752,1753,1753,"black","age.gp4","NoTr","NoTrade","NoGroup",5,0,2,0,3,1,4,0,2,3,0,5,4,1,2
"4607",1861,1862,1862,"white","age.gp3","NoTr","NoTrade","Group",16,2,5,3,6,2,13,1,6,10,0,16,11,5,2
"4608",2299,2300,2300,"other","age.gp2","Tr","NoTrade","Group",12,2,6,1,3,3,9,0,7,5,1,11,8,4,2
"4609",2947,2948,2948,"white","age.gp4","NoTr","NoTrade","Group",16,2,4,3,7,2,11,3,8,8,1,15,10,6,2
"4610",248,249,249,"white","age.gp4","NoTr","NoTrade","NoGroup",2,0,1,1,0,0,2,0,1,1,0,2,2,0,2
"4611",249,250,250,"white","age.gp4","NoTr","NoTrade","NoGroup",4,0,1,1,2,0,4,0,2,2,0,4,4,0,2
"4612",1410,1411,1411,"white","age.gp3","NoTr","NoTrade","Group",13,2,6,2,3,1,10,2,5,8,1,12,8,5,2
"4613",250,251,251,"white","age.gp4","NoTr","NoTrade","NoGroup",1,0,0,0,1,0,1,0,0,1,0,1,1,0,2
"4614",2691,2692,2692,"white","age.gp4","NoTr","NoTrade","Group",16,2,0,2,12,1,14,1,3,13,2,14,6,10,2
"4615",251,252,252,"white","age.gp4","NoTr","NoTrade","NoGroup",1,0,1,0,0,0,1,0,1,0,0,1,1,0,2
"4616",252,253,253,"white","age.gp4","NoTr","NoTrade","NoGroup",1,0,0,0,1,0,1,0,1,0,0,1,1,0,2
"4617",2258,2259,2259,"white","age.gp4","Tr","NoTrade","Group",10,1,0,2,7,0,10,0,2,8,0,10,6,4,2
"4618",253,254,254,"white","age.gp4","NoTr","NoTrade","NoGroup",2,0,0,0,2,0,2,0,1,1,0,2,2,0,2
"4619",302,303,303,"white","age.gp4","NoTr","NoTrade","Group",13,1,2,3,7,1,10,2,2,11,1,12,7,6,2
"4620",254,255,255,"white","age.gp4","NoTr","NoTrade","NoGroup",2,0,2,0,0,0,2,0,2,0,0,2,1,1,2
"4621",1806,1807,1807,"white","age.gp2","Tr","NoTrade","Group",17,0,7,5,5,1,14,2,2,15,1,16,10,7,2
"4622",1081,1082,1082,"white","age.gp4","NoTr","NoTrade","Group",10,2,2,2,4,1,8,1,4,6,1,9,7,3,2
"4623",256,257,257,"white","age.gp4","NoTr","NoTrade","NoGroup",1,0,0,1,0,1,0,0,0,1,0,1,0,1,2
"4624",258,259,259,"white","age.gp4","NoTr","NoTrade","NoGroup",2,0,1,0,1,1,1,0,0,2,0,2,1,1,2
"4625",690,691,691,"white","age.gp4","Tr","NoTrade","Group",9,0,0,3,6,0,9,0,0,9,1,8,6,3,2
"4626",1244,1245,1245,"white","age.gp1","NoTr","NoTrade","NoGroup",15,11,1,0,3,0,10,5,4,11,0,15,3,12,2
"4627",1961,1962,1962,"white","age.gp4","NoTr","NoTrade","Group",7,0,0,1,6,0,7,0,1,6,1,6,5,2,2
"4628",260,261,261,"white","age.gp4","NoTr","NoTrade","NoGroup",5,0,1,2,2,1,4,0,1,4,0,5,4,1,2
"4629",1405,1406,1406,"white","age.gp3","NoTr","NoTrade","Group",16,4,7,3,2,2,11,3,6,10,2,14,9,7,2
"4630",2095,2096,2096,"black","age.gp3","NoTr","NoTrade","NoGroup",6,2,0,1,3,4,2,0,0,6,0,6,0,6,2
"4631",261,262,262,"white","age.gp4","NoTr","NoTrade","NoGroup",7,0,4,0,3,0,6,1,4,3,1,6,5,2,2
"4632",565,566,566,"other","age.gp4","NoTr","NoTrade","NoGroup",4,0,1,0,3,0,4,0,2,2,0,4,3,1,2
"4633",262,263,263,"white","age.gp4","NoTr","NoTrade","NoGroup",3,0,1,1,1,0,2,1,1,2,0,3,2,1,2
"4634",1144,1145,1145,"white","age.gp4","NoTr","NoTrade","NoGroup",3,0,1,0,2,1,1,1,0,3,0,3,0,3,2
"4635",263,264,264,"white","age.gp4","NoTr","NoTrade","NoGroup",1,1,0,0,0,1,0,0,0,1,0,1,0,1,2
"4636",266,267,267,"white","age.gp4","NoTr","NoTrade","NoGroup",8,1,0,1,6,1,6,1,3,5,0,8,6,2,2
"4637",888,889,889,"other","age.gp1","Tr","NoTrade","NoGroup",4,2,1,0,1,0,4,0,1,3,0,4,2,2,2
"4638",1515,1516,1516,"black","age.gp4","NoTr","NoTrade","NoGroup",4,0,1,1,2,3,1,0,0,4,0,4,1,3,2
"4639",2580,2581,2581,"white","age.gp4","NoTr","NoTrade","Group",10,1,4,0,5,1,9,0,4,6,1,9,6,4,2
"4640",2950,2951,2951,"white","age.gp4","NoTr","NoTrade","Group",10,1,0,4,5,0,10,0,4,6,1,9,6,4,2
"4641",267,268,268,"white","age.gp4","NoTr","NoTrade","NoGroup",1,0,0,0,1,0,1,0,0,1,0,1,0,1,2
"4642",2428,2429,2429,"white","age.gp4","NoTr","NoTrade","NoGroup",6,0,1,0,5,0,5,1,2,4,0,6,4,2,2
"4643",268,269,269,"white","age.gp4","NoTr","NoTrade","NoGroup",2,0,2,0,0,0,1,1,1,1,0,2,1,1,2
"4644",971,972,972,"white","age.gp4","NoTr","NoTrade","NoGroup",5,0,1,1,3,0,5,0,1,4,0,5,2,3,2
"4645",2175,2176,2176,"white","age.gp4","NoTr","NoTrade","NoGroup",10,1,2,2,5,1,8,1,4,6,1,9,6,4,2
"4646",270,271,271,"white","age.gp4","NoTr","NoTrade","NoGroup",4,0,1,1,2,0,4,0,3,1,0,4,3,1,2
"4647",439,440,440,"white","age.gp4","NoTr","NoTrade","NoGroup",5,0,0,2,3,0,5,0,0,5,1,4,1,4,2
"4648",271,272,272,"white","age.gp4","NoTr","NoTrade","NoGroup",3,1,0,1,1,1,2,0,0,3,0,3,2,1,2
"4649",272,273,273,"white","age.gp4","NoTr","NoTrade","NoGroup",1,0,0,0,1,1,0,0,0,1,0,1,0,1,2
"4650",2019,2020,2020,"black","age.gp4","NoTr","NoTrade","NoGroup",3,0,1,0,2,2,1,0,0,3,0,3,1,2,2
"4651",273,274,274,"white","age.gp4","NoTr","NoTrade","NoGroup",1,0,1,0,0,0,1,0,0,1,0,1,0,1,2
"4652",1318,1319,1319,"white","age.gp2","NoTr","NoTrade","NoGroup",12,0,4,4,4,1,11,0,5,7,0,12,6,6,2
"4653",274,275,275,"white","age.gp4","NoTr","NoTrade","NoGroup",3,0,0,0,3,1,2,0,1,2,0,3,1,2,2
"4654",499,500,500,"black","age.gp4","NoTr","NoTrade","NoGroup",5,1,0,1,3,3,2,0,0,5,0,5,0,5,2
"4655",275,276,276,"white","age.gp4","NoTr","NoTrade","NoGroup",8,1,2,3,2,0,6,2,4,4,0,8,4,4,2
"4656",821,822,822,"white","age.gp3","NoTr","NoTrade","NoGroup",9,1,6,0,2,1,7,1,1,8,0,9,5,4,2
"4657",1592,1593,1593,"white","age.gp4","Tr","NoTrade","Group",10,1,1,1,7,0,9,1,3,7,0,10,6,4,2
"4658",1794,1795,1795,"white","age.gp4","Tr","NoTrade","Group",10,0,0,2,8,0,10,0,2,8,0,10,6,4,2
"4659",1925,1926,1926,"other","age.gp2","NoTr","NoTrade","NoGroup",6,0,4,1,1,0,6,0,4,2,0,6,5,1,2
"4660",2398,2399,2399,"white","age.gp3","NoTr","NoTrade","NoGroup",9,0,1,5,3,1,8,0,2,7,0,9,5,4,2
"4661",276,277,277,"white","age.gp4","NoTr","NoTrade","NoGroup",1,0,1,0,0,0,1,0,0,1,0,1,1,0,2
"4662",455,456,456,"black","age.gp3","NoTr","NoTrade","NoGroup",5,0,1,2,2,1,4,0,2,3,0,5,3,2,2
"4663",278,279,279,"white","age.gp4","NoTr","NoTrade","NoGroup",3,0,0,1,2,0,3,0,0,3,0,3,2,1,2
"4664",775,776,776,"white","age.gp4","NoTr","NoTrade","NoGroup",5,0,1,1,3,1,4,0,1,4,0,5,3,2,2
"4665",1558,1559,1559,"white","age.gp3","NoTr","NoTrade","Group",14,0,3,6,5,1,11,2,6,8,0,14,8,6,2
"4666",1938,1939,1939,"white","age.gp4","NoTr","NoTrade","Group",9,0,2,1,6,1,8,0,1,8,1,8,8,1,2
"4667",279,280,280,"white","age.gp4","NoTr","NoTrade","NoGroup",1,0,0,1,0,0,1,0,0,1,0,1,0,1,2
"4668",822,823,823,"white","age.gp3","NoTr","NoTrade","NoGroup",10,2,2,3,3,2,7,1,3,7,0,10,4,6,2
"4669",1329,1330,1330,"white","age.gp3","NoTr","NoTrade","NoGroup",6,0,3,2,1,0,5,1,2,4,1,5,4,2,2
"4670",1683,1684,1684,"white","age.gp4","NoTr","Trade","NoGroup",6,0,3,1,2,0,6,0,4,2,0,6,4,2,2
"4671",2367,2368,2368,"black","age.gp2","Tr","NoTrade","Group",19,3,5,7,4,11,8,0,5,14,1,18,7,12,2
"4672",2837,2838,2838,"black","age.gp2","NoTr","NoTrade","NoGroup",6,1,2,2,1,3,3,0,1,5,0,6,3,3,2
"4673",2936,2937,2937,"white","age.gp4","NoTr","NoTrade","Group",6,0,3,1,2,0,6,0,5,1,0,6,5,1,2
"4674",1672,1673,1673,"white","age.gp2","Tr","NoTrade","NoGroup",10,0,7,2,1,1,9,0,3,7,1,9,6,4,2
"4675",2304,2305,2305,"other","age.gp2","Tr","NoTrade","Group",14,1,7,5,1,0,14,0,7,7,0,14,10,4,2
"4676",2662,2663,2663,"white","age.gp3","NoTr","NoTrade","NoGroup",6,2,2,1,1,1,5,0,3,3,0,6,3,3,2
"4677",770,771,771,"white","age.gp4","NoTr","NoTrade","NoGroup",3,0,1,0,2,0,3,0,2,1,0,3,3,0,2
"4678",933,934,934,"white","age.gp3","NoTr","NoTrade","NoGroup",6,1,2,1,2,0,6,0,4,2,0,6,4,2,2
"4679",1661,1662,1662,"other","age.gp2","NoTr","NoTrade","NoGroup",7,0,2,2,3,2,5,0,1,6,1,6,5,2,2
"4680",1865,1866,1866,"white","age.gp3","NoTr","NoTrade","Group",19,5,9,2,3,3,15,1,10,9,2,17,12,7,2
"4681",2748,2749,2749,"white","age.gp3","NoTr","NoTrade","NoGroup",5,2,3,0,0,0,4,1,3,2,0,5,4,1,2
"4682",477,478,478,"black","age.gp4","NoTr","NoTrade","NoGroup",2,0,1,0,1,1,1,0,1,1,0,2,1,1,2
"4683",852,853,853,"other","age.gp2","Tr","NoTrade","Group",9,1,2,4,2,1,8,0,2,7,0,9,7,2,2
"4684",980,981,981,"white","age.gp4","NoTr","NoTrade","NoGroup",1,0,1,0,0,0,1,0,1,0,0,1,1,0,2
"4685",1922,1923,1923,"other","age.gp2","NoTr","NoTrade","NoGroup",5,0,2,2,1,1,4,0,2,3,1,4,5,0,2
"4686",2274,2275,2275,"black","age.gp2","Tr","Trade","Group",18,1,9,5,3,10,8,0,4,14,2,16,8,10,2
"4687",2434,2435,2435,"white","age.gp4","NoTr","NoTrade","NoGroup",1,0,1,0,0,0,1,0,1,0,0,1,1,0,2
"4688",2685,2686,2686,"black","age.gp3","NoTr","NoTrade","NoGroup",6,2,3,1,0,4,2,0,1,5,0,6,2,4,2
"4689",788,789,789,"black","age.gp1","Tr","NoTrade","NoGroup",15,4,3,6,2,5,8,2,3,12,2,13,12,3,2
"4690",2134,2135,2135,"other","age.gp2","NoTr","NoTrade","NoGroup",5,0,3,2,0,1,4,0,2,3,0,5,4,1,2
"4691",2867,2868,2868,"white","age.gp2","Tr","NoTrade","Group",23,3,9,6,5,2,19,2,9,14,0,23,13,10,2
"4692",2937,2938,2938,"white","age.gp4","NoTr","NoTrade","Group",5,0,2,0,3,1,4,0,1,4,1,4,3,2,2
"4693",1011,1012,1012,"white","age.gp1","Tr","NoTrade","NoGroup",12,6,2,2,2,0,10,2,3,9,1,11,7,5,2
"4694",1084,1085,1085,"white","age.gp4","NoTr","NoTrade","Group",13,1,0,3,9,0,13,0,4,9,2,11,8,5,2
"4695",648,649,649,"other","age.gp1","NoTr","Trade","Group",6,5,0,1,0,0,6,0,3,3,0,6,2,4,2
"4696",1881,1882,1882,"other","age.gp1","NoTr","NoTrade","Group",11,6,1,3,1,3,8,0,2,9,1,10,4,7,2
"4697",2382,2383,2383,"white","age.gp1","NoTr","NoTrade","NoGroup",10,8,1,0,1,0,9,1,3,7,3,7,3,7,2
"4698",287,288,288,"white","age.gp1","NoTr","NoTrade","NoGroup",9,5,1,2,1,2,5,2,3,6,0,9,5,4,2
"4699",1850,1851,1851,"black","age.gp3","NoTr","NoTrade","NoGroup",7,1,1,2,3,3,4,0,1,6,1,6,4,3,2
"4700",1905,1906,1906,"black","age.gp1","NoTr","NoTrade","NoGroup",9,3,1,4,1,6,2,1,2,7,1,8,2,7,2
"4701",2056,2057,2057,"white","age.gp4","Tr","NoTrade","Group",9,2,2,0,5,0,8,1,4,5,0,9,4,5,2
"4702",643,644,644,"other","age.gp1","NoTr","Trade","Group",6,4,1,1,0,2,4,0,2,4,0,6,2,4,2
"4703",785,786,786,"black","age.gp1","Tr","NoTrade","NoGroup",11,4,0,7,0,7,3,1,1,10,1,10,1,10,2
"4704",1306,1307,1307,"white","age.gp2","Tr","NoTrade","NoGroup",7,2,4,0,1,3,3,1,2,5,2,5,3,4,2
"4705",289,290,290,"white","age.gp1","NoTr","NoTrade","NoGroup",17,12,2,1,2,2,11,4,1,16,1,16,10,7,2
"4706",958,959,959,"black","age.gp2","Tr","NoTrade","NoGroup",11,1,7,1,2,5,6,0,3,8,0,11,4,7,2
"4707",1384,1385,1385,"white","age.gp1","NoTr","NoTrade","NoGroup",13,8,2,0,3,2,7,4,1,12,4,9,9,4,2
"4708",2770,2771,2771,"white","age.gp1","NoTr","NoTrade","NoGroup",4,3,0,0,1,1,2,1,0,4,0,4,0,4,2
"4709",1349,1350,1350,"black","age.gp4","NoTr","NoTrade","Group",9,2,2,2,3,2,7,0,3,6,0,9,6,3,2
"4710",1502,1503,1503,"white","age.gp4","NoTr","NoTrade","NoGroup",6,0,1,2,3,2,4,0,2,4,0,6,6,0,2
"4711",2276,2277,2277,"black","age.gp2","Tr","Trade","Group",13,0,8,3,2,7,5,1,6,7,1,12,8,5,2
"4712",291,292,292,"black","age.gp2","NoTr","NoTrade","Group",16,2,5,4,5,8,6,2,6,10,4,12,9,7,2
"4713",377,378,378,"black","age.gp4","NoTr","NoTrade","NoGroup",1,0,1,0,0,1,0,0,0,1,0,1,1,0,2
"4714",475,476,476,"black","age.gp3","NoTr","Trade","Group",10,0,1,6,3,7,3,0,3,7,0,10,5,5,2
"4715",1596,1597,1597,"black","age.gp1","Tr","Trade","NoGroup",7,2,1,0,4,5,1,1,1,6,2,5,3,4,2
"4716",2144,2145,2145,"other","age.gp2","NoTr","NoTrade","NoGroup",4,0,3,1,0,2,2,0,2,2,0,4,3,1,2
"4717",2268,2269,2269,"white","age.gp4","Tr","NoTrade","Group",6,1,2,0,3,1,5,0,2,4,0,6,6,0,2
"4718",2298,2299,2299,"other","age.gp2","Tr","NoTrade","Group",7,0,5,0,2,3,4,0,2,5,1,6,6,1,2
"4719",1054,1055,1055,"white","age.gp4","NoTr","NoTrade","Group",11,1,5,2,3,2,8,1,2,9,2,9,9,2,2
"4720",1205,1206,1206,"white","age.gp4","Tr","NoTrade","NoGroup",6,0,4,1,1,1,5,0,1,5,0,6,3,3,2
"4721",1593,1594,1594,"black","age.gp1","Tr","Trade","NoGroup",7,4,1,1,1,3,2,2,2,5,0,7,2,5,2
"4722",2075,2076,2076,"black","age.gp3","NoTr","NoTrade","NoGroup",5,2,3,0,0,3,2,0,1,4,1,4,4,1,2
"4723",2507,2508,2508,"black","age.gp2","NoTr","NoTrade","NoGroup",8,1,5,1,1,7,1,0,2,6,1,7,6,2,2
"4724",1091,1092,1092,"black","age.gp1","NoTr","NoTrade","NoGroup",10,4,1,3,2,4,5,1,1,9,0,10,5,5,2
"4725",1100,1101,1101,"black","age.gp2","NoTr","NoTrade","NoGroup",6,0,5,1,0,5,0,1,0,6,0,6,3,3,2
"4726",1320,1321,1321,"white","age.gp2","Tr","NoTrade","Group",15,1,7,4,3,2,13,0,5,10,1,14,11,4,2
"4727",1418,1419,1419,"black","age.gp2","NoTr","NoTrade","NoGroup",9,2,6,1,0,3,5,1,4,5,2,7,6,3,2
"4728",1751,1752,1752,"black","age.gp4","NoTr","NoTrade","NoGroup",7,0,4,0,3,2,5,0,1,6,0,7,5,2,2
"4729",2506,2507,2507,"black","age.gp2","NoTr","NoTrade","NoGroup",8,0,4,1,3,4,3,1,4,4,1,7,6,2,2
"4730",1165,1166,1166,"white","age.gp4","NoTr","NoTrade","NoGroup",1,0,1,0,0,1,0,0,0,1,0,1,1,0,2
"4731",2446,2447,2447,"white","age.gp4","NoTr","NoTrade","NoGroup",7,1,2,0,4,1,4,2,4,3,0,7,5,2,2
"4732",393,394,394,"black","age.gp4","NoTr","NoTrade","NoGroup",3,0,0,1,2,1,2,0,1,2,0,3,2,1,2
"4733",795,796,796,"white","age.gp4","NoTr","NoTrade","NoGroup",7,1,1,0,5,0,6,1,1,6,0,7,4,3,2
"4734",1177,1178,1178,"white","age.gp4","Tr","NoTrade","NoGroup",5,1,1,0,3,0,5,0,0,5,0,5,5,0,2
"4735",1181,1182,1182,"white","age.gp4","Tr","NoTrade","NoGroup",5,2,1,0,2,0,4,1,1,4,0,5,3,2,2
"4736",1251,1252,1252,"white","age.gp2","Tr","NoTrade","Group",21,0,11,6,4,2,18,1,4,17,0,21,10,11,2
"4737",2143,2144,2144,"other","age.gp2","NoTr","NoTrade","NoGroup",3,1,1,0,1,0,2,1,1,2,0,3,2,1,2
"4738",2921,2922,2922,"white","age.gp4","NoTr","NoTrade","Group",13,2,3,4,4,1,12,0,7,6,1,12,12,1,2
"4739",390,391,391,"black","age.gp4","NoTr","NoTrade","NoGroup",6,0,1,0,5,3,3,0,0,6,0,6,3,3,2
"4740",1542,1543,1543,"white","age.gp2","NoTr","NoTrade","NoGroup",7,0,2,2,3,0,7,0,1,6,0,7,4,3,2
"4741",2589,2590,2590,"white","age.gp4","NoTr","NoTrade","Group",11,1,3,1,6,0,9,2,5,6,0,11,8,3,2
"4742",1799,1800,1800,"white","age.gp4","Tr","NoTrade","Group",11,0,2,4,5,1,9,1,2,9,0,11,9,2,2
"4743",2598,2599,2599,"white","age.gp3","NoTr","NoTrade","Group",15,3,2,2,8,1,12,2,4,11,0,15,7,8,2
"4744",298,299,299,"white","age.gp4","NoTr","NoTrade","Group",12,0,1,1,10,0,12,0,4,8,2,10,7,5,2
"4745",529,530,530,"white","age.gp4","NoTr","NoTrade","NoGroup",3,0,1,0,2,1,2,0,2,1,0,3,3,0,2
"4746",681,682,682,"white","age.gp4","Tr","NoTrade","Group",10,0,1,4,5,0,10,0,2,8,0,10,7,3,2
"4747",790,791,791,"white","age.gp4","NoTr","NoTrade","NoGroup",1,0,0,0,1,0,1,0,0,1,0,1,1,0,2
"4748",1684,1685,1685,"white","age.gp4","NoTr","Trade","NoGroup",6,0,2,2,2,0,5,1,3,3,1,5,6,0,2
"4749",1696,1697,1697,"white","age.gp4","NoTr","Trade","NoGroup",4,1,1,1,1,1,3,0,1,3,1,3,3,1,2
"4750",587,588,588,"other","age.gp4","NoTr","NoTrade","NoGroup",2,0,0,0,2,0,2,0,1,1,0,2,2,0,2
"4751",1225,1226,1226,"white","age.gp4","NoTr","NoTrade","NoGroup",3,0,0,0,3,0,3,0,2,1,0,3,2,1,2
"4752",1924,1925,1925,"other","age.gp2","NoTr","NoTrade","NoGroup",2,0,1,0,1,0,2,0,0,2,0,2,1,1,2
"4753",2571,2572,2572,"white","age.gp4","NoTr","NoTrade","Group",8,1,1,1,5,2,5,1,2,6,3,5,5,3,2
"4754",2577,2578,2578,"white","age.gp4","NoTr","NoTrade","Group",12,1,2,3,6,2,9,1,4,8,2,10,7,5,2
"4755",491,492,492,"black","age.gp4","NoTr","NoTrade","NoGroup",6,1,0,2,3,5,1,0,1,5,1,5,2,4,2
"4756",834,835,835,"white","age.gp3","NoTr","NoTrade","NoGroup",7,0,4,2,1,0,7,0,4,3,1,6,5,2,2
"4757",1569,1570,1570,"white","age.gp4","Tr","NoTrade","Group",8,2,2,0,4,0,7,1,2,6,1,7,7,1,2
"4758",2042,2043,2043,"white","age.gp4","Tr","NoTrade","Group",12,2,2,3,5,1,9,2,2,10,1,11,7,5,2
"4759",2552,2553,2553,"other","age.gp1","NoTr","NoTrade","NoGroup",7,3,0,2,2,2,5,0,2,5,1,6,2,5,2
"4760",2581,2582,2582,"white","age.gp4","NoTr","NoTrade","Group",10,0,2,1,7,0,10,0,3,7,0,10,7,3,2
"4761",2743,2744,2744,"white","age.gp2","NoTr","NoTrade","Group",21,2,14,1,4,2,16,3,12,9,3,18,16,5,2
"4762",429,430,430,"white","age.gp4","NoTr","NoTrade","NoGroup",4,0,0,2,2,0,4,0,1,3,0,4,3,1,2
"4763",893,894,894,"other","age.gp1","Tr","NoTrade","NoGroup",8,5,0,1,2,0,8,0,2,6,0,8,3,5,2
"4764",1172,1173,1173,"white","age.gp4","NoTr","NoTrade","NoGroup",2,0,0,0,2,0,2,0,0,2,0,2,2,0,2
"4765",2221,2222,2222,"black","age.gp4","NoTr","Trade","Group",15,2,5,1,7,6,8,1,7,8,2,13,10,5,2
"4766",303,304,304,"white","age.gp4","NoTr","NoTrade","Group",14,2,2,1,9,2,10,2,7,7,2,12,10,4,2
"4767",1101,1102,1102,"black","age.gp2","NoTr","NoTrade","NoGroup",8,1,3,1,3,2,6,0,5,3,0,8,4,4,2
"4768",1185,1186,1186,"white","age.gp4","Tr","NoTrade","NoGroup",4,0,1,0,3,0,3,1,0,4,0,4,2,2,2
"4769",1782,1783,1783,"white","age.gp4","Tr","NoTrade","Group",13,2,2,1,8,0,12,1,5,8,0,13,10,3,2
"4770",1896,1897,1897,"white","age.gp1","Tr","NoTrade","NoGroup",7,3,3,0,1,1,6,0,4,3,1,6,4,3,2
"4771",2036,2037,2037,"white","age.gp4","Tr","NoTrade","Group",11,1,1,0,9,1,10,0,2,9,0,11,6,5,2
"4772",2226,2227,2227,"black","age.gp4","NoTr","Trade","Group",9,1,1,3,4,6,3,0,1,8,0,9,2,7,2
"4773",2495,2496,2496,"other","age.gp1","NoTr","NoTrade","NoGroup",5,2,1,0,2,0,5,0,2,3,0,5,2,3,2
"4774",1573,1574,1574,"white","age.gp4","Tr","NoTrade","Group",13,0,5,2,6,1,11,1,5,8,1,12,12,1,2
"4775",2178,2179,2179,"white","age.gp4","NoTr","NoTrade","NoGroup",5,0,2,0,3,0,4,1,3,2,0,5,3,2,2
"4776",2357,2358,2358,"white","age.gp3","Tr","NoTrade","NoGroup",4,0,0,2,2,1,3,0,0,4,0,4,2,2,2
"4777",2711,2712,2712,"white","age.gp4","NoTr","NoTrade","Group",11,0,1,2,8,0,11,0,1,10,0,11,9,2,2
"4778",2791,2792,2792,"white","age.gp2","NoTr","NoTrade","Group",28,3,15,3,7,1,23,4,16,12,1,27,16,12,2
"4779",305,306,306,"white","age.gp4","NoTr","NoTrade","Group",7,1,2,1,3,1,6,0,3,4,1,6,5,2,2
"4780",1059,1060,1060,"white","age.gp4","NoTr","NoTrade","Group",10,1,4,1,4,1,9,0,6,4,0,10,6,4,2
"4781",801,802,802,"white","age.gp4","NoTr","NoTrade","NoGroup",3,0,0,1,2,0,3,0,1,2,0,3,2,1,2
"4782",1998,1999,1999,"black","age.gp4","NoTr","NoTrade","NoGroup",9,0,2,2,5,2,6,1,4,5,0,9,8,1,2
"4783",2672,2673,2673,"white","age.gp3","NoTr","NoTrade","NoGroup",9,0,5,0,4,0,8,1,4,5,0,9,8,1,2
"4784",2896,2897,2897,"other","age.gp1","NoTr","NoTrade","NoGroup",3,0,0,1,2,0,3,0,0,3,0,3,3,0,2
"4785",307,308,308,"white","age.gp4","NoTr","NoTrade","Group",14,0,5,4,5,1,12,1,7,7,2,12,8,6,2
"4786",414,415,415,"white","age.gp4","NoTr","NoTrade","NoGroup",5,0,0,1,4,0,5,0,3,2,0,5,5,0,2
"4787",685,686,686,"white","age.gp4","Tr","NoTrade","Group",12,1,1,4,6,2,10,0,3,9,0,12,6,6,2
"4788",946,947,947,"white","age.gp3","Tr","NoTrade","Group",15,1,4,3,7,3,12,0,4,11,1,14,12,3,2
"4789",1526,1527,1527,"black","age.gp4","NoTr","NoTrade","NoGroup",5,2,1,0,2,2,2,1,0,5,1,4,4,1,2
"4790",1615,1616,1616,"white","age.gp3","Tr","NoTrade","NoGroup",6,0,1,2,3,0,5,1,2,4,0,6,5,1,2
"4791",1689,1690,1690,"white","age.gp4","NoTr","Trade","NoGroup",5,0,0,2,3,0,4,1,1,4,0,5,2,3,2
"4792",2704,2705,2705,"white","age.gp4","NoTr","NoTrade","Group",9,1,0,2,6,2,7,0,4,5,0,9,6,3,2
"4793",2799,2800,2800,"white","age.gp2","NoTr","NoTrade","NoGroup",13,0,7,3,3,1,11,1,3,10,1,12,8,5,2
"4794",325,326,326,"white","age.gp4","NoTr","NoTrade","Group",11,0,5,2,4,1,9,1,4,7,0,11,10,1,2
"4795",548,549,549,"white","age.gp4","NoTr","NoTrade","NoGroup",7,1,1,0,5,0,7,0,3,4,1,6,6,1,2
"4796",906,907,907,"other","age.gp1","Tr","NoTrade","NoGroup",7,4,1,1,1,0,7,0,1,6,1,6,5,2,2
"4797",1916,1917,1917,"other","age.gp2","NoTr","NoTrade","NoGroup",4,0,2,1,1,1,3,0,2,2,0,4,1,3,2
"4798",2733,2734,2734,"black","age.gp3","NoTr","NoTrade","NoGroup",8,0,2,1,5,3,4,1,2,6,1,7,6,2,2
"4799",1293,1294,1294,"white","age.gp4","NoTr","NoTrade","Group",9,0,3,1,5,0,9,0,3,6,0,9,6,3,2
"4800",1483,1484,1484,"white","age.gp4","NoTr","NoTrade","NoGroup",10,2,1,3,4,0,10,0,4,6,1,9,6,4,2
"4801",1160,1161,1161,"white","age.gp4","NoTr","NoTrade","NoGroup",8,0,4,1,3,0,7,1,5,3,1,7,8,0,2
"4802",1988,1989,1989,"white","age.gp4","Tr","NoTrade","NoGroup",1,0,0,0,1,0,1,0,0,1,0,1,1,0,2
"4803",2183,2184,2184,"white","age.gp4","NoTr","NoTrade","NoGroup",7,2,3,0,2,0,5,2,4,3,0,7,3,4,2
"4804",2442,2443,2443,"white","age.gp4","NoTr","NoTrade","NoGroup",1,0,0,0,1,0,1,0,0,1,0,1,1,0,2
"4805",2448,2449,2449,"white","age.gp4","NoTr","NoTrade","NoGroup",8,0,2,2,4,2,6,0,3,5,0,8,5,3,2
"4806",1339,1340,1340,"white","age.gp3","NoTr","NoTrade","NoGroup",8,1,3,3,1,2,6,0,1,7,0,8,4,4,2
"4807",1579,1580,1580,"white","age.gp4","Tr","NoTrade","Group",9,1,1,2,5,1,8,0,5,4,1,8,6,3,2
"4808",2353,2354,2354,"white","age.gp3","Tr","NoTrade","NoGroup",6,0,2,3,1,1,4,1,1,5,1,5,5,1,2
"4809",2576,2577,2577,"white","age.gp4","NoTr","NoTrade","Group",13,1,3,4,5,1,11,1,5,8,0,13,10,3,2
"4810",1730,1731,1731,"white","age.gp3","Tr","NoTrade","Group",16,3,5,6,2,0,14,2,5,11,0,16,10,6,2
"4811",2007,2008,2008,"black","age.gp4","NoTr","NoTrade","NoGroup",4,0,1,1,2,1,3,0,2,2,1,3,3,1,2
"4812",2230,2231,2231,"black","age.gp4","NoTr","Trade","Group",9,0,2,1,6,2,5,2,1,8,1,8,3,6,2
"4813",2631,2632,2632,"white","age.gp4","NoTr","NoTrade","NoGroup",10,1,3,0,6,1,7,2,2,8,0,10,5,5,2
"4814",2794,2795,2795,"white","age.gp2","Tr","NoTrade","NoGroup",10,0,7,1,2,2,8,0,5,5,2,8,7,3,2
"4815",1186,1187,1187,"white","age.gp4","Tr","NoTrade","NoGroup",5,0,1,1,3,0,4,1,1,4,0,5,3,2,2
"4816",526,527,527,"white","age.gp4","NoTr","NoTrade","NoGroup",4,0,0,2,2,0,3,1,1,3,0,4,3,1,2
"4817",1617,1618,1618,"white","age.gp3","Tr","NoTrade","NoGroup",6,0,1,2,3,0,6,0,0,6,0,6,6,0,2
"4818",2217,2218,2218,"black","age.gp4","NoTr","Trade","Group",8,0,1,2,5,3,5,0,2,6,1,7,5,3,2
"4819",2720,2721,2721,"white","age.gp4","NoTr","NoTrade","Group",9,1,0,2,6,0,8,1,3,6,0,9,7,2,2
"4820",1161,1162,1162,"white","age.gp4","NoTr","NoTrade","NoGroup",5,0,2,0,3,0,3,2,3,2,0,5,4,1,2
"4821",430,431,431,"white","age.gp4","NoTr","NoTrade","NoGroup",5,0,0,1,4,0,5,0,3,2,0,5,4,1,2
"4822",510,511,511,"white","age.gp2","Tr","NoTrade","NoGroup",14,3,4,4,3,0,12,2,2,12,2,12,11,3,2
"4823",554,555,555,"white","age.gp4","NoTr","NoTrade","NoGroup",4,0,1,1,2,0,3,1,2,2,0,4,3,1,2
"4824",578,579,579,"other","age.gp4","NoTr","NoTrade","NoGroup",2,0,0,0,2,0,2,0,0,2,0,2,2,0,2
"4825",595,596,596,"other","age.gp4","NoTr","NoTrade","NoGroup",5,0,1,0,4,1,4,0,2,3,0,5,3,2,2
"4826",1417,1418,1418,"black","age.gp2","NoTr","NoTrade","NoGroup",7,0,1,3,3,4,3,0,1,6,0,7,2,5,2
"4827",2564,2565,2565,"white","age.gp4","NoTr","NoTrade","Group",12,0,3,2,7,1,11,0,6,6,0,12,9,3,2
"4828",319,320,320,"white","age.gp4","NoTr","NoTrade","Group",12,2,5,0,5,0,12,0,6,6,0,12,9,3,2
"4829",684,685,685,"white","age.gp4","Tr","NoTrade","Group",10,0,3,0,7,2,8,0,3,7,0,10,8,2,2
"4830",686,687,687,"white","age.gp4","Tr","NoTrade","Group",14,0,1,3,10,4,9,1,3,11,1,13,6,8,2
"4831",2611,2612,2612,"white","age.gp4","NoTr","NoTrade","NoGroup",4,0,1,0,3,0,4,0,0,4,0,4,3,1,2
"4832",371,372,372,"black","age.gp4","NoTr","NoTrade","NoGroup",5,1,1,1,2,4,1,0,0,5,0,5,1,4,2
"4833",585,586,586,"other","age.gp4","NoTr","NoTrade","NoGroup",3,0,0,0,3,0,3,0,1,2,0,3,2,1,2
"4834",1175,1176,1176,"white","age.gp4","Tr","NoTrade","NoGroup",9,1,1,3,4,1,7,1,3,6,1,8,5,4,2
"4835",1646,1647,1647,"other","age.gp2","NoTr","NoTrade","NoGroup",8,2,2,2,2,2,6,0,2,6,1,7,5,3,2
"4836",2043,2044,2044,"white","age.gp4","Tr","NoTrade","Group",7,0,0,1,6,1,6,0,2,5,0,7,6,1,2
"4837",434,435,435,"white","age.gp4","NoTr","NoTrade","NoGroup",2,0,0,1,1,0,2,0,0,2,0,2,2,0,2
"4838",322,323,323,"white","age.gp4","NoTr","NoTrade","Group",10,1,1,0,8,1,8,1,5,5,0,10,8,2,2
"4839",1275,1276,1276,"white","age.gp4","NoTr","NoTrade","Group",4,0,1,0,3,0,4,0,2,2,0,4,3,1,2
"4840",1997,1998,1998,"black","age.gp4","NoTr","NoTrade","NoGroup",1,0,0,0,1,0,1,0,0,1,0,1,1,0,2
"4841",2504,2505,2505,"other","age.gp1","NoTr","NoTrade","NoGroup",8,2,3,1,2,3,5,0,3,5,1,7,3,5,2
"4842",574,575,575,"other","age.gp4","NoTr","NoTrade","NoGroup",5,0,2,0,3,1,4,0,2,3,0,5,3,2,2
"4843",1056,1057,1057,"white","age.gp4","NoTr","NoTrade","Group",11,1,2,3,5,1,9,1,5,6,1,10,7,4,2
"4844",1190,1191,1191,"white","age.gp4","Tr","NoTrade","NoGroup",10,3,2,0,5,1,9,0,3,7,2,8,5,5,2
"4845",2259,2260,2260,"white","age.gp4","Tr","NoTrade","Group",10,0,2,1,7,1,9,0,3,7,0,10,5,5,2
"4846",444,445,445,"black","age.gp3","NoTr","NoTrade","NoGroup",7,1,3,2,1,3,3,1,4,3,2,5,5,2,2
"4847",1066,1067,1067,"white","age.gp4","NoTr","NoTrade","Group",11,0,1,3,7,0,11,0,3,8,0,11,9,2,2
"4848",1577,1578,1578,"white","age.gp4","Tr","NoTrade","Group",11,0,3,3,5,0,11,0,2,9,1,10,9,2,2
"4849",2080,2081,2081,"black","age.gp3","NoTr","NoTrade","NoGroup",4,0,0,3,1,3,1,0,0,4,0,4,1,3,2
"4850",2569,2570,2570,"white","age.gp4","NoTr","NoTrade","Group",12,0,4,1,7,2,9,1,1,11,0,12,6,6,2
"4851",903,904,904,"other","age.gp1","Tr","NoTrade","NoGroup",4,3,1,0,0,1,3,0,0,4,0,4,1,3,2
"4852",1131,1132,1132,"other","age.gp1","NoTr","NoTrade","NoGroup",9,3,1,3,2,0,9,0,3,6,0,9,5,4,2
"4853",1713,1714,1714,"white","age.gp1","Tr","NoTrade","NoGroup",8,6,0,2,0,0,5,3,1,7,1,7,3,5,2
"4854",2497,2498,2498,"other","age.gp1","NoTr","NoTrade","NoGroup",4,2,0,1,1,1,3,0,0,4,0,4,0,4,2
"4855",2769,2770,2770,"white","age.gp1","NoTr","NoTrade","NoGroup",12,7,2,2,1,1,10,1,4,8,1,11,8,4,2
"4856",329,330,330,"white","age.gp1","NoTr","NoTrade","NoGroup",11,8,0,1,2,0,10,1,6,5,2,9,4,7,2
"4857",678,679,679,"white","age.gp4","Tr","NoTrade","Group",13,3,2,1,7,0,11,2,3,10,1,12,8,5,2
"4858",1624,1625,1625,"white","age.gp1","NoTr","NoTrade","NoGroup",8,5,2,1,0,2,3,3,1,7,1,7,3,5,2
"4859",330,331,331,"white","age.gp1","NoTr","NoTrade","NoGroup",7,5,0,1,1,2,4,1,2,5,3,4,5,2,2
"4860",1311,1312,1312,"white","age.gp1","NoTr","NoTrade","NoGroup",8,6,0,1,1,0,5,3,3,5,2,6,5,3,2
"4861",2496,2497,2497,"other","age.gp1","NoTr","NoTrade","NoGroup",1,1,0,0,0,0,1,0,0,1,0,1,0,1,2
"4862",1872,1873,1873,"other","age.gp1","NoTr","NoTrade","Group",10,3,0,3,4,3,7,0,3,7,0,10,6,4,2
"4863",2094,2095,2095,"black","age.gp3","NoTr","NoTrade","NoGroup",4,0,2,1,1,2,2,0,1,3,2,2,3,1,2
"4864",2352,2353,2353,"white","age.gp3","Tr","NoTrade","NoGroup",5,0,1,0,4,0,5,0,2,3,0,5,3,2,2
"4865",2360,2361,2361,"white","age.gp3","Tr","NoTrade","NoGroup",5,1,3,1,0,0,4,1,3,2,0,5,2,3,2
"4866",2406,2407,2407,"white","age.gp3","NoTr","NoTrade","NoGroup",12,4,6,0,2,0,7,5,5,7,1,11,7,5,2
"4867",2440,2441,2441,"white","age.gp4","NoTr","NoTrade","NoGroup",5,0,2,1,2,0,5,0,5,0,0,5,4,1,2
"4868",2963,2964,2964,"white","age.gp2","NoTr","NoTrade","NoGroup",7,0,5,1,1,0,5,2,6,1,0,7,5,2,2
"4869",333,334,334,"white","age.gp2","Tr","NoTrade","NoGroup",10,0,6,2,2,2,7,1,5,5,3,7,7,3,2
"4870",880,881,881,"white","age.gp3","NoTr","Trade","Group",10,1,4,4,1,1,8,1,6,4,0,10,6,4,2
"4871",1660,1661,1661,"other","age.gp2","NoTr","NoTrade","NoGroup",7,0,3,2,2,1,6,0,5,2,0,7,4,3,2
"4872",2074,2075,2075,"black","age.gp3","NoTr","NoTrade","NoGroup",1,0,1,0,0,0,1,0,1,0,0,1,0,1,2
"4873",335,336,336,"white","age.gp2","Tr","NoTrade","NoGroup",9,1,1,3,4,0,9,0,2,7,0,9,6,3,2
"4874",442,443,443,"white","age.gp4","NoTr","NoTrade","NoGroup",1,0,1,0,0,0,1,0,1,0,0,1,0,1,2
"4875",2471,2472,2472,"white","age.gp1","NoTr","NoTrade","NoGroup",9,3,2,1,3,0,8,1,3,6,1,8,4,5,2
"4876",1911,1912,1912,"other","age.gp2","NoTr","NoTrade","NoGroup",5,0,5,0,0,0,5,0,4,1,0,5,3,2,2
"4877",1943,1944,1944,"white","age.gp4","NoTr","NoTrade","Group",7,0,2,1,4,0,6,1,4,3,0,7,5,2,2
"4878",1240,1241,1241,"white","age.gp2","Tr","NoTrade","NoGroup",9,1,5,2,1,2,7,0,3,6,3,6,4,5,2
"4879",1895,1896,1896,"other","age.gp1","NoTr","NoTrade","Group",10,1,4,4,1,3,7,0,1,9,1,9,8,2,2
"4880",2902,2903,2903,"other","age.gp1","NoTr","NoTrade","NoGroup",4,1,3,0,0,0,4,0,2,2,1,3,3,1,2
"4881",2903,2904,2904,"other","age.gp1","NoTr","NoTrade","NoGroup",6,3,0,2,1,0,6,0,3,3,1,5,4,2,2
"4882",625,626,626,"other","age.gp1","NoTr","Trade","Group",7,2,1,2,2,1,6,0,1,6,2,5,4,3,2
"4883",904,905,905,"other","age.gp1","Tr","NoTrade","NoGroup",6,4,1,1,0,1,5,0,1,5,1,5,4,2,2
"4884",978,979,979,"white","age.gp4","NoTr","NoTrade","NoGroup",5,2,0,0,3,0,4,1,0,5,1,4,2,3,2
"4885",1880,1881,1881,"other","age.gp1","NoTr","NoTrade","Group",9,5,1,3,0,3,6,0,2,7,4,5,7,2,2
"4886",2644,2645,2645,"white","age.gp1","NoTr","NoTrade","NoGroup",13,7,3,1,2,1,10,2,2,11,3,10,7,6,2
"4887",657,658,658,"white","age.gp2","Tr","NoTrade","NoGroup",7,1,3,3,0,0,7,0,1,6,1,6,5,2,2
"4888",786,787,787,"black","age.gp1","Tr","NoTrade","NoGroup",11,7,2,1,1,4,4,3,4,7,5,6,6,5,2
"4889",1885,1886,1886,"other","age.gp1","NoTr","NoTrade","Group",7,3,2,1,1,2,5,0,1,6,1,6,3,4,2
"4890",2547,2548,2548,"other","age.gp1","NoTr","NoTrade","NoGroup",5,1,2,2,0,0,4,1,1,4,1,4,4,1,2
"4891",644,645,645,"other","age.gp1","NoTr","Trade","Group",6,2,2,1,1,0,6,0,2,4,1,5,4,2,2
"4892",1433,1434,1434,"white","age.gp3","Tr","NoTrade","NoGroup",8,2,4,2,0,1,6,1,3,5,2,6,6,2,2
"4893",1443,1444,1444,"white","age.gp3","Tr","NoTrade","NoGroup",7,4,1,0,2,2,4,1,1,6,1,6,4,3,2
"4894",1631,1632,1632,"white","age.gp1","NoTr","NoTrade","NoGroup",10,4,3,2,1,1,6,3,4,6,1,9,4,6,2
"4895",1844,1845,1845,"black","age.gp3","NoTr","NoTrade","NoGroup",9,3,3,1,2,3,5,1,3,6,2,7,6,3,2
"4896",2400,2401,2401,"white","age.gp3","NoTr","NoTrade","NoGroup",5,1,0,1,3,0,4,1,0,5,1,4,3,2,2
"4897",2697,2698,2698,"white","age.gp4","NoTr","NoTrade","Group",14,4,3,0,7,0,14,0,6,8,2,12,8,6,2
"4898",2886,2887,2887,"white","age.gp1","NoTr","NoTrade","Group",19,10,4,2,3,3,13,3,10,9,3,16,13,6,2
"4899",1871,1872,1872,"other","age.gp1","NoTr","NoTrade","Group",11,8,3,0,0,2,9,0,4,7,3,8,6,5,2
"4900",2503,2504,2504,"other","age.gp1","NoTr","NoTrade","NoGroup",5,1,2,2,0,0,5,0,2,3,1,4,4,1,2
"4901",2546,2547,2547,"other","age.gp1","NoTr","NoTrade","NoGroup",6,4,0,1,1,0,6,0,2,4,3,3,4,2,2
"4902",725,726,726,"black","age.gp4","NoTr","NoTrade","NoGroup",3,0,1,1,1,1,1,1,0,3,0,3,1,2,2
"4903",1564,1565,1565,"white","age.gp4","Tr","NoTrade","Group",9,2,2,0,5,1,8,0,2,7,1,8,4,5,2
"4904",1647,1648,1648,"other","age.gp2","NoTr","NoTrade","NoGroup",7,1,4,2,0,0,7,0,2,5,1,6,6,1,2
"4905",1703,1704,1704,"white","age.gp4","NoTr","Trade","NoGroup",1,0,1,0,0,0,1,0,0,1,0,1,1,0,2
"4906",483,484,484,"black","age.gp4","NoTr","NoTrade","NoGroup",6,0,3,2,1,3,2,1,2,4,2,4,4,2,2
"4907",2466,2467,2467,"white","age.gp1","Tr","NoTrade","NoGroup",12,10,2,0,0,0,9,3,3,9,2,10,4,8,2
"4908",2821,2822,2822,"other","age.gp2","NoTr","NoTrade","NoGroup",4,0,3,0,1,2,2,0,1,3,0,4,2,2,2
"4909",902,903,903,"other","age.gp1","Tr","NoTrade","NoGroup",4,1,2,1,0,1,3,0,0,4,1,3,2,2,2
"4910",2106,2107,2107,"white","age.gp2","Tr","NoTrade","Group",20,2,9,4,5,0,19,1,9,11,1,19,15,5,2
"4911",2386,2387,2387,"white","age.gp2","Tr","NoTrade","Group",25,3,8,8,6,2,22,1,9,16,4,21,18,7,2
"4912",2668,2669,2669,"white","age.gp3","NoTr","NoTrade","NoGroup",7,2,3,0,2,0,5,2,3,4,0,7,4,3,2
"4913",1719,1720,1720,"white","age.gp2","NoTr","NoTrade","Group",21,1,11,4,5,4,15,2,9,12,2,19,16,5,2
"4914",2584,2585,2585,"white","age.gp4","NoTr","NoTrade","Group",9,0,3,4,2,3,5,1,4,5,1,8,6,3,2
"4915",2772,2773,2773,"white","age.gp3","NoTr","NoTrade","Group",11,2,6,3,0,1,8,2,2,9,0,11,7,4,2
"4916",347,348,348,"black","age.gp4","NoTr","NoTrade","NoGroup",4,1,1,0,2,1,3,0,1,3,1,3,4,0,2
"4917",1632,1633,1633,"white","age.gp1","NoTr","NoTrade","NoGroup",11,4,2,4,1,1,9,1,2,9,0,11,4,7,2
"4918",2766,2767,2767,"black","age.gp2","NoTr","NoTrade","NoGroup",5,0,3,1,1,2,3,0,0,5,0,5,2,3,2
"4919",348,349,349,"black","age.gp4","NoTr","NoTrade","NoGroup",5,2,1,1,1,0,2,3,1,4,0,5,2,3,2
"4920",589,590,590,"other","age.gp4","NoTr","NoTrade","NoGroup",2,0,0,0,2,2,0,0,0,2,1,1,1,1,2
"4921",1129,1130,1130,"other","age.gp1","NoTr","NoTrade","NoGroup",4,1,1,1,1,1,3,0,1,3,0,4,3,1,2
"4922",349,350,350,"black","age.gp4","NoTr","NoTrade","NoGroup",5,1,1,1,2,3,1,1,1,4,1,4,2,3,2
"4923",858,859,859,"other","age.gp2","Tr","NoTrade","Group",12,0,5,5,2,1,11,0,5,7,0,12,10,2,2
"4924",2003,2004,2004,"black","age.gp4","NoTr","NoTrade","NoGroup",5,0,1,0,4,3,2,0,1,4,0,5,2,3,2
"4925",1367,1368,1368,"black","age.gp4","NoTr","NoTrade","Group",8,0,1,0,7,4,4,0,1,7,1,7,6,2,2
"4926",351,352,352,"black","age.gp4","NoTr","NoTrade","NoGroup",6,1,2,0,3,2,4,0,1,5,0,6,3,3,2
"4927",389,390,390,"black","age.gp4","NoTr","NoTrade","NoGroup",6,0,0,1,5,5,1,0,0,6,0,6,4,2,2
"4928",1825,1826,1826,"black","age.gp4","NoTr","NoTrade","NoGroup",8,3,1,2,2,7,1,0,4,4,1,7,2,6,2
"4929",352,353,353,"black","age.gp4","NoTr","NoTrade","NoGroup",5,0,1,0,4,3,2,0,1,4,0,5,3,2,2
"4930",1346,1347,1347,"black","age.gp4","NoTr","NoTrade","Group",14,1,1,4,8,10,2,2,1,13,2,12,5,9,2
"4931",2014,2015,2015,"black","age.gp4","NoTr","NoTrade","NoGroup",1,0,0,0,1,1,0,0,0,1,0,1,0,1,2
"4932",353,354,354,"black","age.gp4","NoTr","NoTrade","NoGroup",1,0,1,0,0,0,1,0,0,1,0,1,1,0,2
"4933",354,355,355,"black","age.gp4","NoTr","NoTrade","NoGroup",1,0,1,0,0,1,0,0,0,1,0,1,1,0,2
"4934",355,356,356,"black","age.gp4","NoTr","NoTrade","NoGroup",6,1,1,3,1,3,1,2,0,6,0,6,1,5,2
"4935",2101,2102,2102,"black","age.gp3","NoTr","NoTrade","NoGroup",10,2,0,4,4,5,4,1,1,9,1,9,3,7,2
"4936",2626,2627,2627,"white","age.gp4","NoTr","NoTrade","NoGroup",5,2,0,1,2,1,4,0,3,2,0,5,3,2,2
"4937",356,357,357,"black","age.gp4","NoTr","NoTrade","NoGroup",1,0,0,0,1,0,1,0,0,1,0,1,1,0,2
"4938",357,358,358,"black","age.gp4","NoTr","NoTrade","NoGroup",3,0,0,1,2,1,2,0,1,2,0,3,2,1,2
"4939",2271,2272,2272,"white","age.gp4","Tr","NoTrade","Group",15,1,3,4,7,1,12,2,7,8,0,15,10,5,2
"4940",1281,1282,1282,"white","age.gp4","NoTr","NoTrade","Group",12,1,3,1,7,2,10,0,7,5,0,12,8,4,2
"4941",2033,2034,2034,"white","age.gp4","Tr","NoTrade","Group",7,1,2,2,2,1,6,0,2,5,1,6,5,2,2
"4942",359,360,360,"black","age.gp4","NoTr","NoTrade","NoGroup",1,0,1,0,0,1,0,0,0,1,0,1,0,1,2
"4943",1379,1380,1380,"black","age.gp2","NoTr","NoTrade","NoGroup",10,0,5,1,4,7,2,1,2,8,2,8,6,4,2
"4944",720,721,721,"black","age.gp4","NoTr","NoTrade","NoGroup",3,0,1,0,2,1,2,0,1,2,0,3,2,1,2
"4945",1365,1366,1366,"black","age.gp4","NoTr","NoTrade","Group",10,1,1,2,6,4,5,1,4,6,0,10,4,6,2
"4946",361,362,362,"black","age.gp4","NoTr","NoTrade","NoGroup",2,0,1,0,1,2,0,0,0,2,1,1,1,1,2
"4947",1822,1823,1823,"black","age.gp4","NoTr","NoTrade","NoGroup",2,1,0,0,1,1,1,0,0,2,0,2,1,1,2
"4948",1196,1197,1197,"white","age.gp4","Tr","NoTrade","NoGroup",5,1,1,0,3,2,2,1,0,5,0,5,1,4,2
"4949",1765,1766,1766,"black","age.gp4","NoTr","NoTrade","NoGroup",7,1,0,2,4,6,1,0,2,5,1,6,2,5,2
"4950",2044,2045,2045,"white","age.gp4","Tr","NoTrade","Group",9,0,2,1,6,3,6,0,2,7,1,8,6,3,2
"4951",364,365,365,"black","age.gp4","NoTr","NoTrade","NoGroup",1,0,0,0,1,1,0,0,0,1,0,1,0,1,2
"4952",984,985,985,"white","age.gp4","NoTr","NoTrade","NoGroup",1,0,0,0,1,1,0,0,0,1,0,1,0,1,2
"4953",366,367,367,"black","age.gp4","NoTr","NoTrade","NoGroup",2,0,0,0,2,2,0,0,0,2,0,2,0,2,2
"4954",1033,1034,1034,"black","age.gp4","NoTr","NoTrade","NoGroup",5,0,0,0,5,4,1,0,0,5,0,5,1,4,2
"4955",367,368,368,"black","age.gp4","NoTr","NoTrade","NoGroup",3,0,1,0,2,3,0,0,0,3,1,2,1,2,2
"4956",368,369,369,"black","age.gp4","NoTr","NoTrade","NoGroup",1,0,0,0,1,0,1,0,0,1,0,1,1,0,2
"4957",369,370,370,"black","age.gp4","NoTr","NoTrade","NoGroup",4,0,0,2,2,3,1,0,1,3,1,3,3,1,2
"4958",406,407,407,"black","age.gp4","NoTr","NoTrade","NoGroup",4,1,1,0,2,4,0,0,0,4,1,3,1,3,2
"4959",1375,1376,1376,"black","age.gp2","NoTr","NoTrade","NoGroup",4,1,2,0,1,2,1,1,1,3,0,4,2,2,2
"4960",372,373,373,"black","age.gp4","NoTr","NoTrade","NoGroup",6,1,2,0,3,3,2,1,1,5,0,6,2,4,2
"4961",503,504,504,"black","age.gp4","NoTr","NoTrade","NoGroup",2,0,0,0,2,2,0,0,0,2,1,1,1,1,2
"4962",374,375,375,"black","age.gp4","NoTr","NoTrade","NoGroup",4,1,2,0,1,1,2,1,2,2,2,2,4,0,2
"4963",2214,2215,2215,"black","age.gp4","NoTr","Trade","Group",9,1,1,0,7,3,5,1,3,6,0,9,4,5,2
"4964",2279,2280,2280,"other","age.gp2","Tr","NoTrade","Group",7,0,3,2,2,1,6,0,5,2,1,6,5,2,2
"4965",375,376,376,"black","age.gp4","NoTr","NoTrade","NoGroup",1,0,0,0,1,0,1,0,0,1,0,1,1,0,2
"4966",378,379,379,"black","age.gp4","NoTr","NoTrade","NoGroup",1,0,0,0,1,0,1,0,1,0,0,1,1,0,2
"4967",379,380,380,"black","age.gp4","NoTr","NoTrade","NoGroup",2,0,1,1,0,0,2,0,2,0,0,2,1,1,2
"4968",1611,1612,1612,"white","age.gp3","Tr","NoTrade","NoGroup",7,2,3,0,2,1,4,2,4,3,1,6,4,3,2
"4969",380,381,381,"black","age.gp4","NoTr","NoTrade","NoGroup",1,0,0,0,1,1,0,0,0,1,0,1,1,0,2
"4970",1360,1361,1361,"black","age.gp4","NoTr","NoTrade","Group",7,1,0,0,6,2,5,0,1,6,0,7,0,7,2
"4971",1538,1539,1539,"black","age.gp4","NoTr","NoTrade","NoGroup",5,0,1,0,4,4,0,1,0,5,0,5,1,4,2
"4972",2078,2079,2079,"black","age.gp3","NoTr","NoTrade","NoGroup",5,1,3,0,1,4,1,0,2,3,1,4,2,3,2
"4973",382,383,383,"black","age.gp4","NoTr","NoTrade","NoGroup",4,0,1,2,1,2,2,0,2,2,1,3,2,2,2
"4974",2667,2668,2668,"white","age.gp3","NoTr","NoTrade","NoGroup",7,1,1,3,2,1,6,0,2,5,0,7,4,3,2
"4975",383,384,384,"black","age.gp4","NoTr","NoTrade","NoGroup",1,0,0,0,1,0,1,0,1,0,0,1,1,0,2
"4976",384,385,385,"black","age.gp4","NoTr","NoTrade","NoGroup",4,0,1,0,3,2,2,0,1,3,0,4,2,2,2
"4977",650,651,651,"black","age.gp2","NoTr","NoTrade","NoGroup",12,1,2,6,3,6,6,0,2,10,1,11,5,7,2
"4978",1075,1076,1076,"white","age.gp4","NoTr","NoTrade","Group",7,1,0,2,4,1,6,0,4,3,0,7,3,4,2
"4979",1182,1183,1183,"white","age.gp4","Tr","NoTrade","NoGroup",1,0,0,0,1,1,0,0,0,1,0,1,0,1,2
"4980",385,386,386,"black","age.gp4","NoTr","NoTrade","NoGroup",3,0,1,2,0,2,0,1,0,3,0,3,0,3,2
"4981",1930,1931,1931,"other","age.gp2","NoTr","NoTrade","NoGroup",4,0,2,0,2,1,3,0,1,3,0,4,3,1,2
"4982",386,387,387,"black","age.gp4","NoTr","NoTrade","NoGroup",3,1,0,0,2,2,0,1,0,3,0,3,0,3,2
"4983",571,572,572,"other","age.gp4","NoTr","NoTrade","NoGroup",4,0,0,0,4,2,2,0,1,3,0,4,2,2,2
"4984",1531,1532,1532,"black","age.gp4","NoTr","NoTrade","NoGroup",5,0,1,1,3,3,2,0,1,4,1,4,3,2,2
"4985",387,388,388,"black","age.gp4","NoTr","NoTrade","NoGroup",4,0,1,0,3,2,2,0,2,2,0,4,2,2,2
"4986",480,481,481,"black","age.gp4","NoTr","NoTrade","NoGroup",7,0,1,3,3,5,2,0,2,5,2,5,5,2,2
"4987",1192,1193,1193,"white","age.gp4","Tr","NoTrade","NoGroup",3,0,0,0,3,1,2,0,1,2,0,3,1,2,2
"4988",388,389,389,"black","age.gp4","NoTr","NoTrade","NoGroup",1,0,0,0,1,0,1,0,0,1,0,1,0,1,2
"4989",1348,1349,1349,"black","age.gp4","NoTr","NoTrade","Group",5,0,2,0,3,3,2,0,0,5,0,5,2,3,2
"4990",2013,2014,2014,"black","age.gp4","NoTr","NoTrade","NoGroup",7,0,1,3,3,4,3,0,2,5,1,6,4,3,2
"4991",730,731,731,"black","age.gp4","NoTr","NoTrade","NoGroup",2,0,0,0,2,1,1,0,1,1,0,2,0,2,2
"4992",2744,2745,2745,"white","age.gp2","NoTr","NoTrade","Group",19,2,8,6,3,3,15,1,8,11,3,16,10,9,2
"4993",391,392,392,"black","age.gp4","NoTr","NoTrade","NoGroup",1,0,0,1,0,1,0,0,0,1,0,1,0,1,2
"4994",2684,2685,2685,"black","age.gp3","NoTr","NoTrade","NoGroup",7,0,1,1,5,3,4,0,3,4,0,7,4,3,2
"4995",392,393,393,"black","age.gp4","NoTr","NoTrade","NoGroup",3,2,0,0,1,2,1,0,2,1,0,3,1,2,2
"4996",1024,1025,1025,"black","age.gp4","NoTr","NoTrade","NoGroup",3,0,0,0,3,2,1,0,1,2,0,3,1,2,2
"4997",394,395,395,"black","age.gp4","NoTr","NoTrade","NoGroup",9,0,2,4,3,5,3,1,2,7,0,9,5,4,2
"4998",735,736,736,"black","age.gp4","NoTr","NoTrade","NoGroup",2,0,1,0,1,2,0,0,0,2,0,2,1,1,2
"4999",2844,2845,2845,"black","age.gp3","NoTr","NoTrade","Group",14,2,1,5,6,9,5,0,4,10,2,12,7,7,2
"5000",399,400,400,"black","age.gp4","NoTr","NoTrade","NoGroup",5,0,1,1,3,4,1,0,0,5,0,5,1,4,2
"5001",734,735,735,"black","age.gp4","NoTr","NoTrade","NoGroup",6,0,2,2,2,5,1,0,1,5,1,5,2,4,2
"5002",1347,1348,1348,"black","age.gp4","NoTr","NoTrade","Group",8,0,1,3,4,6,1,1,1,7,0,8,1,7,2
"5003",1563,1564,1564,"white","age.gp4","Tr","NoTrade","Group",11,1,0,4,6,4,7,0,2,9,2,9,4,7,2
"5004",1833,1834,1834,"black","age.gp4","NoTr","NoTrade","NoGroup",3,0,1,0,2,2,1,0,1,2,0,3,1,2,2
"5005",397,398,398,"black","age.gp4","NoTr","NoTrade","NoGroup",1,0,0,0,1,1,0,0,0,1,0,1,0,1,2
"5006",1040,1041,1041,"black","age.gp4","NoTr","NoTrade","NoGroup",4,1,1,0,2,4,0,0,0,4,1,3,1,3,2
"5007",1757,1758,1758,"black","age.gp4","NoTr","NoTrade","NoGroup",1,0,0,0,1,1,0,0,0,1,0,1,0,1,2
"5008",2690,2691,2691,"black","age.gp3","NoTr","NoTrade","NoGroup",13,0,5,6,2,6,5,2,2,11,3,10,7,6,2
"5009",400,401,401,"black","age.gp4","NoTr","NoTrade","NoGroup",1,0,0,0,1,1,0,0,0,1,1,0,1,0,2
"5010",401,402,402,"black","age.gp4","NoTr","NoTrade","NoGroup",1,0,0,0,1,0,1,0,0,1,0,1,1,0,2
"5011",403,404,404,"black","age.gp4","NoTr","NoTrade","NoGroup",1,0,0,0,1,1,0,0,0,1,0,1,0,1,2
"5012",404,405,405,"black","age.gp4","NoTr","NoTrade","NoGroup",1,0,0,0,1,1,0,0,0,1,0,1,1,0,2
"5013",1519,1520,1520,"black","age.gp4","NoTr","NoTrade","NoGroup",5,1,0,1,3,3,2,0,2,3,0,5,1,4,2
"5014",713,714,714,"black","age.gp4","NoTr","NoTrade","NoGroup",6,1,0,0,5,4,1,1,0,6,2,4,5,1,2
"5015",1229,1230,1230,"white","age.gp4","NoTr","NoTrade","NoGroup",5,0,3,1,1,1,4,0,3,2,2,3,2,3,2
"5016",2404,2405,2405,"white","age.gp3","NoTr","NoTrade","NoGroup",5,0,3,1,1,0,5,0,3,2,2,3,5,0,2
"5017",2468,2469,2469,"white","age.gp1","NoTr","NoTrade","NoGroup",7,3,4,0,0,2,3,2,4,3,2,5,2,5,2
"5018",462,463,463,"white","age.gp1","NoTr","NoTrade","NoGroup",7,3,3,1,0,1,4,2,1,6,1,6,5,2,2
"5019",2065,2066,2066,"white","age.gp3","Tr","NoTrade","Group",20,1,11,1,7,2,15,3,10,10,1,19,16,4,2
"5020",666,667,667,"white","age.gp2","Tr","NoTrade","NoGroup",7,0,5,2,0,0,7,0,2,5,3,4,4,3,2
"5021",728,729,729,"black","age.gp4","NoTr","NoTrade","NoGroup",3,0,2,1,0,0,3,0,2,1,1,2,1,2,2
"5022",835,836,836,"white","age.gp3","NoTr","NoTrade","NoGroup",12,1,6,3,2,0,11,1,6,6,2,10,8,4,2
"5023",2734,2735,2735,"black","age.gp3","NoTr","NoTrade","NoGroup",6,0,2,2,2,4,2,0,1,5,1,5,1,5,2
"5024",2907,2908,2908,"other","age.gp1","NoTr","NoTrade","NoGroup",4,1,2,0,1,0,4,0,2,2,1,3,3,1,2
"5025",579,580,580,"other","age.gp4","NoTr","NoTrade","NoGroup",5,1,2,0,2,4,1,0,1,4,1,4,3,2,2
"5026",1132,1133,1133,"other","age.gp1","NoTr","NoTrade","NoGroup",3,1,1,1,0,1,2,0,2,1,2,1,2,1,2
"5027",1495,1496,1496,"white","age.gp4","NoTr","NoTrade","NoGroup",4,1,2,0,1,0,3,1,2,2,1,3,3,1,2
"5028",1910,1911,1911,"other","age.gp2","NoTr","NoTrade","NoGroup",3,0,2,1,0,0,3,0,2,1,1,2,2,1,2
"5029",1991,1992,1992,"white","age.gp4","Tr","NoTrade","NoGroup",7,0,2,2,3,1,5,1,4,3,1,6,4,3,2
"5030",2116,2117,2117,"white","age.gp2","NoTr","NoTrade","NoGroup",13,1,5,3,4,1,11,1,5,8,2,11,7,6,2
"5031",2816,2817,2817,"other","age.gp2","NoTr","NoTrade","NoGroup",4,0,3,1,0,0,4,0,3,1,1,3,3,1,2
"5032",2871,2872,2872,"white","age.gp1","NoTr","NoTrade","Group",28,12,5,7,4,1,22,5,10,18,4,24,17,11,2
"5033",2889,2890,2890,"other","age.gp1","NoTr","NoTrade","NoGroup",1,0,1,0,0,0,1,0,1,0,1,0,1,0,2
"5034",659,660,660,"white","age.gp2","Tr","NoTrade","NoGroup",15,1,7,1,6,4,9,2,5,10,2,13,9,6,2
"5035",412,413,413,"white","age.gp4","NoTr","NoTrade","NoGroup",2,1,1,0,0,0,0,2,0,2,1,1,1,1,2
"5036",2141,2142,2142,"other","age.gp2","NoTr","NoTrade","NoGroup",4,0,2,1,1,1,3,0,1,3,0,4,2,2,2
"5037",413,414,414,"white","age.gp4","NoTr","NoTrade","NoGroup",1,0,1,0,0,0,1,0,0,1,0,1,0,1,2
"5038",415,416,416,"white","age.gp4","NoTr","NoTrade","NoGroup",3,0,0,0,3,0,3,0,2,1,0,3,2,1,2
"5039",2629,2630,2630,"white","age.gp4","NoTr","NoTrade","NoGroup",2,0,0,0,2,0,2,0,0,2,0,2,1,1,2
"5040",416,417,417,"white","age.gp4","NoTr","NoTrade","NoGroup",1,0,0,0,1,0,1,0,0,1,0,1,1,0,2
"5041",1048,1049,1049,"black","age.gp4","NoTr","NoTrade","NoGroup",5,0,1,0,4,2,3,0,1,4,0,5,2,3,2
"5042",1571,1572,1572,"white","age.gp4","Tr","NoTrade","Group",9,0,2,0,7,0,8,1,1,8,0,9,7,2,2
"5043",418,419,419,"white","age.gp4","NoTr","NoTrade","NoGroup",2,0,0,0,2,0,2,0,1,1,0,2,2,0,2
"5044",2262,2263,2263,"white","age.gp4","Tr","NoTrade","Group",11,0,1,2,8,1,10,0,1,10,0,11,6,5,2
"5045",2951,2952,2952,"white","age.gp4","NoTr","NoTrade","Group",10,0,0,2,8,1,9,0,4,6,1,9,7,3,2
"5046",419,420,420,"white","age.gp4","NoTr","NoTrade","NoGroup",1,0,1,0,0,0,1,0,0,1,0,1,0,1,2
"5047",420,421,421,"white","age.gp4","NoTr","NoTrade","NoGroup",5,0,1,2,2,1,4,0,2,3,1,4,4,1,2
"5048",993,994,994,"white","age.gp4","NoTr","NoTrade","NoGroup",2,0,0,0,2,0,2,0,1,1,0,2,1,1,2
"5049",421,422,422,"white","age.gp4","NoTr","NoTrade","NoGroup",8,2,0,2,4,3,4,1,2,6,2,6,5,3,2
"5050",485,486,486,"black","age.gp4","NoTr","NoTrade","NoGroup",6,0,1,2,3,1,5,0,3,3,0,6,3,3,2
"5051",716,717,717,"black","age.gp4","NoTr","NoTrade","NoGroup",5,0,1,0,4,1,4,0,2,3,0,5,3,2,2
"5052",1874,1875,1875,"other","age.gp1","NoTr","NoTrade","Group",6,2,1,0,3,2,4,0,1,5,0,6,1,5,2
"5053",2215,2216,2216,"black","age.gp4","NoTr","Trade","Group",9,2,1,1,5,3,4,2,3,6,0,9,5,4,2
"5054",422,423,423,"white","age.gp4","NoTr","NoTrade","NoGroup",4,0,1,1,2,0,3,1,3,1,0,4,4,0,2
"5055",2702,2703,2703,"white","age.gp4","NoTr","NoTrade","Group",12,0,1,4,7,1,11,0,4,8,1,11,10,2,2
"5056",425,426,426,"white","age.gp4","NoTr","NoTrade","NoGroup",4,0,0,1,3,0,4,0,1,3,0,4,2,2,2
"5057",1154,1155,1155,"white","age.gp4","NoTr","NoTrade","NoGroup",7,0,0,0,7,0,7,0,1,6,0,7,5,2,2
"5058",1974,1975,1975,"white","age.gp4","Tr","NoTrade","NoGroup",4,0,1,2,1,0,4,0,2,2,0,4,2,2,2
"5059",426,427,427,"white","age.gp4","NoTr","NoTrade","NoGroup",1,0,0,0,1,0,1,0,0,1,0,1,1,0,2
"5060",2324,2325,2325,"white","age.gp1","NoTr","NoTrade","NoGroup",12,5,3,3,1,1,11,0,5,7,0,12,3,9,2
"5061",2779,2780,2780,"white","age.gp3","NoTr","NoTrade","Group",17,0,4,6,7,1,15,1,7,10,2,15,10,7,2
"5062",428,429,429,"white","age.gp4","NoTr","NoTrade","NoGroup",1,0,0,0,1,0,1,0,0,1,0,1,1,0,2
"5063",2722,2723,2723,"white","age.gp4","NoTr","NoTrade","Group",12,0,0,2,10,1,10,1,3,9,0,12,8,4,2
"5064",538,539,539,"white","age.gp4","NoTr","NoTrade","NoGroup",4,0,0,0,4,0,4,0,2,2,0,4,2,2,2
"5065",1940,1941,1941,"white","age.gp4","NoTr","NoTrade","Group",9,1,0,1,7,0,9,0,1,8,1,8,4,5,2
"5066",612,613,613,"other","age.gp4","NoTr","NoTrade","NoGroup",2,0,1,0,1,0,2,0,0,2,1,1,1,1,2
"5067",2561,2562,2562,"white","age.gp4","NoTr","NoTrade","Group",10,2,1,1,6,1,9,0,5,5,0,10,6,4,2
"5068",436,437,437,"white","age.gp4","NoTr","NoTrade","NoGroup",7,0,2,3,2,0,7,0,2,5,0,7,4,3,2
"5069",767,768,768,"white","age.gp4","NoTr","NoTrade","NoGroup",5,0,0,1,4,0,5,0,3,2,0,5,2,3,2
"5070",2959,2960,2960,"white","age.gp2","NoTr","NoTrade","Group",22,2,10,6,4,3,17,2,9,13,2,20,13,9,2
"5071",1695,1696,1696,"white","age.gp4","NoTr","Trade","NoGroup",4,0,0,0,4,0,4,0,3,1,0,4,2,2,2
"5072",2755,2756,2756,"white","age.gp3","NoTr","NoTrade","NoGroup",6,0,3,1,2,0,5,1,2,4,0,6,3,3,2
"5073",440,441,441,"white","age.gp4","NoTr","NoTrade","NoGroup",1,0,1,0,0,0,1,0,0,1,0,1,1,0,2
"5074",1268,1269,1269,"black","age.gp3","NoTr","NoTrade","NoGroup",7,1,3,2,1,5,2,0,1,6,2,5,2,5,2
"5075",930,931,931,"white","age.gp3","NoTr","NoTrade","NoGroup",10,1,4,1,4,2,8,0,3,7,3,7,5,5,2
"5076",1313,1314,1314,"white","age.gp1","NoTr","NoTrade","NoGroup",14,2,6,2,4,1,10,3,6,8,1,13,10,4,2
"5077",447,448,448,"black","age.gp3","NoTr","NoTrade","NoGroup",5,1,1,1,2,5,0,0,0,5,0,5,3,2,2
"5078",1026,1027,1027,"black","age.gp4","NoTr","NoTrade","NoGroup",11,0,0,4,7,2,9,0,2,9,0,11,8,3,2
"5079",448,449,449,"black","age.gp3","NoTr","NoTrade","NoGroup",1,0,0,0,1,1,0,0,0,1,0,1,1,0,2
"5080",449,450,450,"black","age.gp3","NoTr","NoTrade","NoGroup",6,1,1,4,0,5,0,1,1,5,0,6,2,4,2
"5081",450,451,451,"black","age.gp3","NoTr","NoTrade","NoGroup",10,1,6,0,3,5,4,1,4,6,2,8,7,3,2
"5082",532,533,533,"white","age.gp4","NoTr","NoTrade","NoGroup",4,1,0,1,2,1,3,0,2,2,0,4,3,1,2
"5083",627,628,628,"other","age.gp1","NoTr","Trade","Group",8,3,1,2,2,2,6,0,1,7,0,8,4,4,2
"5084",2378,2379,2379,"white","age.gp2","NoTr","NoTrade","NoGroup",6,0,3,1,2,1,5,0,2,4,1,5,3,3,2
"5085",451,452,452,"black","age.gp3","NoTr","NoTrade","NoGroup",5,0,1,1,3,4,1,0,0,5,0,5,2,3,2
"5086",552,553,553,"white","age.gp4","NoTr","NoTrade","NoGroup",6,1,1,4,0,1,5,0,1,5,1,5,2,4,2
"5087",1528,1529,1529,"black","age.gp4","NoTr","NoTrade","NoGroup",4,1,0,1,2,2,2,0,1,3,1,3,2,2,2
"5088",2688,2689,2689,"black","age.gp3","NoTr","NoTrade","NoGroup",5,0,2,3,0,2,3,0,0,5,1,4,2,3,2
"5089",2302,2303,2303,"other","age.gp2","Tr","NoTrade","Group",9,1,3,4,1,2,7,0,5,4,0,9,6,3,2
"5090",1224,1225,1225,"white","age.gp4","NoTr","NoTrade","NoGroup",8,0,3,2,3,3,4,1,1,7,0,8,5,3,2
"5091",1366,1367,1367,"black","age.gp4","NoTr","NoTrade","Group",13,0,3,4,6,8,5,0,2,11,2,11,7,6,2
"5092",1732,1733,1733,"white","age.gp3","Tr","NoTrade","Group",23,0,10,8,5,3,18,2,8,15,2,21,15,8,2
"5093",1460,1461,1461,"white","age.gp1","NoTr","NoTrade","NoGroup",10,4,2,3,1,0,9,1,4,6,1,9,5,5,2
"5094",1470,1471,1471,"white","age.gp1","NoTr","NoTrade","NoGroup",7,4,2,1,0,1,4,2,1,6,2,5,4,3,2
"5095",1712,1713,1713,"white","age.gp1","Tr","NoTrade","NoGroup",12,7,3,1,1,0,8,4,4,8,1,11,9,3,2
"5096",2498,2499,2499,"other","age.gp1","NoTr","NoTrade","NoGroup",3,2,0,0,1,0,3,0,0,3,0,3,1,2,2
"5097",2859,2860,2860,"white","age.gp1","Tr","NoTrade","NoGroup",15,9,2,3,1,2,9,4,8,7,1,14,3,12,2
"5098",789,790,790,"white","age.gp4","NoTr","NoTrade","NoGroup",5,1,1,1,2,0,4,1,3,2,0,5,3,2,2
"5099",892,893,893,"other","age.gp1","Tr","NoTrade","NoGroup",2,2,0,0,0,0,2,0,0,2,0,2,0,2,2
"5100",1117,1118,1118,"other","age.gp1","NoTr","NoTrade","NoGroup",3,1,0,2,0,0,3,0,1,2,0,3,1,2,2
"5101",1440,1441,1441,"white","age.gp3","Tr","NoTrade","NoGroup",9,2,4,3,0,2,5,2,1,8,0,9,3,6,2
"5102",1636,1637,1637,"black","age.gp1","Tr","NoTrade","NoGroup",15,6,5,1,3,4,7,4,5,10,2,13,9,6,2
"5103",2359,2360,2360,"white","age.gp3","Tr","NoTrade","NoGroup",9,2,2,3,2,0,9,0,1,8,0,9,6,3,2
"5104",633,634,634,"other","age.gp1","NoTr","Trade","Group",4,3,1,0,0,1,3,0,0,4,0,4,2,2,2
"5105",918,919,919,"white","age.gp1","NoTr","Trade","NoGroup",13,5,2,6,0,1,11,1,2,11,3,10,9,4,2
"5106",1126,1127,1127,"other","age.gp1","NoTr","NoTrade","NoGroup",3,2,1,0,0,0,3,0,1,2,0,3,2,1,2
"5107",1473,1474,1474,"white","age.gp1","NoTr","NoTrade","NoGroup",12,6,4,1,1,2,6,4,3,9,1,11,5,7,2
"5108",2481,2482,2482,"other","age.gp1","NoTr","NoTrade","NoGroup",4,2,1,1,0,1,3,0,1,3,0,4,2,2,2
"5109",1578,1579,1579,"white","age.gp4","Tr","NoTrade","Group",13,0,1,3,9,2,11,0,8,5,1,12,10,3,2
"5110",1761,1762,1762,"black","age.gp4","NoTr","NoTrade","NoGroup",6,1,2,1,2,6,0,0,1,5,2,4,2,4,2
"5111",1778,1779,1779,"white","age.gp4","Tr","NoTrade","Group",9,1,2,1,5,1,6,2,6,3,1,8,7,2,2
"5112",739,740,740,"black","age.gp4","NoTr","NoTrade","NoGroup",3,0,0,1,2,3,0,0,0,3,1,2,2,1,2
"5113",959,960,960,"black","age.gp2","Tr","NoTrade","NoGroup",6,1,1,4,0,3,2,1,2,4,2,4,4,2,2
"5114",2150,2151,2151,"other","age.gp2","NoTr","NoTrade","NoGroup",3,0,1,1,1,1,2,0,1,2,1,2,3,0,2
"5115",2909,2910,2910,"other","age.gp1","NoTr","NoTrade","NoGroup",7,2,2,2,1,2,5,0,2,5,3,4,5,2,2
"5116",642,643,643,"other","age.gp1","NoTr","Trade","Group",6,4,0,2,0,1,5,0,1,5,2,4,3,3,2
"5117",1369,1370,1370,"black","age.gp4","NoTr","NoTrade","Group",6,0,1,2,3,2,4,0,1,5,1,5,4,2,2
"5118",718,719,719,"black","age.gp4","NoTr","NoTrade","NoGroup",1,0,0,1,0,1,0,0,0,1,1,0,1,0,2
"5119",829,830,830,"white","age.gp3","NoTr","NoTrade","NoGroup",4,0,1,1,2,1,2,1,2,2,1,3,3,1,2
"5120",908,909,909,"other","age.gp1","Tr","NoTrade","NoGroup",5,3,0,2,0,2,3,0,0,5,1,4,2,3,2
"5121",1846,1847,1847,"black","age.gp3","NoTr","NoTrade","NoGroup",9,1,2,4,2,6,3,0,3,6,1,8,5,4,2
"5122",1112,1113,1113,"other","age.gp1","NoTr","NoTrade","NoGroup",4,2,0,1,1,3,1,0,1,3,1,3,1,3,2
"5123",1089,1090,1090,"black","age.gp2","Tr","NoTrade","NoGroup",11,2,5,2,2,8,2,1,3,8,1,10,3,8,2
"5124",2168,2169,2169,"black","age.gp2","NoTr","NoTrade","NoGroup",8,0,4,3,1,4,4,0,3,5,3,5,6,2,2
"5125",600,601,601,"other","age.gp4","NoTr","NoTrade","NoGroup",6,1,2,3,0,2,4,0,2,4,2,4,4,2,2
"5126",2280,2281,2281,"other","age.gp2","Tr","NoTrade","Group",10,1,4,5,0,1,9,0,2,8,1,9,8,2,2
"5127",2396,2397,2397,"white","age.gp3","NoTr","NoTrade","NoGroup",8,0,1,5,2,3,5,0,2,6,2,6,7,1,2
"5128",2459,2460,2460,"black","age.gp1","NoTr","NoTrade","NoGroup",10,3,3,2,2,4,4,2,1,9,3,7,4,6,2
"5129",1085,1086,1086,"black","age.gp2","Tr","NoTrade","NoGroup",10,2,3,2,3,5,4,1,1,9,2,8,7,3,2
"5130",1557,1558,1558,"white","age.gp3","NoTr","NoTrade","Group",21,1,5,6,9,4,16,1,6,15,1,20,13,8,2
"5131",2775,2776,2776,"white","age.gp3","NoTr","NoTrade","Group",18,1,7,8,2,3,15,0,4,14,1,17,14,4,2
"5132",1122,1123,1123,"other","age.gp1","NoTr","NoTrade","NoGroup",1,0,0,1,0,1,0,0,0,1,1,0,1,0,2
"5133",519,520,520,"black","age.gp3","NoTr","NoTrade","NoGroup",5,1,2,2,0,3,2,0,1,4,1,4,3,2,2
"5134",2100,2101,2101,"black","age.gp3","NoTr","NoTrade","NoGroup",3,1,1,1,0,3,0,0,0,3,1,2,2,1,2
"5135",476,477,477,"black","age.gp3","NoTr","Trade","Group",12,1,4,4,3,6,4,2,2,10,0,12,5,7,2
"5136",513,514,514,"black","age.gp3","NoTr","NoTrade","NoGroup",6,1,0,2,3,4,2,0,2,4,1,5,3,3,2
"5137",791,792,792,"white","age.gp4","NoTr","NoTrade","NoGroup",5,0,1,3,1,1,4,0,3,2,1,4,3,2,2
"5138",1351,1352,1352,"black","age.gp4","NoTr","NoTrade","Group",5,1,1,2,1,2,2,1,1,4,2,3,4,1,2
"5139",2736,2737,2737,"black","age.gp3","NoTr","NoTrade","NoGroup",7,1,2,3,1,4,2,1,2,5,1,6,4,3,2
"5140",478,479,479,"black","age.gp4","NoTr","NoTrade","NoGroup",4,1,0,1,2,3,0,1,0,4,0,4,2,2,2
"5141",1359,1360,1360,"black","age.gp4","NoTr","NoTrade","Group",15,0,5,2,8,7,8,0,2,13,3,12,10,5,2
"5142",1829,1830,1830,"black","age.gp4","NoTr","NoTrade","NoGroup",1,0,0,0,1,1,0,0,0,1,0,1,0,1,2
"5143",1890,1891,1891,"other","age.gp1","NoTr","NoTrade","Group",8,4,0,1,3,2,6,0,3,5,0,8,2,6,2
"5144",2099,2100,2100,"black","age.gp3","NoTr","NoTrade","NoGroup",5,0,1,2,2,2,3,0,2,3,1,4,3,2,2
"5145",1356,1357,1357,"black","age.gp4","NoTr","NoTrade","Group",12,0,5,2,5,7,4,1,5,7,3,9,10,2,2
"5146",2220,2221,2221,"black","age.gp4","NoTr","Trade","Group",7,0,2,0,5,3,3,1,2,5,0,7,3,4,2
"5147",481,482,482,"black","age.gp4","NoTr","NoTrade","NoGroup",1,1,0,0,0,1,0,0,0,1,0,1,0,1,2
"5148",1901,1902,1902,"black","age.gp1","NoTr","NoTrade","NoGroup",8,6,0,1,1,4,1,3,1,7,1,7,3,5,2
"5149",482,483,483,"black","age.gp4","NoTr","NoTrade","NoGroup",1,0,0,0,1,0,1,0,1,0,0,1,1,0,2
"5150",1412,1413,1413,"white","age.gp3","NoTr","NoTrade","Group",19,4,4,5,6,1,16,2,4,15,2,17,13,6,2
"5151",486,487,487,"black","age.gp4","NoTr","NoTrade","NoGroup",2,1,0,1,0,1,1,0,1,1,0,2,1,1,2
"5152",1475,1476,1476,"black","age.gp1","NoTr","NoTrade","NoGroup",8,3,2,0,3,4,2,2,2,6,2,6,3,5,2
"5153",487,488,488,"black","age.gp4","NoTr","NoTrade","NoGroup",1,0,0,0,1,0,1,0,1,0,0,1,1,0,2
"5154",488,489,489,"black","age.gp4","NoTr","NoTrade","NoGroup",1,0,1,0,0,1,0,0,0,1,0,1,0,1,2
"5155",489,490,490,"black","age.gp4","NoTr","NoTrade","NoGroup",5,0,1,0,4,1,4,0,3,2,1,4,4,1,2
"5156",1835,1836,1836,"black","age.gp4","NoTr","NoTrade","NoGroup",3,0,1,0,2,1,2,0,1,2,0,3,2,1,2
"5157",2048,2049,2049,"white","age.gp4","Tr","NoTrade","Group",10,1,2,2,5,2,8,0,4,6,1,9,4,6,2
"5158",490,491,491,"black","age.gp4","NoTr","NoTrade","NoGroup",1,0,0,1,0,1,0,0,0,1,0,1,0,1,2
"5159",1745,1746,1746,"black","age.gp4","NoTr","NoTrade","NoGroup",1,0,0,0,1,1,0,0,0,1,0,1,0,1,2
"5160",492,493,493,"black","age.gp4","NoTr","NoTrade","NoGroup",5,3,1,0,1,3,2,0,3,2,3,2,4,1,2
"5161",1666,1667,1667,"black","age.gp1","Tr","Trade","Group",14,6,2,2,4,8,4,2,3,11,2,12,8,6,2
"5162",2587,2588,2588,"white","age.gp4","NoTr","NoTrade","Group",7,1,0,2,4,2,4,1,2,5,0,7,4,3,2
"5163",494,495,495,"black","age.gp4","NoTr","NoTrade","NoGroup",2,0,0,1,1,0,2,0,2,0,0,2,2,0,2
"5164",495,496,496,"black","age.gp4","NoTr","NoTrade","NoGroup",1,1,0,0,0,1,0,0,0,1,0,1,0,1,2
"5165",496,497,497,"black","age.gp4","NoTr","NoTrade","NoGroup",6,0,1,0,5,2,4,0,2,4,1,5,5,1,2
"5166",1838,1839,1839,"black","age.gp4","NoTr","NoTrade","NoGroup",3,0,1,1,1,1,2,0,1,2,0,3,2,1,2
"5167",2222,2223,2223,"black","age.gp4","NoTr","Trade","Group",5,0,0,1,4,2,3,0,0,5,1,4,1,4,2
"5168",497,498,498,"black","age.gp4","NoTr","NoTrade","NoGroup",2,1,1,0,0,1,1,0,0,2,0,2,0,2,2
"5169",498,499,499,"black","age.gp4","NoTr","NoTrade","NoGroup",5,2,2,0,1,1,2,2,0,5,0,5,1,4,2
"5170",614,615,615,"other","age.gp4","NoTr","NoTrade","NoGroup",1,0,0,0,1,1,0,0,0,1,0,1,0,1,2
"5171",732,733,733,"black","age.gp4","NoTr","NoTrade","NoGroup",1,0,0,0,1,1,0,0,0,1,0,1,0,1,2
"5172",500,501,501,"black","age.gp4","NoTr","NoTrade","NoGroup",4,0,2,0,2,2,2,0,1,3,0,4,1,3,2
"5173",1750,1751,1751,"black","age.gp4","NoTr","NoTrade","NoGroup",3,1,0,0,2,2,1,0,0,3,0,3,2,1,2
"5174",501,502,502,"black","age.gp4","NoTr","NoTrade","NoGroup",1,0,0,1,0,1,0,0,0,1,0,1,0,1,2
"5175",2096,2097,2097,"black","age.gp3","NoTr","NoTrade","NoGroup",8,1,2,2,3,5,2,1,1,7,1,7,3,5,2
"5176",502,503,503,"black","age.gp4","NoTr","NoTrade","NoGroup",1,0,0,0,1,1,0,0,0,1,0,1,0,1,2
"5177",1999,2000,2000,"black","age.gp4","NoTr","NoTrade","NoGroup",4,0,0,0,4,1,3,0,2,2,0,4,1,3,2
"5178",2234,2235,2235,"black","age.gp4","NoTr","Trade","Group",9,1,3,1,4,6,3,0,5,4,0,9,4,5,2
"5179",738,739,739,"black","age.gp4","NoTr","NoTrade","NoGroup",2,0,1,0,1,2,0,0,0,2,0,2,1,1,2
"5180",2726,2727,2727,"black","age.gp3","NoTr","NoTrade","NoGroup",6,1,1,1,3,4,1,1,2,4,1,5,3,3,2
"5181",506,507,507,"black","age.gp4","NoTr","NoTrade","NoGroup",1,0,0,0,1,0,1,0,0,1,0,1,0,1,2
"5182",2139,2140,2140,"other","age.gp2","NoTr","NoTrade","NoGroup",6,0,2,2,2,0,6,0,4,2,0,6,4,2,2
"5183",508,509,509,"white","age.gp2","Tr","NoTrade","NoGroup",12,3,4,3,2,0,11,1,2,10,0,12,6,6,2
"5184",973,974,974,"white","age.gp4","NoTr","NoTrade","NoGroup",4,0,2,2,0,0,4,0,2,2,0,4,3,1,2
"5185",2323,2324,2324,"white","age.gp1","NoTr","NoTrade","NoGroup",9,6,1,2,0,1,6,2,4,5,2,7,3,6,2
"5186",2332,2333,2333,"white","age.gp3","Tr","NoTrade","Group",15,2,6,3,4,0,15,0,6,9,0,15,8,7,2
"5187",575,576,576,"other","age.gp4","NoTr","NoTrade","NoGroup",3,0,2,1,0,0,3,0,2,1,0,3,2,1,2
"5188",1917,1918,1918,"other","age.gp2","NoTr","NoTrade","NoGroup",4,0,3,1,0,0,4,0,2,2,0,4,2,2,2
"5189",2148,2149,2149,"other","age.gp2","NoTr","NoTrade","NoGroup",6,0,3,3,0,0,6,0,2,4,1,5,3,3,2
"5190",2792,2793,2793,"white","age.gp2","Tr","NoTrade","NoGroup",9,0,6,3,0,0,9,0,3,6,0,9,6,3,2
"5191",520,521,521,"black","age.gp3","NoTr","NoTrade","NoGroup",5,0,2,1,2,3,2,0,1,4,0,5,0,5,2
"5192",1086,1087,1087,"black","age.gp2","Tr","NoTrade","NoGroup",6,0,2,2,2,5,1,0,0,6,0,6,1,5,2
"5193",1030,1031,1031,"black","age.gp4","NoTr","NoTrade","NoGroup",1,0,0,1,0,1,0,0,0,1,0,1,0,1,2
"5194",1118,1119,1119,"other","age.gp1","NoTr","NoTrade","NoGroup",2,1,0,1,0,1,1,0,0,2,0,2,0,2,2
"5195",518,519,519,"black","age.gp3","NoTr","NoTrade","NoGroup",6,1,2,1,2,4,2,0,1,5,3,3,3,3,2
"5196",2001,2002,2002,"black","age.gp4","NoTr","NoTrade","NoGroup",5,0,1,2,2,4,1,0,2,3,1,4,2,3,2
"5197",2723,2724,2724,"black","age.gp3","NoTr","NoTrade","NoGroup",9,0,5,2,2,6,3,0,1,8,3,6,6,3,2
"5198",813,814,814,"white","age.gp4","NoTr","NoTrade","NoGroup",1,0,0,1,0,1,0,0,0,1,0,1,0,1,2
"5199",1149,1150,1150,"white","age.gp4","NoTr","NoTrade","NoGroup",5,0,0,1,4,1,3,1,0,5,0,5,3,2,2
"5200",2167,2168,2168,"black","age.gp2","NoTr","NoTrade","NoGroup",11,0,5,5,1,6,3,2,2,9,2,9,6,5,2
"5201",521,522,522,"black","age.gp3","NoTr","NoTrade","NoGroup",3,1,1,1,0,2,0,1,0,3,1,2,1,2,2
"5202",624,625,625,"other","age.gp1","NoTr","Trade","Group",12,5,1,4,2,3,9,0,3,9,0,12,5,7,2
"5203",522,523,523,"black","age.gp3","NoTr","NoTrade","NoGroup",1,1,0,0,0,1,0,0,0,1,0,1,0,1,2
"5204",2785,2786,2786,"white","age.gp3","NoTr","NoTrade","Group",14,1,7,4,2,1,13,0,7,7,1,13,10,4,2
"5205",2857,2858,2858,"black","age.gp3","NoTr","NoTrade","Group",10,3,0,4,3,5,3,2,4,6,0,10,5,5,2
"5206",1115,1116,1116,"other","age.gp1","NoTr","NoTrade","NoGroup",4,0,1,3,0,1,3,0,1,3,0,4,3,1,2
"5207",2558,2559,2559,"white","age.gp4","NoTr","NoTrade","Group",12,1,1,6,4,3,9,0,4,8,2,10,9,3,2
"5208",525,526,526,"black","age.gp3","NoTr","NoTrade","NoGroup",7,0,2,3,2,2,5,0,2,5,0,7,6,1,2
"5209",923,924,924,"white","age.gp2","NoTr","NoTrade","NoGroup",13,0,4,6,3,3,10,0,6,7,0,13,8,5,2
"5210",583,584,584,"other","age.gp4","NoTr","NoTrade","NoGroup",5,2,0,1,2,0,5,0,2,3,0,5,3,2,2
"5211",527,528,528,"white","age.gp4","NoTr","NoTrade","NoGroup",1,0,0,0,1,0,1,0,0,1,0,1,1,0,2
"5212",1803,1804,1804,"white","age.gp4","Tr","NoTrade","Group",9,0,0,3,6,0,9,0,1,8,1,8,7,2,2
"5213",530,531,531,"white","age.gp4","NoTr","NoTrade","NoGroup",5,0,1,1,3,0,5,0,2,3,0,5,3,2,2
"5214",994,995,995,"white","age.gp4","NoTr","NoTrade","NoGroup",1,0,0,0,1,0,1,0,0,1,0,1,0,1,2
"5215",533,534,534,"white","age.gp4","NoTr","NoTrade","NoGroup",4,1,0,1,2,0,3,1,1,3,1,3,3,1,2
"5216",1700,1701,1701,"white","age.gp4","NoTr","Trade","NoGroup",4,0,1,1,2,0,4,0,1,3,0,4,2,2,2
"5217",1779,1780,1780,"white","age.gp4","Tr","NoTrade","Group",11,0,2,3,6,2,8,1,2,9,0,11,6,5,2
"5218",536,537,537,"white","age.gp4","NoTr","NoTrade","NoGroup",4,0,1,3,0,0,4,0,3,1,1,3,3,1,2
"5219",537,538,538,"white","age.gp4","NoTr","NoTrade","NoGroup",9,0,2,2,5,2,7,0,3,6,0,9,7,2,2
"5220",1843,1844,1844,"black","age.gp3","NoTr","NoTrade","NoGroup",5,0,2,2,1,2,2,1,0,5,0,5,1,4,2
"5221",2035,2036,2036,"white","age.gp4","Tr","NoTrade","Group",11,1,1,1,8,0,10,1,2,9,1,10,6,5,2
"5222",1184,1185,1185,"white","age.gp4","Tr","NoTrade","NoGroup",11,0,2,3,6,1,10,0,6,5,0,11,8,3,2
"5223",1582,1583,1583,"white","age.gp4","Tr","NoTrade","Group",12,0,2,2,8,0,12,0,3,9,0,12,8,4,2
"5224",539,540,540,"white","age.gp4","NoTr","NoTrade","NoGroup",1,0,0,0,1,0,1,0,0,1,0,1,1,0,2
"5225",540,541,541,"white","age.gp4","NoTr","NoTrade","NoGroup",1,0,0,0,1,0,1,0,1,0,0,1,1,0,2
"5226",541,542,542,"white","age.gp4","NoTr","NoTrade","NoGroup",5,2,0,1,2,2,2,1,2,3,1,4,4,1,2
"5227",542,543,543,"white","age.gp4","NoTr","NoTrade","NoGroup",7,1,2,0,4,1,6,0,3,4,1,6,4,3,2
"5228",2568,2569,2569,"white","age.gp4","NoTr","NoTrade","Group",9,1,3,2,3,0,8,1,5,4,0,9,6,3,2
"5229",544,545,545,"white","age.gp4","NoTr","NoTrade","NoGroup",1,0,0,0,1,0,1,0,1,0,0,1,0,1,2
"5230",1967,1968,1968,"white","age.gp4","Tr","NoTrade","NoGroup",4,0,1,2,1,1,3,0,0,4,0,4,1,3,2
"5231",545,546,546,"white","age.gp4","NoTr","NoTrade","NoGroup",1,0,1,0,0,0,1,0,1,0,0,1,1,0,2
"5232",547,548,548,"white","age.gp4","NoTr","NoTrade","NoGroup",1,0,1,0,0,0,1,0,0,1,0,1,1,0,2
"5233",549,550,550,"white","age.gp4","NoTr","NoTrade","NoGroup",2,0,0,1,1,0,2,0,1,1,0,2,2,0,2
"5234",550,551,551,"white","age.gp4","NoTr","NoTrade","NoGroup",1,0,0,0,1,0,1,0,1,0,0,1,0,1,2
"5235",1188,1189,1189,"white","age.gp4","Tr","NoTrade","NoGroup",9,1,0,3,5,2,7,0,1,8,3,6,5,4,2
"5236",551,552,552,"white","age.gp4","NoTr","NoTrade","NoGroup",1,0,0,0,1,1,0,0,0,1,0,1,0,1,2
"5237",920,921,921,"white","age.gp1","NoTr","Trade","NoGroup",11,6,1,2,2,0,8,3,1,10,2,9,7,4,2
"5238",1674,1675,1675,"white","age.gp2","Tr","NoTrade","NoGroup",7,1,3,0,3,1,6,0,2,5,0,7,5,2,2
"5239",1795,1796,1796,"white","age.gp4","Tr","NoTrade","Group",23,0,3,5,15,2,19,2,3,20,1,22,13,10,2
"5240",555,556,556,"white","age.gp4","NoTr","NoTrade","NoGroup",3,0,0,1,2,0,3,0,0,3,0,3,3,0,2
"5241",1962,1963,1963,"white","age.gp4","NoTr","NoTrade","Group",9,0,2,1,6,1,8,0,4,5,0,9,5,4,2
"5242",559,560,560,"other","age.gp4","NoTr","NoTrade","NoGroup",4,0,1,0,3,1,3,0,1,3,1,3,3,1,2
"5243",2251,2252,2252,"white","age.gp4","Tr","NoTrade","Group",15,2,3,0,10,1,13,1,6,9,1,14,9,6,2
"5244",560,561,561,"other","age.gp4","NoTr","NoTrade","NoGroup",2,0,0,1,1,0,2,0,0,2,0,2,2,0,2
"5245",561,562,562,"other","age.gp4","NoTr","NoTrade","NoGroup",1,0,0,0,1,0,1,0,1,0,0,1,1,0,2
"5246",562,563,563,"other","age.gp4","NoTr","NoTrade","NoGroup",5,0,1,1,3,1,4,0,2,3,0,5,3,2,2
"5247",740,741,741,"black","age.gp4","NoTr","NoTrade","NoGroup",6,0,1,1,4,2,3,1,1,5,0,6,4,2,2
"5248",2045,2046,2046,"white","age.gp4","Tr","NoTrade","Group",9,0,1,1,7,0,8,1,2,7,0,9,5,4,2
"5249",563,564,564,"other","age.gp4","NoTr","NoTrade","NoGroup",3,0,1,1,1,0,3,0,2,1,1,2,3,0,2
"5250",564,565,565,"other","age.gp4","NoTr","NoTrade","NoGroup",2,0,0,0,2,0,2,0,1,1,0,2,2,0,2
"5251",1786,1787,1787,"white","age.gp4","Tr","NoTrade","Group",15,1,3,5,6,2,11,2,3,12,3,12,9,6,2
"5252",2244,2245,2245,"white","age.gp4","Tr","NoTrade","Group",11,0,1,0,10,3,7,1,0,11,0,11,7,4,2
"5253",568,569,569,"other","age.gp4","NoTr","NoTrade","NoGroup",1,0,0,0,1,0,1,0,1,0,0,1,1,0,2
"5254",569,570,570,"other","age.gp4","NoTr","NoTrade","NoGroup",2,1,0,0,1,1,1,0,0,2,0,2,1,1,2
"5255",570,571,571,"other","age.gp4","NoTr","NoTrade","NoGroup",1,0,1,0,0,0,1,0,0,1,0,1,1,0,2
"5256",573,574,574,"other","age.gp4","NoTr","NoTrade","NoGroup",2,0,1,1,0,0,2,0,1,1,0,2,2,0,2
"5257",669,670,670,"white","age.gp2","Tr","NoTrade","NoGroup",4,0,3,0,1,0,1,3,2,2,0,4,3,1,2
"5258",576,577,577,"other","age.gp4","NoTr","NoTrade","NoGroup",1,0,0,0,1,0,1,0,0,1,0,1,0,1,2
"5259",577,578,578,"other","age.gp4","NoTr","NoTrade","NoGroup",1,0,0,0,1,0,1,0,0,1,0,1,1,0,2
"5260",1289,1290,1290,"white","age.gp4","NoTr","NoTrade","Group",12,2,3,2,5,0,10,2,3,9,2,10,7,5,2
"5261",580,581,581,"other","age.gp4","NoTr","NoTrade","NoGroup",2,1,0,0,1,0,2,0,0,2,0,2,2,0,2
"5262",1083,1084,1084,"white","age.gp4","NoTr","NoTrade","Group",10,1,2,0,7,1,7,2,3,7,1,9,6,4,2
"5263",582,583,583,"other","age.gp4","NoTr","NoTrade","NoGroup",1,0,1,0,0,0,1,0,1,0,0,1,1,0,2
"5264",1975,1976,1976,"white","age.gp4","Tr","NoTrade","NoGroup",7,0,0,1,6,2,4,1,0,7,1,6,5,2,2
"5265",586,587,587,"other","age.gp4","NoTr","NoTrade","NoGroup",1,1,0,0,0,0,1,0,0,1,0,1,1,0,2
"5266",588,589,589,"other","age.gp4","NoTr","NoTrade","NoGroup",3,0,1,0,2,1,2,0,1,2,0,3,2,1,2
"5267",2374,2375,2375,"black","age.gp2","NoTr","NoTrade","NoGroup",6,0,1,1,4,4,1,1,1,5,1,5,1,5,2
"5268",590,591,591,"other","age.gp4","NoTr","NoTrade","NoGroup",2,0,0,1,1,0,2,0,2,0,0,2,2,0,2
"5269",591,592,592,"other","age.gp4","NoTr","NoTrade","NoGroup",3,0,0,1,2,1,2,0,1,2,1,2,2,1,2
"5270",2708,2709,2709,"white","age.gp4","NoTr","NoTrade","Group",16,2,1,3,10,1,13,2,8,8,0,16,9,7,2
"5271",592,593,593,"other","age.gp4","NoTr","NoTrade","NoGroup",6,0,1,2,3,0,6,0,3,3,0,6,3,3,2
"5272",2719,2720,2720,"white","age.gp4","NoTr","NoTrade","Group",10,0,3,2,5,3,6,1,3,7,0,10,4,6,2
"5273",594,595,595,"other","age.gp4","NoTr","NoTrade","NoGroup",3,0,1,0,2,0,3,0,2,1,0,3,3,0,2
"5274",2699,2700,2700,"white","age.gp4","NoTr","NoTrade","Group",9,1,2,2,4,0,7,2,2,7,2,7,7,2,2
"5275",1194,1195,1195,"white","age.gp4","Tr","NoTrade","NoGroup",5,1,1,0,3,1,3,1,1,4,0,5,1,4,2
"5276",596,597,597,"other","age.gp4","NoTr","NoTrade","NoGroup",1,0,0,0,1,0,1,0,1,0,0,1,1,0,2
"5277",599,600,600,"other","age.gp4","NoTr","NoTrade","NoGroup",1,0,1,0,0,0,1,0,0,1,0,1,0,1,2
"5278",602,603,603,"other","age.gp4","NoTr","NoTrade","NoGroup",1,0,0,0,1,1,0,0,0,1,0,1,1,0,2
"5279",603,604,604,"other","age.gp4","NoTr","NoTrade","NoGroup",1,0,0,1,0,1,0,0,0,1,0,1,0,1,2
"5280",604,605,605,"other","age.gp4","NoTr","NoTrade","NoGroup",4,2,0,0,2,2,2,0,0,4,1,3,0,4,2
"5281",605,606,606,"other","age.gp4","NoTr","NoTrade","NoGroup",2,0,0,0,2,0,2,0,1,1,0,2,2,0,2
"5282",606,607,607,"other","age.gp4","NoTr","NoTrade","NoGroup",3,0,0,2,1,0,3,0,2,1,0,3,2,1,2
"5283",771,772,772,"white","age.gp4","NoTr","NoTrade","NoGroup",7,0,0,1,6,0,6,1,2,5,0,7,5,2,2
"5284",1208,1209,1209,"white","age.gp4","NoTr","NoTrade","NoGroup",4,0,2,1,1,1,2,1,0,4,0,4,2,2,2
"5285",2634,2635,2635,"white","age.gp4","NoTr","NoTrade","NoGroup",4,0,0,1,3,0,3,1,1,3,0,4,3,1,2
"5286",608,609,609,"other","age.gp4","NoTr","NoTrade","NoGroup",2,0,1,0,1,0,2,0,1,1,0,2,2,0,2
"5287",2578,2579,2579,"white","age.gp4","NoTr","NoTrade","Group",6,0,1,3,2,0,5,1,0,6,1,5,5,1,2
"5288",609,610,610,"other","age.gp4","NoTr","NoTrade","NoGroup",1,0,1,0,0,0,1,0,0,1,0,1,0,1,2
"5289",613,614,614,"other","age.gp4","NoTr","NoTrade","NoGroup",2,0,0,0,2,0,2,0,1,1,1,1,0,2,2
"5290",1687,1688,1688,"white","age.gp4","NoTr","Trade","NoGroup",5,0,1,1,3,0,4,1,0,5,1,4,2,3,2
"5291",618,619,619,"other","age.gp4","NoTr","NoTrade","NoGroup",4,2,0,0,2,0,4,0,1,3,0,4,2,2,2
"5292",1297,1298,1298,"white","age.gp4","NoTr","NoTrade","Group",11,2,1,2,6,1,9,1,3,8,1,10,6,5,2
"5293",619,620,620,"other","age.gp4","NoTr","NoTrade","NoGroup",2,0,1,0,1,0,2,0,0,2,1,1,1,1,2
"5294",991,992,992,"white","age.gp4","NoTr","NoTrade","NoGroup",1,0,0,0,1,0,0,1,0,1,0,1,0,1,2
"5295",620,621,621,"other","age.gp4","NoTr","NoTrade","NoGroup",3,0,0,2,1,0,3,0,1,2,1,2,2,1,2
"5296",1990,1991,1991,"white","age.gp4","Tr","NoTrade","NoGroup",6,0,2,1,3,1,3,2,2,4,0,6,2,4,2
"5297",621,622,622,"other","age.gp4","NoTr","NoTrade","NoGroup",1,0,1,0,0,0,1,0,1,0,0,1,1,0,2
"5298",697,698,698,"white","age.gp4","Tr","NoTrade","Group",8,1,0,3,4,0,7,1,1,7,2,6,3,5,2
"5299",1010,1011,1011,"white","age.gp1","Tr","NoTrade","NoGroup",12,7,1,1,3,1,9,2,3,9,2,10,7,5,2
"5300",1454,1455,1455,"white","age.gp1","NoTr","NoTrade","NoGroup",10,4,0,4,2,2,6,2,3,7,3,7,8,2,2
"5301",623,624,624,"other","age.gp1","NoTr","Trade","Group",10,3,1,3,3,1,9,0,2,8,0,10,5,5,2
"5302",1472,1473,1473,"white","age.gp1","NoTr","NoTrade","NoGroup",6,4,2,0,0,1,3,2,1,5,1,5,3,3,2
"5303",1854,1855,1855,"white","age.gp3","NoTr","NoTrade","Group",21,6,5,5,5,2,16,3,6,15,4,17,13,8,2
"5304",2727,2728,2728,"black","age.gp3","NoTr","NoTrade","NoGroup",9,1,3,2,3,4,4,1,2,7,2,7,3,6,2
"5305",1009,1010,1010,"white","age.gp1","Tr","NoTrade","NoGroup",16,11,1,3,1,0,11,5,5,11,3,13,9,7,2
"5306",2076,2077,2077,"black","age.gp3","NoTr","NoTrade","NoGroup",8,4,3,0,1,4,2,2,2,6,3,5,5,3,2
"5307",626,627,627,"other","age.gp1","NoTr","Trade","Group",8,3,2,2,1,0,7,1,5,3,0,8,3,5,2
"5308",1899,1900,1900,"white","age.gp1","Tr","NoTrade","NoGroup",9,2,2,1,4,0,7,2,2,7,1,8,8,1,2
"5309",2000,2001,2001,"black","age.gp4","NoTr","NoTrade","NoGroup",1,1,0,0,0,0,0,1,0,1,1,0,1,0,2
"5310",2874,2875,2875,"white","age.gp1","NoTr","NoTrade","NoGroup",14,8,2,3,1,2,10,2,4,10,4,10,9,5,2
"5311",629,630,630,"other","age.gp1","NoTr","Trade","Group",6,3,0,1,2,1,5,0,3,3,0,6,1,5,2
"5312",1008,1009,1009,"white","age.gp1","Tr","NoTrade","NoGroup",10,6,2,1,1,0,6,4,3,7,1,9,4,6,2
"5313",1158,1159,1159,"white","age.gp4","NoTr","NoTrade","NoGroup",5,3,1,0,1,0,4,1,3,2,1,4,3,2,2
"5314",1067,1068,1068,"white","age.gp4","NoTr","NoTrade","Group",7,2,1,2,2,0,5,2,3,4,1,6,4,3,2
"5315",1381,1382,1382,"white","age.gp1","NoTr","NoTrade","NoGroup",8,2,2,0,4,0,5,3,3,5,2,6,5,3,2
"5316",1508,1509,1509,"white","age.gp4","NoTr","NoTrade","NoGroup",7,1,0,2,4,0,6,1,1,6,1,6,6,1,2
"5317",2086,2087,2087,"black","age.gp3","NoTr","NoTrade","NoGroup",5,1,1,0,3,1,3,1,1,4,1,4,5,0,2
"5318",916,917,917,"white","age.gp1","NoTr","Trade","NoGroup",7,7,0,0,0,1,3,3,0,7,1,6,2,5,2
"5319",2610,2611,2611,"white","age.gp4","NoTr","NoTrade","NoGroup",4,2,0,1,1,0,3,1,1,3,1,3,3,1,2
"5320",1610,1611,1611,"white","age.gp3","Tr","NoTrade","NoGroup",8,1,3,2,2,2,5,1,1,7,2,6,6,2,2
"5321",2522,2523,2523,"white","age.gp2","Tr","NoTrade","Group",22,2,11,2,7,6,13,3,6,16,3,19,17,5,2
"5322",2420,2421,2421,"white","age.gp3","NoTr","Trade","Group",13,2,2,6,3,0,11,2,6,7,1,12,9,4,2
"5323",647,648,648,"other","age.gp1","NoTr","Trade","Group",11,4,3,1,3,1,9,1,6,5,0,11,7,4,2
"5324",1341,1342,1342,"white","age.gp1","Tr","NoTrade","NoGroup",11,7,1,1,2,1,9,1,3,8,1,10,4,7,2
"5325",1037,1038,1038,"black","age.gp4","NoTr","NoTrade","NoGroup",10,1,2,4,3,6,4,0,2,8,0,10,6,4,2
"5326",2617,2618,2618,"white","age.gp4","NoTr","NoTrade","NoGroup",1,0,1,0,0,1,0,0,0,1,0,1,0,1,2
"5327",651,652,652,"black","age.gp2","NoTr","NoTrade","NoGroup",7,0,5,0,2,3,4,0,3,4,2,5,7,0,2
"5328",1080,1081,1081,"white","age.gp4","NoTr","NoTrade","Group",12,1,3,2,6,2,9,1,4,8,0,12,8,4,2
"5329",653,654,654,"black","age.gp2","NoTr","NoTrade","NoGroup",4,1,1,1,1,2,2,0,1,3,0,4,2,2,2
"5330",1634,1635,1635,"black","age.gp1","Tr","NoTrade","NoGroup",14,6,5,2,1,7,5,2,6,8,3,11,9,5,2
"5331",2006,2007,2007,"black","age.gp4","NoTr","NoTrade","NoGroup",3,0,1,1,1,1,2,0,0,3,1,2,2,1,2
"5332",654,655,655,"black","age.gp2","NoTr","NoTrade","NoGroup",2,0,0,2,0,1,1,0,1,1,0,2,1,1,2
"5333",970,971,971,"white","age.gp2","Tr","NoTrade","Group",22,1,13,5,3,2,20,0,7,15,0,22,16,6,2
"5334",1032,1033,1033,"black","age.gp4","NoTr","NoTrade","NoGroup",1,0,1,0,0,0,1,0,1,0,0,1,0,1,2
"5335",2266,2267,2267,"white","age.gp4","Tr","NoTrade","Group",9,1,2,2,4,1,8,0,2,7,0,9,5,4,2
"5336",2831,2832,2832,"white","age.gp2","Tr","NoTrade","NoGroup",8,1,6,0,1,0,7,1,4,4,0,8,6,2,2
"5337",783,784,784,"white","age.gp2","NoTr","NoTrade","NoGroup",7,1,3,1,2,1,6,0,2,5,0,7,3,4,2
"5338",2538,2539,2539,"other","age.gp1","NoTr","NoTrade","NoGroup",2,0,1,0,1,0,2,0,1,1,0,2,2,0,2
"5339",1450,1451,1451,"black","age.gp1","NoTr","NoTrade","NoGroup",8,4,2,2,0,5,2,1,0,8,0,8,2,6,2
"5340",1492,1493,1493,"white","age.gp4","NoTr","NoTrade","NoGroup",3,0,1,0,2,0,3,0,1,2,0,3,3,0,2
"5341",2695,2696,2696,"white","age.gp4","NoTr","NoTrade","Group",14,2,4,0,8,3,10,1,1,13,0,14,10,4,2
"5342",910,911,911,"other","age.gp1","Tr","NoTrade","NoGroup",5,2,3,0,0,1,4,0,3,2,1,4,3,2,2
"5343",1082,1083,1083,"white","age.gp4","NoTr","NoTrade","Group",11,1,3,1,6,1,9,1,3,8,1,10,8,3,2
"5344",1973,1974,1974,"white","age.gp4","Tr","NoTrade","NoGroup",5,1,1,1,2,0,5,0,3,2,0,5,3,2,2
"5345",806,807,807,"white","age.gp4","NoTr","NoTrade","NoGroup",6,0,2,0,4,0,6,0,1,5,0,6,6,0,2
"5346",2081,2082,2082,"black","age.gp3","NoTr","NoTrade","NoGroup",14,2,7,2,3,8,4,2,4,10,1,13,7,7,2
"5347",2157,2158,2158,"other","age.gp2","NoTr","NoTrade","NoGroup",4,0,4,0,0,1,3,0,2,2,0,4,3,1,2
"5348",665,666,666,"white","age.gp2","Tr","NoTrade","NoGroup",5,1,1,1,2,0,4,1,1,4,0,5,4,1,2
"5349",748,749,749,"white","age.gp4","NoTr","NoTrade","NoGroup",6,1,0,2,3,0,6,0,1,5,0,6,3,3,2
"5350",1233,1234,1234,"white","age.gp4","NoTr","NoTrade","NoGroup",5,0,1,1,3,1,4,0,3,2,0,5,4,1,2
"5351",1980,1981,1981,"white","age.gp4","Tr","NoTrade","NoGroup",1,0,0,0,1,0,1,0,1,0,0,1,1,0,2
"5352",671,672,672,"white","age.gp4","Tr","NoTrade","Group",11,0,4,4,3,1,9,1,4,7,3,8,8,3,2
"5353",1218,1219,1219,"white","age.gp4","NoTr","NoTrade","NoGroup",4,0,0,0,4,1,3,0,2,2,0,4,3,1,2
"5354",1285,1286,1286,"white","age.gp4","NoTr","NoTrade","Group",12,2,3,3,4,2,9,1,5,7,0,12,9,3,2
"5355",2361,2362,2362,"white","age.gp3","Tr","NoTrade","NoGroup",5,2,0,2,1,0,4,1,2,3,0,5,3,2,2
"5356",1378,1379,1379,"black","age.gp2","NoTr","NoTrade","NoGroup",2,0,1,0,1,1,1,0,1,1,1,1,2,0,2
"5357",674,675,675,"white","age.gp4","Tr","NoTrade","Group",14,1,3,3,7,1,12,1,5,9,1,13,8,6,2
"5358",761,762,762,"white","age.gp4","NoTr","NoTrade","NoGroup",6,0,1,1,4,0,6,0,3,3,1,5,5,1,2
"5359",889,890,890,"other","age.gp1","Tr","NoTrade","NoGroup",3,1,0,0,2,0,3,0,1,2,0,3,1,2,2
"5360",2641,2642,2642,"white","age.gp4","NoTr","NoTrade","NoGroup",7,2,0,0,5,1,6,0,5,2,1,6,4,3,2
"5361",1507,1508,1508,"white","age.gp4","NoTr","NoTrade","NoGroup",2,0,0,0,2,0,2,0,1,1,0,2,2,0,2
"5362",1824,1825,1825,"black","age.gp4","NoTr","NoTrade","NoGroup",4,0,0,0,4,1,3,0,2,2,0,4,3,1,2
"5363",2515,2516,2516,"black","age.gp2","NoTr","NoTrade","Group",16,2,8,3,3,7,8,1,6,10,2,14,10,6,2
"5364",2523,2524,2524,"white","age.gp2","Tr","NoTrade","Group",24,3,13,6,2,1,21,2,10,14,1,23,14,10,2
"5365",2180,2181,2181,"white","age.gp4","NoTr","NoTrade","NoGroup",4,0,1,0,3,0,4,0,3,1,0,4,3,1,2
"5366",1459,1460,1460,"white","age.gp1","NoTr","NoTrade","NoGroup",7,3,0,1,3,0,6,1,1,6,0,7,4,3,2
"5367",753,754,754,"white","age.gp4","NoTr","NoTrade","NoGroup",1,0,0,0,1,0,1,0,1,0,0,1,1,0,2
"5368",919,920,920,"white","age.gp1","NoTr","Trade","NoGroup",5,2,0,1,2,0,5,0,2,3,0,5,3,2,2
"5369",1234,1235,1235,"white","age.gp4","NoTr","NoTrade","NoGroup",2,0,1,0,1,0,2,0,2,0,0,2,2,0,2
"5370",1183,1184,1184,"white","age.gp4","Tr","NoTrade","NoGroup",5,0,1,1,3,1,4,0,2,3,0,5,3,2,2
"5371",1222,1223,1223,"white","age.gp4","NoTr","NoTrade","NoGroup",3,1,0,0,2,0,2,1,2,1,0,3,2,1,2
"5372",830,831,831,"white","age.gp3","NoTr","NoTrade","NoGroup",4,0,2,0,2,1,3,0,3,1,0,4,3,1,2
"5373",1800,1801,1801,"white","age.gp4","Tr","NoTrade","Group",8,0,4,2,2,1,6,1,3,5,1,7,5,3,2
"5374",2463,2464,2464,"white","age.gp1","Tr","NoTrade","NoGroup",12,5,0,4,3,1,10,1,3,9,1,11,6,6,2
"5375",1603,1604,1604,"white","age.gp3","Tr","NoTrade","NoGroup",8,2,1,3,2,0,7,1,2,6,0,8,6,2,2
"5376",1981,1982,1982,"white","age.gp4","Tr","NoTrade","NoGroup",6,0,2,2,2,0,6,0,3,3,1,5,6,0,2
"5377",1830,1831,1831,"black","age.gp4","NoTr","NoTrade","NoGroup",3,0,1,0,2,1,2,0,3,0,0,3,2,1,2
"5378",2565,2566,2566,"white","age.gp4","NoTr","NoTrade","Group",7,1,1,0,5,1,6,0,3,4,0,7,6,1,2
"5379",2640,2641,2641,"white","age.gp4","NoTr","NoTrade","NoGroup",5,0,0,0,5,0,5,0,2,3,0,5,4,1,2
"5380",825,826,826,"white","age.gp3","NoTr","NoTrade","NoGroup",7,1,1,2,3,1,6,0,2,5,2,5,7,0,2
"5381",1110,1111,1111,"other","age.gp1","NoTr","NoTrade","NoGroup",3,1,0,1,1,1,2,0,1,2,0,3,2,1,2
"5382",793,794,794,"white","age.gp4","NoTr","NoTrade","NoGroup",7,1,0,0,6,0,6,1,2,5,0,7,2,5,2
"5383",1316,1317,1317,"white","age.gp2","NoTr","NoTrade","NoGroup",11,1,4,2,4,0,11,0,3,8,0,11,8,3,2
"5384",2452,2453,2453,"white","age.gp4","NoTr","NoTrade","NoGroup",6,2,1,1,2,0,5,1,2,4,0,6,4,2,2
"5385",2693,2694,2694,"white","age.gp4","NoTr","NoTrade","Group",10,1,2,1,6,1,7,2,5,5,0,10,7,3,2
"5386",1065,1066,1066,"white","age.gp4","NoTr","NoTrade","Group",12,1,1,4,6,2,10,0,5,7,0,12,7,5,2
"5387",1189,1190,1190,"white","age.gp4","Tr","NoTrade","NoGroup",3,0,0,0,3,0,3,0,2,1,0,3,3,0,2
"5388",2093,2094,2094,"black","age.gp3","NoTr","NoTrade","NoGroup",5,0,0,1,4,1,4,0,1,4,0,5,3,2,2
"5389",694,695,695,"white","age.gp4","Tr","NoTrade","Group",8,0,2,1,5,0,8,0,3,5,0,8,6,2,2
"5390",755,756,756,"white","age.gp4","NoTr","NoTrade","NoGroup",1,0,0,0,1,0,1,0,1,0,0,1,1,0,2
"5391",2823,2824,2824,"other","age.gp2","NoTr","NoTrade","NoGroup",4,0,1,1,2,0,4,0,2,2,0,4,4,0,2
"5392",1230,1231,1231,"white","age.gp4","NoTr","NoTrade","NoGroup",4,0,0,0,4,0,4,0,2,2,0,4,3,1,2
"5393",1956,1957,1957,"white","age.gp4","NoTr","NoTrade","Group",8,0,3,1,4,1,7,0,3,5,0,8,4,4,2
"5394",2376,2377,2377,"white","age.gp2","NoTr","NoTrade","NoGroup",7,1,2,1,3,0,7,0,3,4,0,7,5,2,2
"5395",1501,1502,1502,"white","age.gp4","NoTr","NoTrade","NoGroup",6,1,2,0,3,0,6,0,3,3,1,5,4,2,2
"5396",2431,2432,2432,"white","age.gp4","NoTr","NoTrade","NoGroup",4,0,1,1,2,1,3,0,3,1,0,4,3,1,2
"5397",1728,1729,1729,"white","age.gp3","Tr","NoTrade","Group",16,0,6,6,4,3,12,1,5,11,2,14,12,4,2
"5398",700,701,701,"white","age.gp4","Tr","NoTrade","Group",7,2,1,0,4,1,5,1,3,4,0,7,4,3,2
"5399",2905,2906,2906,"other","age.gp1","NoTr","NoTrade","NoGroup",5,0,3,0,2,0,5,0,2,3,0,5,4,1,2
"5400",1503,1504,1504,"white","age.gp4","NoTr","NoTrade","NoGroup",1,0,0,0,1,0,1,0,1,0,0,1,1,0,2
"5401",2490,2491,2491,"other","age.gp1","NoTr","NoTrade","NoGroup",6,2,1,1,2,0,6,0,1,5,1,5,4,2,2
"5402",2906,2907,2907,"other","age.gp1","NoTr","NoTrade","NoGroup",2,0,0,0,2,0,2,0,2,0,0,2,1,1,2
"5403",1494,1495,1495,"white","age.gp4","NoTr","NoTrade","NoGroup",3,0,1,0,2,0,3,0,0,3,0,3,3,0,2
"5404",2437,2438,2438,"white","age.gp4","NoTr","NoTrade","NoGroup",1,0,1,0,0,0,1,0,0,1,0,1,1,0,2
"5405",861,862,862,"other","age.gp2","Tr","NoTrade","Group",7,1,4,1,1,0,6,1,2,5,0,7,6,1,2
"5406",2899,2900,2900,"other","age.gp1","NoTr","NoTrade","NoGroup",2,1,1,0,0,0,2,0,1,1,1,1,2,0,2
"5407",2292,2293,2293,"other","age.gp2","Tr","NoTrade","Group",11,1,6,2,2,1,10,0,4,7,0,11,7,4,2
"5408",1377,1378,1378,"black","age.gp2","NoTr","NoTrade","NoGroup",6,2,2,0,2,3,3,0,0,6,1,5,5,1,2
"5409",1197,1198,1198,"white","age.gp4","Tr","NoTrade","NoGroup",11,0,3,3,5,1,10,0,6,5,0,11,9,2,2
"5410",1269,1270,1270,"black","age.gp3","NoTr","NoTrade","NoGroup",4,0,1,3,0,0,4,0,2,2,1,3,3,1,2
"5411",1932,1933,1933,"other","age.gp2","NoTr","NoTrade","NoGroup",6,0,5,0,1,0,6,0,5,1,0,6,4,2,2
"5412",2152,2153,2153,"other","age.gp2","NoTr","NoTrade","NoGroup",3,2,1,0,0,0,2,1,2,1,0,3,1,2,2
"5413",1114,1115,1115,"other","age.gp1","NoTr","NoTrade","NoGroup",5,3,1,1,0,0,4,1,2,3,1,4,3,2,2
"5414",1512,1513,1513,"black","age.gp4","NoTr","NoTrade","NoGroup",6,0,2,2,2,3,3,0,1,5,1,5,4,2,2
"5415",2194,2195,2195,"white","age.gp4","NoTr","NoTrade","NoGroup",2,0,1,0,1,1,1,0,1,1,0,2,1,1,2
"5416",2926,2927,2927,"white","age.gp4","NoTr","NoTrade","Group",12,1,3,4,4,1,10,1,6,6,0,12,7,5,2
"5417",1107,1108,1108,"other","age.gp1","NoTr","NoTrade","NoGroup",6,2,2,1,1,0,6,0,3,3,1,5,4,2,2
"5418",2004,2005,2005,"black","age.gp4","NoTr","NoTrade","NoGroup",2,0,2,0,0,0,2,0,2,0,0,2,2,0,2
"5419",769,770,770,"white","age.gp4","NoTr","NoTrade","NoGroup",1,0,1,0,0,0,1,0,1,0,0,1,1,0,2
"5420",1220,1221,1221,"white","age.gp4","NoTr","NoTrade","NoGroup",7,1,3,0,3,1,5,1,5,2,0,7,5,2,2
"5421",1264,1265,1265,"black","age.gp3","NoTr","NoTrade","NoGroup",4,0,3,1,0,2,2,0,2,2,0,4,2,2,2
"5422",1928,1929,1929,"other","age.gp2","NoTr","NoTrade","NoGroup",8,1,4,2,1,0,8,0,4,4,1,7,7,1,2
"5423",2812,2813,2813,"other","age.gp2","NoTr","NoTrade","NoGroup",2,0,2,0,0,0,2,0,1,1,0,2,1,1,2
"5424",2760,2761,2761,"white","age.gp3","NoTr","NoTrade","NoGroup",5,0,4,0,1,0,4,1,3,2,0,5,4,1,2
"5425",2801,2802,2802,"white","age.gp2","NoTr","NoTrade","NoGroup",6,0,5,1,0,0,6,0,3,3,1,5,4,2,2
"5426",712,713,713,"black","age.gp4","NoTr","NoTrade","NoGroup",1,0,0,0,1,1,0,0,0,1,1,0,1,0,2
"5427",1298,1299,1299,"white","age.gp4","NoTr","NoTrade","Group",13,0,1,5,7,1,11,1,6,7,0,13,10,3,2
"5428",1566,1567,1567,"white","age.gp4","Tr","NoTrade","Group",6,0,1,1,4,1,5,0,2,4,0,6,3,3,2
"5429",1653,1654,1654,"other","age.gp2","NoTr","NoTrade","NoGroup",3,0,1,0,2,1,2,0,1,2,0,3,2,1,2
"5430",2147,2148,2148,"other","age.gp2","NoTr","NoTrade","NoGroup",3,0,1,0,2,1,2,0,1,2,0,3,2,1,2
"5431",2678,2679,2679,"black","age.gp3","NoTr","NoTrade","NoGroup",8,0,1,1,6,5,3,0,1,7,0,8,3,5,2
"5432",1511,1512,1512,"black","age.gp4","NoTr","NoTrade","NoGroup",2,0,0,0,2,1,1,0,1,1,0,2,1,1,2
"5433",719,720,720,"black","age.gp4","NoTr","NoTrade","NoGroup",1,0,1,0,0,1,0,0,0,1,0,1,1,0,2
"5434",723,724,724,"black","age.gp4","NoTr","NoTrade","NoGroup",5,0,2,1,2,1,3,1,2,3,1,4,4,1,2
"5435",1171,1172,1172,"white","age.gp4","NoTr","NoTrade","NoGroup",6,0,1,1,4,1,5,0,1,5,0,6,5,1,2
"5436",2089,2090,2090,"black","age.gp3","NoTr","NoTrade","NoGroup",12,1,2,4,5,7,5,0,2,10,0,12,4,8,2
"5437",726,727,727,"black","age.gp4","NoTr","NoTrade","NoGroup",1,0,0,0,1,0,1,0,0,1,0,1,0,1,2
"5438",729,730,730,"black","age.gp4","NoTr","NoTrade","NoGroup",1,0,0,0,1,1,0,0,0,1,0,1,1,0,2
"5439",1350,1351,1351,"black","age.gp4","NoTr","NoTrade","Group",9,0,2,0,7,5,3,1,0,9,0,9,3,6,2
"5440",731,732,732,"black","age.gp4","NoTr","NoTrade","NoGroup",1,0,0,1,0,1,0,0,0,1,0,1,0,1,2
"5441",733,734,734,"black","age.gp4","NoTr","NoTrade","NoGroup",1,0,0,0,1,0,1,0,0,1,0,1,1,0,2
"5442",1947,1948,1948,"white","age.gp4","NoTr","NoTrade","Group",16,1,5,2,8,2,14,0,7,9,0,16,10,6,2
"5443",1374,1375,1375,"black","age.gp4","NoTr","NoTrade","Group",3,1,0,0,2,1,2,0,1,2,1,2,2,1,2
"5444",736,737,737,"black","age.gp4","NoTr","NoTrade","NoGroup",1,1,0,0,0,0,1,0,1,0,1,0,1,0,2
"5445",737,738,738,"black","age.gp4","NoTr","NoTrade","NoGroup",1,0,1,0,0,1,0,0,0,1,0,1,0,1,2
"5446",1355,1356,1356,"black","age.gp4","NoTr","NoTrade","Group",8,0,1,1,6,6,2,0,1,7,0,8,3,5,2
"5447",1836,1837,1837,"black","age.gp4","NoTr","NoTrade","NoGroup",1,0,0,0,1,1,0,0,0,1,0,1,0,1,2
"5448",741,742,742,"black","age.gp4","NoTr","NoTrade","NoGroup",1,0,0,0,1,1,0,0,0,1,0,1,0,1,2
"5449",2020,2021,2021,"black","age.gp4","NoTr","NoTrade","NoGroup",3,2,0,0,1,2,1,0,2,1,0,3,0,3,2
"5450",1693,1694,1694,"white","age.gp4","NoTr","Trade","NoGroup",6,0,4,1,1,0,6,0,5,1,0,6,4,2,2
"5451",2261,2262,2262,"white","age.gp4","Tr","NoTrade","Group",10,0,1,2,7,2,8,0,2,8,0,10,9,1,2
"5452",2317,2318,2318,"white","age.gp2","NoTr","NoTrade","NoGroup",14,1,6,6,1,1,11,2,6,8,0,14,11,3,2
"5453",2241,2242,2242,"white","age.gp4","Tr","NoTrade","Group",12,0,4,4,4,1,11,0,6,6,0,12,10,2,2
"5454",2286,2287,2287,"other","age.gp2","Tr","NoTrade","Group",10,1,6,0,3,1,9,0,5,5,0,10,7,3,2
"5455",1756,1757,1757,"black","age.gp4","NoTr","NoTrade","NoGroup",1,0,1,0,0,0,1,0,1,0,0,1,1,0,2
"5456",2149,2150,2150,"other","age.gp2","NoTr","NoTrade","NoGroup",7,1,1,4,1,1,6,0,2,5,1,6,6,1,2
"5457",2537,2538,2538,"other","age.gp1","NoTr","NoTrade","NoGroup",8,3,2,2,1,0,7,1,4,4,1,7,4,4,2
"5458",2836,2837,2837,"black","age.gp2","NoTr","NoTrade","NoGroup",9,0,3,3,3,2,6,1,5,4,0,9,7,2,2
"5459",747,748,748,"white","age.gp4","NoTr","NoTrade","NoGroup",1,0,0,0,1,1,0,0,0,1,1,0,1,0,2
"5460",1211,1212,1212,"white","age.gp4","NoTr","NoTrade","NoGroup",6,0,1,1,4,0,5,1,3,3,0,6,4,2,2
"5461",1245,1246,1246,"white","age.gp1","NoTr","NoTrade","NoGroup",7,3,1,0,3,1,5,1,2,5,2,5,4,3,2
"5462",749,750,750,"white","age.gp4","NoTr","NoTrade","NoGroup",1,0,0,0,1,0,1,0,1,0,0,1,1,0,2
"5463",1462,1463,1463,"white","age.gp1","NoTr","NoTrade","NoGroup",8,3,2,2,1,0,7,1,2,6,0,8,4,4,2
"5464",751,752,752,"white","age.gp4","NoTr","NoTrade","NoGroup",6,1,1,1,3,2,4,0,0,6,0,6,3,3,2
"5465",992,993,993,"white","age.gp4","NoTr","NoTrade","NoGroup",1,0,0,0,1,0,1,0,0,1,0,1,0,1,2
"5466",1476,1477,1477,"black","age.gp1","NoTr","NoTrade","NoGroup",5,2,1,1,1,1,4,0,1,4,0,5,1,4,2
"5467",752,753,753,"white","age.gp4","NoTr","NoTrade","NoGroup",4,0,1,1,2,0,4,0,1,3,0,4,2,2,2
"5468",1995,1996,1996,"white","age.gp4","Tr","NoTrade","NoGroup",7,0,1,3,3,0,6,1,2,5,0,7,2,5,2
"5469",2091,2092,2092,"black","age.gp3","NoTr","NoTrade","NoGroup",9,0,2,4,3,3,6,0,3,6,0,9,3,6,2
"5470",756,757,757,"white","age.gp4","NoTr","NoTrade","NoGroup",9,1,5,1,2,0,7,2,4,5,0,9,6,3,2
"5471",757,758,758,"white","age.gp4","NoTr","NoTrade","NoGroup",1,0,0,0,1,1,0,0,0,1,1,0,1,0,2
"5472",2059,2060,2060,"white","age.gp3","Tr","NoTrade","Group",22,1,9,7,5,2,18,2,4,18,1,21,17,5,2
"5473",2451,2452,2452,"white","age.gp4","NoTr","NoTrade","NoGroup",5,0,0,3,2,1,4,0,0,5,0,5,1,4,2
"5474",2721,2722,2722,"white","age.gp4","NoTr","NoTrade","Group",4,0,1,1,2,0,4,0,1,3,0,4,3,1,2
"5475",759,760,760,"white","age.gp4","NoTr","NoTrade","NoGroup",1,0,0,0,1,0,1,0,1,0,0,1,1,0,2
"5476",760,761,761,"white","age.gp4","NoTr","NoTrade","NoGroup",1,1,0,0,0,0,0,1,0,1,0,1,1,0,2
"5477",762,763,763,"white","age.gp4","NoTr","NoTrade","NoGroup",1,0,1,0,0,0,1,0,1,0,0,1,1,0,2
"5478",763,764,764,"white","age.gp4","NoTr","NoTrade","NoGroup",1,0,0,1,0,0,1,0,0,1,0,1,1,0,2
"5479",765,766,766,"white","age.gp4","NoTr","NoTrade","NoGroup",1,0,1,0,0,0,1,0,1,0,0,1,1,0,2
"5480",766,767,767,"white","age.gp4","NoTr","NoTrade","NoGroup",3,0,0,1,2,1,2,0,0,3,0,3,1,2,2
"5481",1809,1810,1810,"black","age.gp4","NoTr","NoTrade","NoGroup",1,0,0,0,1,0,1,0,0,1,0,1,0,1,2
"5482",2932,2933,2933,"white","age.gp4","NoTr","NoTrade","Group",11,1,5,2,3,1,9,1,7,4,0,11,8,3,2
"5483",772,773,773,"white","age.gp4","NoTr","NoTrade","NoGroup",1,0,0,0,1,0,1,0,1,0,0,1,1,0,2
"5484",773,774,774,"white","age.gp4","NoTr","NoTrade","NoGroup",7,1,1,2,3,0,6,1,3,4,0,7,3,4,2
"5485",1608,1609,1609,"white","age.gp3","Tr","NoTrade","NoGroup",9,0,3,4,2,0,9,0,1,8,3,6,6,3,2
"5486",2477,2478,2478,"other","age.gp1","NoTr","NoTrade","NoGroup",7,2,2,2,1,0,7,0,3,4,1,6,5,2,2
"5487",774,775,775,"white","age.gp4","NoTr","NoTrade","NoGroup",1,0,0,0,1,1,0,0,0,1,1,0,1,0,2
"5488",776,777,777,"white","age.gp4","NoTr","NoTrade","NoGroup",1,0,0,0,1,0,1,0,0,1,0,1,1,0,2
"5489",1079,1080,1080,"white","age.gp4","NoTr","NoTrade","Group",10,0,2,2,6,0,10,0,4,6,1,9,7,3,2
"5490",778,779,779,"white","age.gp4","NoTr","NoTrade","NoGroup",2,0,0,0,2,0,2,0,0,2,0,2,0,2,2
"5491",2619,2620,2620,"white","age.gp4","NoTr","NoTrade","NoGroup",7,1,2,0,4,0,6,1,3,4,0,7,5,2,2
"5492",2967,2968,2968,"white","age.gp2","NoTr","NoTrade","NoGroup",9,0,5,3,1,1,7,1,4,5,0,9,7,2,2
"5493",782,783,783,"white","age.gp2","NoTr","NoTrade","NoGroup",9,1,2,4,2,0,9,0,2,7,0,9,6,3,2
"5494",1232,1233,1233,"white","age.gp4","NoTr","NoTrade","NoGroup",6,1,2,0,3,2,4,0,3,3,1,5,4,2,2
"5495",1242,1243,1243,"white","age.gp2","Tr","NoTrade","NoGroup",10,0,4,3,3,0,9,1,4,6,0,10,5,5,2
"5496",2023,2024,2024,"black","age.gp4","NoTr","NoTrade","NoGroup",4,1,1,0,2,2,2,0,1,3,1,3,1,3,2
"5497",2548,2549,2549,"other","age.gp1","NoTr","NoTrade","NoGroup",4,2,0,1,1,1,3,0,2,2,1,3,2,2,2
"5498",1595,1596,1596,"black","age.gp1","Tr","Trade","NoGroup",9,5,1,1,2,5,4,0,2,7,0,9,4,5,2
"5499",2008,2009,2009,"black","age.gp4","NoTr","NoTrade","NoGroup",1,1,0,0,0,1,0,0,1,0,0,1,0,1,2
"5500",2485,2486,2486,"other","age.gp1","NoTr","NoTrade","NoGroup",4,2,1,1,0,1,3,0,3,1,0,4,2,2,2
"5501",792,793,793,"white","age.gp4","NoTr","NoTrade","NoGroup",4,0,1,1,2,0,4,0,2,2,0,4,3,1,2
"5502",807,808,808,"white","age.gp4","NoTr","NoTrade","NoGroup",4,0,0,1,3,0,4,0,2,2,0,4,2,2,2
"5503",796,797,797,"white","age.gp4","NoTr","NoTrade","NoGroup",1,0,0,1,0,0,1,0,1,0,0,1,1,0,2
"5504",798,799,799,"white","age.gp4","NoTr","NoTrade","NoGroup",1,0,0,1,0,0,1,0,0,1,0,1,1,0,2
"5505",799,800,800,"white","age.gp4","NoTr","NoTrade","NoGroup",4,0,1,0,3,1,3,0,3,1,1,3,4,0,2
"5506",1772,1773,1773,"white","age.gp4","Tr","NoTrade","Group",14,0,1,3,10,0,13,1,6,8,0,14,12,2,2
"5507",800,801,801,"white","age.gp4","NoTr","NoTrade","NoGroup",7,1,1,0,5,1,6,0,4,3,0,7,5,2,2
"5508",1992,1993,1993,"white","age.gp4","Tr","NoTrade","NoGroup",7,1,0,2,4,1,5,1,2,5,0,7,5,2,2
"5509",802,803,803,"white","age.gp4","NoTr","NoTrade","NoGroup",1,0,0,1,0,0,1,0,0,1,0,1,1,0,2
"5510",804,805,805,"white","age.gp4","NoTr","NoTrade","NoGroup",1,0,0,0,1,0,1,0,1,0,0,1,0,1,2
"5511",810,811,811,"white","age.gp4","NoTr","NoTrade","NoGroup",1,0,0,1,0,0,1,0,1,0,0,1,1,0,2
"5512",811,812,812,"white","age.gp4","NoTr","NoTrade","NoGroup",1,0,0,0,1,0,1,0,0,1,0,1,1,0,2
"5513",815,816,816,"white","age.gp4","NoTr","NoTrade","NoGroup",1,0,0,0,1,0,1,0,0,1,0,1,1,0,2
"5514",818,819,819,"white","age.gp4","NoTr","NoTrade","NoGroup",1,0,1,0,0,0,1,0,1,0,0,1,1,0,2
"5515",819,820,820,"white","age.gp4","NoTr","NoTrade","NoGroup",4,0,1,1,2,0,3,1,2,2,0,4,3,1,2
"5516",1913,1914,1914,"other","age.gp2","NoTr","NoTrade","NoGroup",1,0,0,0,1,0,1,0,0,1,0,1,0,1,2
"5517",1651,1652,1652,"other","age.gp2","NoTr","NoTrade","NoGroup",5,0,0,5,0,0,5,0,1,4,0,5,4,1,2
"5518",999,1000,1000,"white","age.gp4","NoTr","NoTrade","NoGroup",5,0,2,2,1,0,5,0,1,4,1,4,3,2,2
"5519",2625,2626,2626,"white","age.gp4","NoTr","NoTrade","NoGroup",4,0,0,1,3,0,4,0,0,4,0,4,2,2,2
"5520",2200,2201,2201,"white","age.gp4","NoTr","NoTrade","NoGroup",7,1,1,1,4,0,7,0,1,6,0,7,4,3,2
"5521",2618,2619,2619,"white","age.gp4","NoTr","NoTrade","NoGroup",1,0,0,1,0,0,1,0,0,1,0,1,0,1,2
"5522",828,829,829,"white","age.gp3","NoTr","NoTrade","NoGroup",7,0,1,3,3,0,7,0,4,3,1,6,3,4,2
"5523",2201,2202,2202,"white","age.gp4","NoTr","NoTrade","NoGroup",5,0,2,2,1,1,4,0,1,4,0,5,4,1,2
"5524",1241,1242,1242,"white","age.gp2","Tr","NoTrade","NoGroup",5,0,3,1,1,0,5,0,1,4,0,5,3,2,2
"5525",938,939,939,"white","age.gp3","NoTr","NoTrade","NoGroup",7,0,1,6,0,0,7,0,1,6,0,7,5,2,2
"5526",976,977,977,"white","age.gp4","NoTr","NoTrade","NoGroup",2,0,0,2,0,0,2,0,0,2,0,2,1,1,2
"5527",1604,1605,1605,"white","age.gp3","Tr","NoTrade","NoGroup",13,0,5,5,3,2,9,2,3,10,1,12,9,4,2
"5528",2306,2307,2307,"white","age.gp2","NoTr","NoTrade","NoGroup",6,0,2,2,2,2,3,1,2,4,0,6,3,3,2
"5529",1270,1271,1271,"black","age.gp3","NoTr","NoTrade","NoGroup",6,3,2,0,1,3,3,0,1,5,0,6,3,3,2
"5530",1663,1664,1664,"other","age.gp2","NoTr","NoTrade","NoGroup",8,0,3,3,2,0,8,0,4,4,0,8,4,4,2
"5531",2486,2487,2487,"other","age.gp1","NoTr","NoTrade","NoGroup",2,0,1,1,0,0,2,0,1,1,0,2,2,0,2
"5532",2818,2819,2819,"other","age.gp2","NoTr","NoTrade","NoGroup",6,0,3,3,0,0,6,0,2,4,1,5,5,1,2
"5533",1791,1792,1792,"white","age.gp4","Tr","NoTrade","Group",11,4,2,3,2,0,10,1,3,8,0,11,8,3,2
"5534",1787,1788,1788,"white","age.gp4","Tr","NoTrade","Group",12,0,4,1,7,1,9,2,5,7,1,11,9,3,2
"5535",2757,2758,2758,"white","age.gp3","NoTr","NoTrade","NoGroup",14,1,8,2,3,1,12,1,9,5,0,14,11,3,2
"5536",868,869,869,"other","age.gp2","Tr","NoTrade","Group",4,0,3,1,0,1,3,0,1,3,1,3,4,0,2
"5537",2826,2827,2827,"other","age.gp2","NoTr","NoTrade","NoGroup",6,0,3,3,0,2,4,0,4,2,0,6,4,2,2
"5538",1111,1112,1112,"other","age.gp1","NoTr","NoTrade","NoGroup",4,2,2,0,0,0,4,0,2,2,0,4,1,3,2
"5539",2862,2863,2863,"white","age.gp1","Tr","NoTrade","NoGroup",14,8,2,2,2,1,11,2,4,10,1,13,10,4,2
"5540",853,854,854,"other","age.gp2","Tr","NoTrade","Group",7,1,2,3,1,0,7,0,3,4,1,6,7,0,2
"5541",2351,2352,2352,"white","age.gp3","Tr","NoTrade","NoGroup",5,1,4,0,0,1,2,2,3,2,0,5,4,1,2
"5542",2759,2760,2760,"white","age.gp3","NoTr","NoTrade","NoGroup",4,0,3,0,1,0,3,1,2,2,0,4,2,2,2
"5543",860,861,861,"other","age.gp2","Tr","NoTrade","Group",7,0,1,3,3,2,5,0,1,6,0,7,3,4,2
"5544",1041,1042,1042,"black","age.gp4","NoTr","NoTrade","NoGroup",1,0,1,0,0,0,0,1,1,0,0,1,1,0,2
"5545",863,864,864,"other","age.gp2","Tr","NoTrade","Group",9,1,3,4,1,1,8,0,3,6,1,8,6,3,2
"5546",1784,1785,1785,"white","age.gp4","Tr","NoTrade","Group",12,1,4,4,3,1,10,1,4,8,1,11,9,3,2
"5547",1977,1978,1978,"white","age.gp4","Tr","NoTrade","NoGroup",9,0,2,2,5,0,8,1,6,3,0,9,6,3,2
"5548",2559,2560,2560,"white","age.gp4","NoTr","NoTrade","Group",11,0,3,3,5,0,10,1,7,4,0,11,9,2,2
"5549",1140,1141,1141,"white","age.gp1","NoTr","NoTrade","NoGroup",8,3,2,2,1,0,7,1,4,4,2,6,5,3,2
"5550",2930,2931,2931,"white","age.gp4","NoTr","NoTrade","Group",6,0,2,0,4,0,5,1,3,3,0,6,6,0,2
"5551",2543,2544,2544,"other","age.gp1","NoTr","NoTrade","NoGroup",8,2,1,2,3,1,6,1,3,5,0,8,5,3,2
"5552",2793,2794,2794,"white","age.gp2","Tr","NoTrade","NoGroup",9,1,2,2,4,0,7,2,4,5,0,9,9,0,2
"5553",1227,1228,1228,"white","age.gp4","NoTr","NoTrade","NoGroup",2,0,1,1,0,0,1,1,0,2,1,1,1,1,2
"5554",1627,1628,1628,"white","age.gp1","NoTr","NoTrade","NoGroup",4,1,0,1,2,0,4,0,2,2,1,3,3,1,2
"5555",1545,1546,1546,"white","age.gp2","NoTr","NoTrade","NoGroup",8,1,3,2,2,0,7,1,4,4,2,6,6,2,2
"5556",1662,1663,1663,"other","age.gp2","NoTr","NoTrade","NoGroup",4,0,0,3,1,0,4,0,1,3,1,3,3,1,2
"5557",1168,1169,1169,"white","age.gp4","NoTr","NoTrade","NoGroup",5,0,2,2,1,1,4,0,3,2,1,4,3,2,2
"5558",2615,2616,2616,"white","age.gp4","NoTr","NoTrade","NoGroup",4,0,1,1,2,1,3,0,2,2,1,3,3,1,2
"5559",1070,1071,1071,"white","age.gp4","NoTr","NoTrade","Group",14,0,5,3,6,1,12,1,7,7,1,13,12,2,2
"5560",2825,2826,2826,"other","age.gp2","NoTr","NoTrade","NoGroup",4,2,1,1,0,0,4,0,3,1,2,2,2,2,2
"5561",979,980,980,"white","age.gp4","NoTr","NoTrade","NoGroup",5,0,0,3,2,0,5,0,3,2,1,4,4,1,2
"5562",1302,1303,1303,"white","age.gp4","NoTr","NoTrade","Group",9,2,2,1,4,1,7,1,3,6,1,8,7,2,2
"5563",1148,1149,1149,"white","age.gp4","NoTr","NoTrade","NoGroup",2,0,0,2,0,0,2,0,1,1,1,1,2,0,2
"5564",1952,1953,1953,"white","age.gp4","NoTr","NoTrade","Group",7,0,3,2,2,2,5,0,4,3,2,5,6,1,2
"5565",2082,2083,2083,"black","age.gp3","NoTr","NoTrade","NoGroup",7,0,2,3,2,3,4,0,2,5,2,5,4,3,2
"5566",2278,2279,2279,"other","age.gp2","Tr","NoTrade","Group",9,3,2,1,3,0,9,0,4,5,1,8,7,2,2
"5567",2918,2919,2919,"white","age.gp1","NoTr","NoTrade","NoGroup",8,6,0,1,1,0,3,5,3,5,1,7,3,5,2
"5568",1964,1965,1965,"white","age.gp4","NoTr","NoTrade","Group",7,2,0,2,3,0,6,1,4,3,1,6,4,3,2
"5569",895,896,896,"other","age.gp1","Tr","NoTrade","NoGroup",1,1,0,0,0,0,1,0,0,1,0,1,1,0,2
"5570",898,899,899,"other","age.gp1","Tr","NoTrade","NoGroup",5,4,0,1,0,0,5,0,2,3,1,4,3,2,2
"5571",900,901,901,"other","age.gp1","Tr","NoTrade","NoGroup",3,1,0,0,2,0,3,0,1,2,1,2,3,0,2
"5572",905,906,906,"other","age.gp1","Tr","NoTrade","NoGroup",3,1,0,2,0,0,3,0,2,1,0,3,2,1,2
"5573",1141,1142,1142,"white","age.gp1","NoTr","NoTrade","NoGroup",7,3,2,1,1,0,5,2,2,5,0,7,2,5,2
"5574",907,908,908,"other","age.gp1","Tr","NoTrade","NoGroup",5,2,0,2,1,1,4,0,1,4,1,4,3,2,2
"5575",913,914,914,"other","age.gp1","Tr","NoTrade","NoGroup",1,1,0,0,0,0,1,0,1,0,0,1,1,0,2
"5576",914,915,915,"other","age.gp1","Tr","NoTrade","NoGroup",4,3,0,1,0,0,4,0,1,3,0,4,1,3,2
"5577",1016,1017,1017,"white","age.gp1","NoTr","NoTrade","NoGroup",8,7,1,0,0,1,6,1,4,4,3,5,6,2,2
"5578",2500,2501,2501,"other","age.gp1","NoTr","NoTrade","NoGroup",5,4,0,1,0,0,5,0,0,5,1,4,1,4,2
"5579",1480,1481,1481,"white","age.gp4","NoTr","NoTrade","NoGroup",1,0,1,0,0,0,1,0,0,1,0,1,0,1,2
"5580",924,925,925,"white","age.gp2","NoTr","NoTrade","NoGroup",9,1,4,3,1,0,6,3,3,6,0,9,4,5,2
"5581",1699,1700,1700,"white","age.gp4","NoTr","Trade","NoGroup",4,0,2,1,1,0,3,1,2,2,0,4,3,1,2
"5582",931,932,932,"white","age.gp3","NoTr","NoTrade","NoGroup",2,0,1,0,1,0,2,0,0,2,0,2,1,1,2
"5583",932,933,933,"white","age.gp3","NoTr","NoTrade","NoGroup",7,0,4,2,1,2,5,0,3,4,1,6,7,0,2
"5584",2210,2211,2211,"black","age.gp2","NoTr","Trade","Group",11,0,5,5,1,5,6,0,5,6,1,10,7,4,2
"5585",2761,2762,2762,"white","age.gp3","NoTr","NoTrade","NoGroup",8,1,4,2,1,0,7,1,4,4,0,8,6,2,2
"5586",2026,2027,2027,"black","age.gp4","NoTr","NoTrade","NoGroup",1,0,0,1,0,0,1,0,0,1,0,1,0,1,2
"5587",1145,1146,1146,"white","age.gp4","NoTr","NoTrade","NoGroup",1,0,0,1,0,0,1,0,1,0,0,1,1,0,2
"5588",1200,1201,1201,"white","age.gp4","Tr","NoTrade","NoGroup",1,0,0,1,0,0,1,0,1,0,0,1,1,0,2
"5589",2747,2748,2748,"white","age.gp3","NoTr","NoTrade","NoGroup",5,0,1,2,2,0,5,0,3,2,0,5,5,0,2
"5590",1793,1794,1794,"white","age.gp4","Tr","NoTrade","Group",11,2,2,2,5,1,7,3,5,6,1,10,9,2,2
"5591",2914,2915,2915,"other","age.gp1","NoTr","NoTrade","NoGroup",4,1,1,1,1,1,3,0,2,2,0,4,3,1,2
"5592",1985,1986,1986,"white","age.gp4","Tr","NoTrade","NoGroup",6,0,2,3,1,1,4,1,3,3,0,6,4,2,2
"5593",2706,2707,2707,"white","age.gp4","NoTr","NoTrade","Group",16,1,3,5,7,2,14,0,6,10,1,15,8,8,2
"5594",2363,2364,2364,"white","age.gp3","Tr","NoTrade","NoGroup",6,1,1,2,2,1,5,0,2,4,1,5,4,2,2
"5595",1336,1337,1337,"white","age.gp3","NoTr","NoTrade","NoGroup",6,2,3,1,0,2,3,1,5,1,1,5,6,0,2
"5596",1746,1747,1747,"black","age.gp4","NoTr","NoTrade","NoGroup",6,1,0,2,3,2,3,1,2,4,0,6,4,2,2
"5597",2356,2357,2357,"white","age.gp3","Tr","NoTrade","NoGroup",3,1,0,2,0,0,3,0,3,0,0,3,2,1,2
"5598",1150,1151,1151,"white","age.gp4","NoTr","NoTrade","NoGroup",1,0,0,1,0,0,1,0,1,0,0,1,1,0,2
"5599",1448,1449,1449,"white","age.gp1","NoTr","NoTrade","NoGroup",9,6,2,1,0,1,7,1,2,7,1,8,3,6,2
"5600",2034,2035,2035,"white","age.gp4","Tr","NoTrade","Group",14,2,3,3,6,2,12,0,5,9,0,14,9,5,2
"5601",960,961,961,"black","age.gp2","Tr","NoTrade","NoGroup",6,0,3,2,1,4,2,0,2,4,1,5,4,2,2
"5602",2098,2099,2099,"black","age.gp3","NoTr","NoTrade","NoGroup",9,0,6,2,1,6,3,0,4,5,0,9,5,4,2
"5603",1388,1389,1389,"black","age.gp3","NoTr","NoTrade","NoGroup",1,0,1,0,0,1,0,0,0,1,0,1,1,0,2
"5604",2229,2230,2230,"black","age.gp4","NoTr","Trade","Group",5,0,1,0,4,4,1,0,0,5,2,3,5,0,2
"5605",2492,2493,2493,"other","age.gp1","NoTr","NoTrade","NoGroup",2,1,1,0,0,1,1,0,1,1,0,2,1,1,2
"5606",1656,1657,1657,"other","age.gp2","NoTr","NoTrade","NoGroup",4,1,2,0,1,1,3,0,1,3,0,4,3,1,2
"5607",1212,1213,1213,"white","age.gp4","NoTr","NoTrade","NoGroup",3,0,2,0,1,0,3,0,2,1,0,3,2,1,2
"5608",1385,1386,1386,"black","age.gp3","NoTr","NoTrade","NoGroup",4,0,3,1,0,2,1,1,1,3,0,4,3,1,2
"5609",2050,2051,2051,"white","age.gp4","Tr","NoTrade","Group",5,2,2,0,1,0,5,0,3,2,0,5,3,2,2
"5610",1068,1069,1069,"white","age.gp4","NoTr","NoTrade","Group",7,1,1,2,3,1,6,0,3,4,0,7,4,3,2
"5611",1955,1956,1956,"white","age.gp4","NoTr","NoTrade","Group",8,0,3,1,4,0,8,0,7,1,0,8,8,0,2
"5612",2483,2484,2484,"other","age.gp1","NoTr","NoTrade","NoGroup",3,2,1,0,0,1,2,0,2,1,0,3,2,1,2
"5613",1541,1542,1542,"white","age.gp2","NoTr","NoTrade","NoGroup",8,0,4,2,2,0,7,1,4,4,0,8,7,1,2
"5614",977,978,978,"white","age.gp4","NoTr","NoTrade","NoGroup",1,0,0,0,1,0,1,0,0,1,0,1,0,1,2
"5615",974,975,975,"white","age.gp4","NoTr","NoTrade","NoGroup",1,0,0,0,1,0,1,0,0,1,0,1,0,1,2
"5616",975,976,976,"white","age.gp4","NoTr","NoTrade","NoGroup",7,0,1,0,6,0,7,0,5,2,0,7,6,1,2
"5617",1979,1980,1980,"white","age.gp4","Tr","NoTrade","NoGroup",2,0,0,1,1,0,2,0,1,1,0,2,1,1,2
"5618",982,983,983,"white","age.gp4","NoTr","NoTrade","NoGroup",1,0,0,0,1,0,1,0,0,1,0,1,1,0,2
"5619",983,984,984,"white","age.gp4","NoTr","NoTrade","NoGroup",1,0,0,0,1,0,1,0,0,1,0,1,1,0,2
"5620",985,986,986,"white","age.gp4","NoTr","NoTrade","NoGroup",1,0,1,0,0,0,1,0,0,1,0,1,0,1,2
"5621",1920,1921,1921,"other","age.gp2","NoTr","NoTrade","NoGroup",7,1,2,3,1,0,7,0,2,5,0,7,5,2,2
"5622",2197,2198,2198,"white","age.gp4","NoTr","NoTrade","NoGroup",3,0,1,1,1,0,3,0,1,2,0,3,2,1,2
"5623",988,989,989,"white","age.gp4","NoTr","NoTrade","NoGroup",1,0,0,1,0,0,1,0,1,0,0,1,0,1,2
"5624",995,996,996,"white","age.gp4","NoTr","NoTrade","NoGroup",2,0,0,0,2,0,2,0,0,2,0,2,1,1,2
"5625",990,991,991,"white","age.gp4","NoTr","NoTrade","NoGroup",1,0,0,0,1,0,1,0,1,0,0,1,1,0,2
"5626",996,997,997,"white","age.gp4","NoTr","NoTrade","NoGroup",1,0,0,0,1,0,1,0,0,1,0,1,1,0,2
"5627",997,998,998,"white","age.gp4","NoTr","NoTrade","NoGroup",1,0,1,0,0,0,0,1,1,0,0,1,1,0,2
"5628",2933,2934,2934,"white","age.gp4","NoTr","NoTrade","Group",10,1,0,0,9,0,10,0,4,6,0,10,6,4,2
"5629",1000,1001,1001,"white","age.gp4","NoTr","NoTrade","NoGroup",1,0,0,0,1,0,1,0,0,1,0,1,0,1,2
"5630",1001,1002,1002,"white","age.gp4","NoTr","NoTrade","NoGroup",2,0,0,1,1,0,2,0,1,1,0,2,2,0,2
"5631",2499,2500,2500,"other","age.gp1","NoTr","NoTrade","NoGroup",9,5,3,1,0,2,7,0,5,4,1,8,5,4,2
"5632",2895,2896,2896,"other","age.gp1","NoTr","NoTrade","NoGroup",3,3,0,0,0,0,3,0,2,1,0,3,2,1,2
"5633",2479,2480,2480,"other","age.gp1","NoTr","NoTrade","NoGroup",4,3,0,1,0,0,4,0,1,3,0,4,3,1,2
"5634",2532,2533,2533,"other","age.gp1","NoTr","NoTrade","NoGroup",7,5,0,2,0,2,5,0,1,6,0,7,2,5,2
"5635",2501,2502,2502,"other","age.gp1","NoTr","NoTrade","NoGroup",2,2,0,0,0,0,2,0,1,1,0,2,0,2,2
"5636",2915,2916,2916,"other","age.gp1","NoTr","NoTrade","NoGroup",2,2,0,0,0,0,2,0,1,1,0,2,0,2,2
"5637",2638,2639,2639,"white","age.gp4","NoTr","NoTrade","NoGroup",4,1,1,1,1,0,4,0,2,2,0,4,2,2,2
"5638",1576,1577,1577,"white","age.gp4","Tr","NoTrade","Group",14,2,2,4,6,0,14,0,4,10,1,13,11,3,2
"5639",1130,1131,1131,"other","age.gp1","NoTr","NoTrade","NoGroup",7,4,0,1,2,2,5,0,2,5,0,7,2,5,2
"5640",2493,2494,2494,"other","age.gp1","NoTr","NoTrade","NoGroup",6,4,0,2,0,0,6,0,1,5,0,6,2,4,2
"5641",2904,2905,2905,"other","age.gp1","NoTr","NoTrade","NoGroup",5,4,1,0,0,0,5,0,1,4,0,5,2,3,2
"5642",1614,1615,1615,"white","age.gp3","Tr","NoTrade","NoGroup",7,1,5,0,1,1,4,2,2,5,1,6,4,3,2
"5643",2762,2763,2763,"black","age.gp2","NoTr","NoTrade","NoGroup",9,0,4,4,1,5,4,0,2,7,1,8,6,3,2
"5644",2964,2965,2965,"white","age.gp2","NoTr","NoTrade","NoGroup",6,1,5,0,0,1,5,0,3,3,1,5,5,1,2
"5645",1023,1024,1024,"black","age.gp4","NoTr","NoTrade","NoGroup",5,0,1,0,4,2,3,0,1,4,0,5,3,2,2
"5646",1521,1522,1522,"black","age.gp4","NoTr","NoTrade","NoGroup",3,0,0,2,1,3,0,0,0,3,0,3,0,3,2
"5647",1817,1818,1818,"black","age.gp4","NoTr","NoTrade","NoGroup",1,0,0,0,1,1,0,0,0,1,0,1,0,1,2
"5648",1025,1026,1026,"black","age.gp4","NoTr","NoTrade","NoGroup",1,0,0,0,1,1,0,0,0,1,0,1,0,1,2
"5649",1522,1523,1523,"black","age.gp4","NoTr","NoTrade","NoGroup",2,0,0,0,2,1,1,0,1,1,0,2,1,1,2
"5650",1485,1486,1486,"white","age.gp4","NoTr","NoTrade","NoGroup",5,1,0,1,3,1,4,0,1,4,0,5,4,1,2
"5651",1027,1028,1028,"black","age.gp4","NoTr","NoTrade","NoGroup",1,0,1,0,0,0,1,0,0,1,0,1,1,0,2
"5652",1029,1030,1030,"black","age.gp4","NoTr","NoTrade","NoGroup",1,0,1,0,0,0,1,0,1,0,0,1,1,0,2
"5653",1031,1032,1032,"black","age.gp4","NoTr","NoTrade","NoGroup",3,0,0,1,2,1,2,0,1,2,0,3,2,1,2
"5654",1767,1768,1768,"black","age.gp4","NoTr","NoTrade","NoGroup",1,0,0,0,1,1,0,0,0,1,0,1,0,1,2
"5655",1034,1035,1035,"black","age.gp4","NoTr","NoTrade","NoGroup",1,0,0,0,1,0,1,0,0,1,0,1,1,0,2
"5656",1035,1036,1036,"black","age.gp4","NoTr","NoTrade","NoGroup",1,0,1,0,0,1,0,0,0,1,0,1,0,1,2
"5657",1036,1037,1037,"black","age.gp4","NoTr","NoTrade","NoGroup",1,0,1,0,0,0,1,0,1,0,0,1,1,0,2
"5658",1042,1043,1043,"black","age.gp4","NoTr","NoTrade","NoGroup",2,1,0,0,1,0,2,0,1,1,0,2,0,2,2
"5659",1043,1044,1044,"black","age.gp4","NoTr","NoTrade","NoGroup",1,0,0,0,1,1,0,0,0,1,0,1,0,1,2
"5660",2016,2017,2017,"black","age.gp4","NoTr","NoTrade","NoGroup",4,0,0,0,4,2,2,0,0,4,0,4,2,2,2
"5661",1044,1045,1045,"black","age.gp4","NoTr","NoTrade","NoGroup",1,0,0,1,0,1,0,0,0,1,0,1,0,1,2
"5662",1045,1046,1046,"black","age.gp4","NoTr","NoTrade","NoGroup",1,0,0,0,1,1,0,0,0,1,0,1,0,1,2
"5663",1755,1756,1756,"black","age.gp4","NoTr","NoTrade","NoGroup",1,0,0,0,1,1,0,0,0,1,0,1,0,1,2
"5664",2240,2241,2241,"black","age.gp4","NoTr","Trade","Group",8,0,0,2,6,6,2,0,1,7,1,7,3,5,2
"5665",2373,2374,2374,"black","age.gp2","NoTr","NoTrade","NoGroup",8,1,4,0,3,7,0,1,1,7,0,8,4,4,2
"5666",1047,1048,1048,"black","age.gp4","NoTr","NoTrade","NoGroup",1,0,0,0,1,1,0,0,0,1,0,1,1,0,2
"5667",1049,1050,1050,"black","age.gp4","NoTr","NoTrade","NoGroup",5,1,1,2,1,2,3,0,2,3,0,5,2,3,2
"5668",1518,1519,1519,"black","age.gp4","NoTr","NoTrade","NoGroup",3,0,1,1,1,2,1,0,0,3,0,3,0,3,2
"5669",1052,1053,1053,"black","age.gp4","NoTr","NoTrade","NoGroup",1,1,0,0,0,1,0,0,0,1,0,1,0,1,2
"5670",2813,2814,2814,"other","age.gp2","NoTr","NoTrade","NoGroup",6,1,2,1,2,1,5,0,1,5,0,6,2,4,2
"5671",1590,1591,1591,"white","age.gp4","Tr","NoTrade","Group",8,1,1,0,6,2,6,0,2,6,0,8,6,2,2
"5672",1173,1174,1174,"white","age.gp4","NoTr","NoTrade","NoGroup",1,0,0,0,1,0,1,0,0,1,0,1,1,0,2
"5673",2488,2489,2489,"other","age.gp1","NoTr","NoTrade","NoGroup",2,0,1,0,1,0,2,0,1,1,0,2,2,0,2
"5674",2860,2861,2861,"white","age.gp1","Tr","NoTrade","NoGroup",7,3,2,0,2,1,6,0,1,6,0,7,4,3,2
"5675",2621,2622,2622,"white","age.gp4","NoTr","NoTrade","NoGroup",7,0,0,4,3,0,7,0,3,4,0,7,6,1,2
"5676",1984,1985,1985,"white","age.gp4","Tr","NoTrade","NoGroup",1,0,0,0,1,0,1,0,0,1,0,1,1,0,2
"5677",1678,1679,1679,"white","age.gp4","NoTr","Trade","NoGroup",5,0,1,0,4,0,5,0,3,2,0,5,5,0,2
"5678",2179,2180,2180,"white","age.gp4","NoTr","NoTrade","NoGroup",4,0,0,1,3,0,4,0,0,4,0,4,4,0,2
"5679",1076,1077,1077,"white","age.gp4","NoTr","NoTrade","Group",4,0,1,0,3,0,4,0,3,1,0,4,2,2,2
"5680",2189,2190,2190,"white","age.gp4","NoTr","NoTrade","NoGroup",1,0,0,0,1,0,1,0,0,1,0,1,1,0,2
"5681",1474,1475,1475,"black","age.gp1","NoTr","NoTrade","NoGroup",3,1,1,0,1,0,2,1,0,3,0,3,3,0,2
"5682",2456,2457,2457,"white","age.gp4","NoTr","NoTrade","NoGroup",1,0,0,0,1,0,1,0,0,1,0,1,1,0,2
"5683",1397,1398,1398,"black","age.gp3","NoTr","NoTrade","NoGroup",6,0,2,1,3,4,2,0,0,6,0,6,4,2,2
"5684",2803,2804,2804,"other","age.gp2","NoTr","NoTrade","NoGroup",3,0,1,1,1,0,3,0,1,2,0,3,3,0,2
"5685",2433,2434,2434,"white","age.gp4","NoTr","NoTrade","NoGroup",6,1,0,0,5,1,4,1,1,5,0,6,4,2,2
"5686",2174,2175,2175,"white","age.gp4","NoTr","NoTrade","NoGroup",3,1,1,0,1,1,2,0,2,1,0,3,1,2,2
"5687",1839,1840,1840,"black","age.gp3","NoTr","NoTrade","NoGroup",9,1,4,3,1,7,2,0,1,8,1,8,5,4,2
"5688",1635,1636,1636,"black","age.gp1","Tr","NoTrade","NoGroup",9,4,4,1,0,4,1,4,2,7,1,8,3,6,2
"5689",2820,2821,2821,"other","age.gp2","NoTr","NoTrade","NoGroup",3,0,2,1,0,1,2,0,1,2,0,3,1,2,2
"5690",2502,2503,2503,"other","age.gp1","NoTr","NoTrade","NoGroup",3,2,1,0,0,1,2,0,1,2,0,3,1,2,2
"5691",1108,1109,1109,"other","age.gp1","NoTr","NoTrade","NoGroup",7,5,1,1,0,3,4,0,0,7,0,7,2,5,2
"5692",1221,1222,1222,"white","age.gp4","NoTr","NoTrade","NoGroup",1,0,1,0,0,0,1,0,0,1,0,1,1,0,2
"5693",2642,2643,2643,"white","age.gp1","NoTr","NoTrade","NoGroup",7,6,1,0,0,0,5,2,3,4,1,6,2,5,2
"5694",2461,2462,2462,"black","age.gp1","NoTr","NoTrade","NoGroup",7,1,4,1,1,5,2,0,1,6,1,6,3,4,2
"5695",1109,1110,1110,"other","age.gp1","NoTr","NoTrade","NoGroup",4,4,0,0,0,1,3,0,1,3,1,3,1,3,2
"5696",1116,1117,1117,"other","age.gp1","NoTr","NoTrade","NoGroup",5,3,1,0,1,0,5,0,3,2,0,5,3,2,2
"5697",1121,1122,1122,"other","age.gp1","NoTr","NoTrade","NoGroup",4,1,0,2,1,1,3,0,2,2,0,4,1,3,2
"5698",1123,1124,1124,"other","age.gp1","NoTr","NoTrade","NoGroup",1,0,0,1,0,0,1,0,1,0,0,1,0,1,2
"5699",1124,1125,1125,"other","age.gp1","NoTr","NoTrade","NoGroup",6,1,1,1,3,1,5,0,4,2,1,5,5,1,2
"5700",1127,1128,1128,"other","age.gp1","NoTr","NoTrade","NoGroup",5,3,0,1,1,1,4,0,2,3,1,4,4,1,2
"5701",1179,1180,1180,"white","age.gp4","Tr","NoTrade","NoGroup",5,1,1,0,3,1,4,0,2,3,0,5,2,3,2
"5702",2155,2156,2156,"other","age.gp2","NoTr","NoTrade","NoGroup",6,0,4,1,1,1,5,0,3,3,0,6,5,1,2
"5703",2890,2891,2891,"other","age.gp1","NoTr","NoTrade","NoGroup",4,1,3,0,0,0,3,1,2,2,0,4,2,2,2
"5704",1278,1279,1279,"white","age.gp4","NoTr","NoTrade","Group",9,0,2,2,5,0,9,0,6,3,0,9,9,0,2
"5705",1139,1140,1140,"white","age.gp1","NoTr","NoTrade","NoGroup",6,4,2,0,0,0,5,1,2,4,0,6,2,4,2
"5706",1143,1144,1144,"white","age.gp4","NoTr","NoTrade","NoGroup",1,0,0,1,0,0,1,0,0,1,0,1,1,0,2
"5707",1146,1147,1147,"white","age.gp4","NoTr","NoTrade","NoGroup",1,0,0,1,0,0,1,0,0,1,0,1,1,0,2
"5708",1147,1148,1148,"white","age.gp4","NoTr","NoTrade","NoGroup",2,0,0,0,2,0,2,0,1,1,0,2,2,0,2
"5709",1152,1153,1153,"white","age.gp4","NoTr","NoTrade","NoGroup",1,0,1,0,0,0,1,0,0,1,0,1,1,0,2
"5710",2566,2567,2567,"white","age.gp4","NoTr","NoTrade","Group",10,0,3,2,5,2,7,1,4,6,1,9,4,6,2
"5711",1155,1156,1156,"white","age.gp4","NoTr","NoTrade","NoGroup",1,0,1,0,0,0,1,0,1,0,0,1,0,1,2
"5712",1156,1157,1157,"white","age.gp4","NoTr","NoTrade","NoGroup",3,0,2,0,1,1,2,0,1,2,0,3,2,1,2
"5713",1159,1160,1160,"white","age.gp4","NoTr","NoTrade","NoGroup",8,0,3,2,3,1,7,0,4,4,1,7,8,0,2
"5714",1162,1163,1163,"white","age.gp4","NoTr","NoTrade","NoGroup",1,1,0,0,0,0,1,0,1,0,1,0,1,0,2
"5715",1163,1164,1164,"white","age.gp4","NoTr","NoTrade","NoGroup",1,0,0,0,1,0,1,0,0,1,0,1,1,0,2
"5716",1436,1437,1437,"white","age.gp3","Tr","NoTrade","NoGroup",5,1,0,1,3,0,5,0,3,2,0,5,3,2,2
"5717",1174,1175,1175,"white","age.gp4","NoTr","NoTrade","NoGroup",1,1,0,0,0,0,0,1,0,1,0,1,0,1,2
"5718",1690,1691,1691,"white","age.gp4","NoTr","Trade","NoGroup",1,0,0,0,1,0,1,0,1,0,0,1,0,1,2
"5719",2295,2296,2296,"other","age.gp2","Tr","NoTrade","Group",8,0,5,1,2,0,8,0,6,2,0,8,6,2,2
"5720",1176,1177,1177,"white","age.gp4","Tr","NoTrade","NoGroup",5,0,2,2,1,0,5,0,3,2,0,5,4,1,2
"5721",1481,1482,1482,"white","age.gp4","NoTr","NoTrade","NoGroup",5,1,1,1,2,0,4,1,2,3,0,5,2,3,2
"5722",1217,1218,1218,"white","age.gp4","NoTr","NoTrade","NoGroup",1,0,0,0,1,0,1,0,1,0,0,1,0,1,2
"5723",1180,1181,1181,"white","age.gp4","Tr","NoTrade","NoGroup",1,0,1,0,0,0,1,0,0,1,0,1,1,0,2
"5724",2370,2371,2371,"black","age.gp2","NoTr","NoTrade","NoGroup",4,0,3,0,1,1,2,1,3,1,0,4,2,2,2
"5725",1216,1217,1217,"white","age.gp4","NoTr","NoTrade","NoGroup",3,0,0,1,2,0,3,0,2,1,0,3,2,1,2
"5726",1509,1510,1510,"white","age.gp4","NoTr","NoTrade","NoGroup",1,0,0,0,1,0,1,0,1,0,0,1,0,1,2
"5727",1187,1188,1188,"white","age.gp4","Tr","NoTrade","NoGroup",1,1,0,0,0,0,0,1,0,1,0,1,1,0,2
"5728",1479,1480,1480,"white","age.gp4","NoTr","NoTrade","NoGroup",5,0,1,2,2,1,3,1,2,3,1,4,2,3,2
"5729",1193,1194,1194,"white","age.gp4","Tr","NoTrade","NoGroup",1,0,0,0,1,0,1,0,0,1,0,1,1,0,2
"5730",2371,2372,2372,"black","age.gp2","NoTr","NoTrade","NoGroup",3,0,0,1,2,0,3,0,2,1,0,3,1,2,2
"5731",1198,1199,1199,"white","age.gp4","Tr","NoTrade","NoGroup",7,0,2,1,4,0,6,1,1,6,0,7,6,1,2
"5732",1199,1200,1200,"white","age.gp4","Tr","NoTrade","NoGroup",1,0,0,0,1,0,1,0,0,1,0,1,1,0,2
"5733",1202,1203,1203,"white","age.gp4","Tr","NoTrade","NoGroup",6,0,2,0,4,1,5,0,4,2,0,6,6,0,2
"5734",1488,1489,1489,"white","age.gp4","NoTr","NoTrade","NoGroup",1,0,0,0,1,0,1,0,1,0,0,1,0,1,2
"5735",1206,1207,1207,"white","age.gp4","Tr","NoTrade","NoGroup",2,1,1,0,0,0,1,1,0,2,0,2,1,1,2
"5736",1207,1208,1208,"white","age.gp4","NoTr","NoTrade","NoGroup",1,0,0,0,1,0,1,0,1,0,0,1,1,0,2
"5737",2347,2348,2348,"black","age.gp2","NoTr","NoTrade","Group",16,0,8,7,1,7,8,1,6,10,1,15,9,7,2
"5738",2674,2675,2675,"white","age.gp3","NoTr","NoTrade","NoGroup",7,0,3,1,3,0,7,0,1,6,0,7,4,3,2
"5739",1209,1210,1210,"white","age.gp4","NoTr","NoTrade","NoGroup",4,0,2,0,2,0,4,0,3,1,0,4,4,0,2
"5740",1215,1216,1216,"white","age.gp4","NoTr","NoTrade","NoGroup",1,0,0,0,1,0,1,0,0,1,0,1,0,1,2
"5741",1223,1224,1224,"white","age.gp4","NoTr","NoTrade","NoGroup",1,0,0,0,1,0,1,0,0,1,0,1,1,0,2
"5742",1228,1229,1229,"white","age.gp4","NoTr","NoTrade","NoGroup",1,0,0,1,0,0,1,0,0,1,0,1,1,0,2
"5743",1235,1236,1236,"white","age.gp4","NoTr","NoTrade","NoGroup",1,0,0,0,1,0,1,0,0,1,0,1,1,0,2
"5744",1238,1239,1239,"white","age.gp4","NoTr","NoTrade","NoGroup",4,0,0,0,4,0,4,0,2,2,0,4,3,1,2
"5745",1676,1677,1677,"white","age.gp4","NoTr","Trade","NoGroup",2,0,1,1,0,0,2,0,1,1,0,2,1,1,2
"5746",2462,2463,2463,"white","age.gp1","Tr","NoTrade","NoGroup",8,4,2,1,1,0,8,0,1,7,0,8,5,3,2
"5747",1334,1335,1335,"white","age.gp3","NoTr","NoTrade","NoGroup",5,1,2,0,2,0,4,1,2,3,0,5,3,2,2
"5748",2556,2557,2557,"other","age.gp1","NoTr","NoTrade","NoGroup",4,3,1,0,0,0,4,0,3,1,0,4,1,3,2
"5749",1330,1331,1331,"white","age.gp3","NoTr","NoTrade","NoGroup",1,0,1,0,0,0,1,0,1,0,0,1,1,0,2
"5750",2158,2159,2159,"other","age.gp2","NoTr","NoTrade","NoGroup",7,1,3,1,2,2,5,0,1,6,1,6,3,4,2
"5751",1382,1383,1383,"white","age.gp1","NoTr","NoTrade","NoGroup",9,4,2,2,1,0,9,0,4,5,1,8,6,3,2
"5752",2384,2385,2385,"white","age.gp1","NoTr","NoTrade","NoGroup",7,2,3,1,1,0,6,1,4,3,1,6,5,2,2
"5753",1768,1769,1769,"black","age.gp4","NoTr","NoTrade","NoGroup",1,0,0,1,0,1,0,0,0,1,0,1,0,1,2
"5754",1260,1261,1261,"black","age.gp3","NoTr","NoTrade","NoGroup",4,1,1,1,1,4,0,0,0,4,1,3,1,3,2
"5755",1513,1514,1514,"black","age.gp4","NoTr","NoTrade","NoGroup",2,0,0,1,1,1,1,0,1,1,0,2,0,2,2
"5756",1688,1689,1689,"white","age.gp4","NoTr","Trade","NoGroup",1,0,0,1,0,1,0,0,0,1,0,1,0,1,2
"5757",2758,2759,2759,"white","age.gp3","NoTr","NoTrade","NoGroup",10,2,1,5,2,2,8,0,3,7,0,10,5,5,2
"5758",2682,2683,2683,"black","age.gp3","NoTr","NoTrade","NoGroup",5,2,1,1,1,4,1,0,1,4,0,5,1,4,2
"5759",1439,1440,1440,"white","age.gp3","Tr","NoTrade","NoGroup",4,0,0,2,2,1,3,0,2,2,0,4,3,1,2
"5760",1282,1283,1283,"white","age.gp4","NoTr","NoTrade","Group",8,1,0,3,4,0,8,0,3,5,1,7,5,3,2
"5761",1681,1682,1682,"white","age.gp4","NoTr","Trade","NoGroup",2,0,0,0,2,0,2,0,0,2,0,2,2,0,2
"5762",1704,1705,1705,"white","age.gp4","NoTr","Trade","NoGroup",1,0,0,0,1,0,1,0,0,1,0,1,1,0,2
"5763",1929,1930,1930,"other","age.gp2","NoTr","NoTrade","NoGroup",4,0,2,0,2,0,4,0,2,2,0,4,3,1,2
"5764",1934,1935,1935,"white","age.gp4","NoTr","NoTrade","Group",10,2,0,1,7,3,7,0,6,4,2,8,7,3,2
"5765",1923,1924,1924,"other","age.gp2","NoTr","NoTrade","NoGroup",1,0,0,0,1,0,1,0,0,1,0,1,1,0,2
"5766",2487,2488,2488,"other","age.gp1","NoTr","NoTrade","NoGroup",3,1,0,1,1,0,3,0,0,3,0,3,2,1,2
"5767",1679,1680,1680,"white","age.gp4","NoTr","Trade","NoGroup",1,0,0,0,1,0,1,0,0,1,0,1,1,0,2
"5768",1422,1423,1423,"white","age.gp2","NoTr","NoTrade","Group",15,1,7,3,4,1,13,1,4,11,1,14,8,7,2
"5769",1969,1970,1970,"white","age.gp4","Tr","NoTrade","NoGroup",3,0,3,0,0,0,2,1,2,1,0,3,1,2,2
"5770",2156,2157,2157,"other","age.gp2","NoTr","NoTrade","NoGroup",3,0,2,0,1,0,3,0,2,1,1,2,2,1,2
"5771",1664,1665,1665,"other","age.gp2","NoTr","NoTrade","NoGroup",6,0,1,3,2,0,6,0,4,2,0,6,4,2,2
"5772",2901,2902,2902,"other","age.gp1","NoTr","NoTrade","NoGroup",3,1,1,0,1,0,3,0,1,2,0,3,2,1,2
"5773",1540,1541,1541,"black","age.gp4","NoTr","NoTrade","NoGroup",2,1,0,1,0,1,1,0,1,1,0,2,0,2,2
"5774",1914,1915,1915,"other","age.gp2","NoTr","NoTrade","NoGroup",3,0,1,0,2,1,2,0,1,2,0,3,3,0,2
"5775",1530,1531,1531,"black","age.gp4","NoTr","NoTrade","NoGroup",1,0,0,0,1,1,0,0,0,1,0,1,1,0,2
"5776",1816,1817,1817,"black","age.gp4","NoTr","NoTrade","NoGroup",2,0,0,1,1,2,0,0,0,2,0,2,1,1,2
"5777",2015,2016,2016,"black","age.gp4","NoTr","NoTrade","NoGroup",1,0,0,0,1,1,0,0,0,1,0,1,1,0,2
"5778",2185,2186,2186,"white","age.gp4","NoTr","NoTrade","NoGroup",1,0,0,0,1,1,0,0,0,1,0,1,1,0,2
"5779",1539,1540,1540,"black","age.gp4","NoTr","NoTrade","NoGroup",5,1,1,1,2,3,2,0,2,3,1,4,5,0,2
"5780",1769,1770,1770,"black","age.gp4","NoTr","NoTrade","NoGroup",1,0,0,0,1,1,0,0,0,1,0,1,1,0,2
"5781",2639,2640,2640,"white","age.gp4","NoTr","NoTrade","NoGroup",1,0,0,0,1,1,0,0,0,1,0,1,1,0,2
"5782",2017,2018,2018,"black","age.gp4","NoTr","NoTrade","NoGroup",4,0,1,0,3,1,3,0,2,2,0,4,3,1,2
"5783",1659,1660,1660,"other","age.gp2","NoTr","NoTrade","NoGroup",3,0,0,3,0,1,2,0,1,2,0,3,2,1,2
"5784",1392,1393,1393,"black","age.gp3","NoTr","NoTrade","NoGroup",2,1,1,0,0,0,2,0,1,1,0,2,1,1,2
"5785",1396,1397,1397,"black","age.gp3","NoTr","NoTrade","NoGroup",4,2,1,1,0,2,1,1,1,3,0,4,2,2,2
"5786",1637,1638,1638,"black","age.gp1","Tr","NoTrade","NoGroup",8,2,2,3,1,4,4,0,1,7,1,7,5,3,2
"5787",1398,1399,1399,"black","age.gp3","NoTr","NoTrade","NoGroup",10,0,5,4,1,6,3,1,2,8,0,10,6,4,2
"5788",2802,2803,2803,"other","age.gp2","NoTr","NoTrade","NoGroup",2,0,0,1,1,1,1,0,0,2,0,2,0,2,2
"5789",1491,1492,1492,"white","age.gp4","NoTr","NoTrade","NoGroup",1,0,0,1,0,0,1,0,0,1,0,1,1,0,2
"5790",2796,2797,2797,"white","age.gp2","Tr","NoTrade","NoGroup",8,0,4,2,2,1,7,0,1,7,0,8,5,3,2
"5791",1821,1822,1822,"black","age.gp4","NoTr","NoTrade","NoGroup",1,0,1,0,0,0,1,0,1,0,0,1,1,0,2
"5792",1487,1488,1488,"white","age.gp4","NoTr","NoTrade","NoGroup",1,0,1,0,0,0,1,0,1,0,0,1,1,0,2
"5793",1650,1651,1651,"other","age.gp2","NoTr","NoTrade","NoGroup",5,0,2,2,1,1,4,0,3,2,0,5,3,2,2
"5794",1461,1462,1462,"white","age.gp1","NoTr","NoTrade","NoGroup",4,2,2,0,0,0,4,0,0,4,0,4,3,1,2
"5795",1912,1913,1913,"other","age.gp2","NoTr","NoTrade","NoGroup",2,1,1,0,0,1,1,0,0,2,0,2,1,1,2
"5796",1633,1634,1634,"black","age.gp1","Tr","NoTrade","NoGroup",4,2,1,1,0,1,3,0,2,2,0,4,3,1,2
"5797",2539,2540,2540,"other","age.gp1","NoTr","NoTrade","NoGroup",3,2,0,1,0,0,3,0,1,2,0,3,2,1,2
"5798",2534,2535,2535,"other","age.gp1","NoTr","NoTrade","NoGroup",4,1,2,1,0,1,3,0,1,3,1,3,2,2,2
"5799",1641,1642,1642,"other","age.gp2","NoTr","NoTrade","NoGroup",2,0,2,0,0,0,2,0,0,2,1,1,2,0,2
"5800",2146,2147,2147,"other","age.gp2","NoTr","NoTrade","NoGroup",3,1,1,1,0,0,3,0,2,1,0,3,2,1,2
"5801",1486,1487,1487,"white","age.gp4","NoTr","NoTrade","NoGroup",3,1,0,2,0,0,2,1,2,1,0,3,1,2,2
"5802",1489,1490,1490,"white","age.gp4","NoTr","NoTrade","NoGroup",6,0,2,1,3,1,4,1,1,5,0,6,3,3,2
"5803",1831,1832,1832,"black","age.gp4","NoTr","NoTrade","NoGroup",5,0,0,1,4,2,3,0,1,4,1,4,3,2,2
"5804",1496,1497,1497,"white","age.gp4","NoTr","NoTrade","NoGroup",1,0,0,0,1,0,1,0,1,0,0,1,1,0,2
"5805",1497,1498,1498,"white","age.gp4","NoTr","NoTrade","NoGroup",1,0,0,0,1,0,1,0,1,0,0,1,1,0,2
"5806",1500,1501,1501,"white","age.gp4","NoTr","NoTrade","NoGroup",1,0,1,0,0,0,0,1,1,0,0,1,1,0,2
"5807",1506,1507,1507,"white","age.gp4","NoTr","NoTrade","NoGroup",1,0,0,0,1,0,1,0,1,0,0,1,1,0,2
"5808",1514,1515,1515,"black","age.gp4","NoTr","NoTrade","NoGroup",1,1,0,0,0,0,1,0,0,1,0,1,1,0,2
"5809",1516,1517,1517,"black","age.gp4","NoTr","NoTrade","NoGroup",1,0,1,0,0,0,0,1,0,1,0,1,0,1,2
"5810",1517,1518,1518,"black","age.gp4","NoTr","NoTrade","NoGroup",1,0,0,0,1,1,0,0,0,1,0,1,0,1,2
"5811",1828,1829,1829,"black","age.gp4","NoTr","NoTrade","NoGroup",2,0,0,0,2,2,0,0,0,2,1,1,1,1,2
"5812",1524,1525,1525,"black","age.gp4","NoTr","NoTrade","NoGroup",1,0,1,0,0,0,0,1,1,0,0,1,1,0,2
"5813",1525,1526,1526,"black","age.gp4","NoTr","NoTrade","NoGroup",1,0,0,0,1,1,0,0,0,1,0,1,0,1,2
"5814",1535,1536,1536,"black","age.gp4","NoTr","NoTrade","NoGroup",1,0,0,0,1,0,1,0,1,0,0,1,1,0,2
"5815",1536,1537,1537,"black","age.gp4","NoTr","NoTrade","NoGroup",1,0,0,0,1,0,1,0,0,1,0,1,1,0,2
"5816",2732,2733,2733,"black","age.gp3","NoTr","NoTrade","NoGroup",3,0,1,1,1,1,2,0,0,3,0,3,1,2,2
"5817",1970,1971,1971,"white","age.gp4","Tr","NoTrade","NoGroup",2,0,0,1,1,0,2,0,1,1,0,2,1,1,2
"5818",2811,2812,2812,"other","age.gp2","NoTr","NoTrade","NoGroup",2,0,1,1,0,0,2,0,1,1,0,2,2,0,2
"5819",2193,2194,2194,"white","age.gp4","NoTr","NoTrade","NoGroup",1,0,0,0,1,0,1,0,1,0,0,1,1,0,2
"5820",1852,1853,1853,"black","age.gp3","NoTr","NoTrade","NoGroup",2,1,0,0,1,0,1,1,1,1,0,2,1,1,2
"5821",2620,2621,2621,"white","age.gp4","NoTr","NoTrade","NoGroup",1,0,0,0,1,0,1,0,1,0,0,1,1,0,2
"5822",2880,2881,2881,"white","age.gp2","NoTr","NoTrade","NoGroup",1,0,0,0,1,0,1,0,1,0,0,1,1,0,2
"5823",1744,1745,1745,"black","age.gp4","NoTr","NoTrade","NoGroup",1,0,0,0,1,0,1,0,1,0,0,1,1,0,2
"5824",2205,2206,2206,"white","age.gp4","NoTr","NoTrade","NoGroup",4,0,0,1,3,0,4,0,3,1,0,4,3,1,2
"5825",1691,1692,1692,"white","age.gp4","NoTr","Trade","NoGroup",4,0,0,2,2,0,4,0,4,0,0,4,4,0,2
"5826",1743,1744,1744,"black","age.gp4","NoTr","NoTrade","NoGroup",1,1,0,0,0,1,0,0,1,0,1,0,0,1,2
"5827",2224,2225,2225,"black","age.gp4","NoTr","Trade","Group",4,1,0,2,1,3,1,0,1,3,1,3,3,1,2
"5828",1686,1687,1687,"white","age.gp4","NoTr","Trade","NoGroup",1,0,1,0,0,0,1,0,1,0,0,1,0,1,2
"5829",1638,1639,1639,"other","age.gp2","NoTr","NoTrade","NoGroup",3,0,1,0,2,0,3,0,1,2,0,3,2,1,2
"5830",1639,1640,1640,"other","age.gp2","NoTr","NoTrade","NoGroup",2,0,2,0,0,0,2,0,2,0,0,2,2,0,2
"5831",1645,1646,1646,"other","age.gp2","NoTr","NoTrade","NoGroup",1,0,1,0,0,0,1,0,0,1,0,1,0,1,2
"5832",2202,2203,2203,"white","age.gp4","NoTr","NoTrade","NoGroup",1,0,1,0,0,0,0,1,0,1,0,1,0,1,2
"5833",1649,1650,1650,"other","age.gp2","NoTr","NoTrade","NoGroup",2,0,1,1,0,1,1,0,2,0,1,1,2,0,2
"5834",2010,2011,2011,"black","age.gp4","NoTr","NoTrade","NoGroup",1,0,1,0,0,0,1,0,1,0,0,1,0,1,2
"5835",2622,2623,2623,"white","age.gp4","NoTr","NoTrade","NoGroup",1,0,1,0,0,0,1,0,1,0,0,1,0,1,2
"5836",1675,1676,1676,"white","age.gp4","NoTr","Trade","NoGroup",1,0,0,0,1,0,1,0,0,1,0,1,1,0,2
"5837",1677,1678,1678,"white","age.gp4","NoTr","Trade","NoGroup",1,0,0,0,1,0,1,0,1,0,0,1,1,0,2
"5838",1680,1681,1681,"white","age.gp4","NoTr","Trade","NoGroup",1,0,0,0,1,0,1,0,1,0,0,1,1,0,2
"5839",1682,1683,1683,"white","age.gp4","NoTr","Trade","NoGroup",1,0,0,0,1,1,0,0,0,1,1,0,1,0,2
"5840",1685,1686,1686,"white","age.gp4","NoTr","Trade","NoGroup",1,0,0,0,1,0,1,0,1,0,0,1,0,1,2
"5841",1965,1966,1966,"white","age.gp4","Tr","NoTrade","NoGroup",7,0,1,3,3,0,7,0,3,4,2,5,5,2,2
"5842",1692,1693,1693,"white","age.gp4","NoTr","Trade","NoGroup",1,0,1,0,0,0,1,0,1,0,0,1,1,0,2
"5843",1694,1695,1695,"white","age.gp4","NoTr","Trade","NoGroup",1,0,0,0,1,0,1,0,0,1,0,1,1,0,2
"5844",1702,1703,1703,"white","age.gp4","NoTr","Trade","NoGroup",1,1,0,0,0,0,1,0,1,0,0,1,0,1,2
"5845",1705,1706,1706,"white","age.gp4","NoTr","Trade","NoGroup",1,0,0,0,1,1,0,0,0,1,1,0,1,0,2
"5846",1972,1973,1973,"white","age.gp4","Tr","NoTrade","NoGroup",1,0,1,0,0,0,1,0,1,0,0,1,1,0,2
"5847",2553,2554,2554,"other","age.gp1","NoTr","NoTrade","NoGroup",2,2,0,0,0,0,2,0,2,0,0,2,0,2,2
"5848",2687,2688,2688,"black","age.gp3","NoTr","NoTrade","NoGroup",4,0,2,1,1,2,2,0,1,3,1,3,4,0,2
"5849",2079,2080,2080,"black","age.gp3","NoTr","NoTrade","NoGroup",2,0,1,1,0,0,2,0,1,1,0,2,2,0,2
"5850",1742,1743,1743,"black","age.gp4","NoTr","NoTrade","NoGroup",1,0,0,1,0,0,1,0,1,0,0,1,0,1,2
"5851",2188,2189,2189,"white","age.gp4","NoTr","NoTrade","NoGroup",1,0,0,0,1,1,0,0,0,1,0,1,0,1,2
"5852",1753,1754,1754,"black","age.gp4","NoTr","NoTrade","NoGroup",2,0,0,0,2,1,1,0,0,2,1,1,1,1,2
"5853",2450,2451,2451,"white","age.gp4","NoTr","NoTrade","NoGroup",1,0,0,0,1,1,0,0,0,1,0,1,0,1,2
"5854",1754,1755,1755,"black","age.gp4","NoTr","NoTrade","NoGroup",1,1,0,0,0,0,0,1,0,1,0,1,1,0,2
"5855",1762,1763,1763,"black","age.gp4","NoTr","NoTrade","NoGroup",2,0,2,0,0,1,1,0,0,2,0,2,2,0,2
"5856",1763,1764,1764,"black","age.gp4","NoTr","NoTrade","NoGroup",1,0,0,1,0,1,0,0,0,1,0,1,0,1,2
"5857",1764,1765,1765,"black","age.gp4","NoTr","NoTrade","NoGroup",1,0,0,0,1,0,1,0,1,0,0,1,1,0,2
"5858",2436,2437,2437,"white","age.gp4","NoTr","NoTrade","NoGroup",1,0,0,0,1,0,1,0,1,0,0,1,1,0,2
"5859",2441,2442,2442,"white","age.gp4","NoTr","NoTrade","NoGroup",1,0,0,0,1,0,1,0,1,0,0,1,1,0,2
"5860",2911,2912,2912,"other","age.gp1","NoTr","NoTrade","NoGroup",3,1,1,0,1,0,3,0,1,2,0,3,2,1,2
"5861",2894,2895,2895,"other","age.gp1","NoTr","NoTrade","NoGroup",2,0,2,0,0,0,2,0,1,1,0,2,2,0,2
"5862",1811,1812,1812,"black","age.gp4","NoTr","NoTrade","NoGroup",1,0,0,1,0,1,0,0,0,1,0,1,0,1,2
"5863",1815,1816,1816,"black","age.gp4","NoTr","NoTrade","NoGroup",1,1,0,0,0,1,0,0,0,1,0,1,0,1,2
"5864",1818,1819,1819,"black","age.gp4","NoTr","NoTrade","NoGroup",1,0,1,0,0,1,0,0,0,1,0,1,1,0,2
"5865",1819,1820,1820,"black","age.gp4","NoTr","NoTrade","NoGroup",1,0,0,1,0,0,1,0,0,1,0,1,0,1,2
"5866",1823,1824,1824,"black","age.gp4","NoTr","NoTrade","NoGroup",1,1,0,0,0,0,0,1,0,1,0,1,1,0,2
"5867",1826,1827,1827,"black","age.gp4","NoTr","NoTrade","NoGroup",2,0,0,1,1,1,1,0,0,2,0,2,0,2,2
"5868",2225,2226,2226,"black","age.gp4","NoTr","Trade","Group",3,0,0,1,2,2,1,0,0,3,0,3,1,2,2
"5869",1832,1833,1833,"black","age.gp4","NoTr","NoTrade","NoGroup",1,0,0,1,0,1,0,0,0,1,0,1,1,0,2
"5870",1834,1835,1835,"black","age.gp4","NoTr","NoTrade","NoGroup",1,0,0,1,0,1,0,0,0,1,0,1,0,1,2
"5871",1837,1838,1838,"black","age.gp4","NoTr","NoTrade","NoGroup",1,0,0,1,0,1,0,0,0,1,0,1,1,0,2
"5872",1841,1842,1842,"black","age.gp3","NoTr","NoTrade","NoGroup",4,2,0,2,0,2,2,0,1,3,0,4,1,3,2
"5873",1845,1846,1846,"black","age.gp3","NoTr","NoTrade","NoGroup",1,0,0,1,0,0,1,0,1,0,0,1,1,0,2
"5874",2550,2551,2551,"other","age.gp1","NoTr","NoTrade","NoGroup",3,2,0,1,0,2,1,0,0,3,0,3,1,2,2
"5875",1987,1988,1988,"white","age.gp4","Tr","NoTrade","NoGroup",1,0,0,1,0,0,1,0,0,1,0,1,1,0,2
"5876",2187,2188,2188,"white","age.gp4","NoTr","NoTrade","NoGroup",1,1,0,0,0,0,0,1,0,1,0,1,1,0,2
"5877",1921,1922,1922,"other","age.gp2","NoTr","NoTrade","NoGroup",3,1,2,0,0,0,3,0,1,2,0,3,3,0,2
"5878",1927,1928,1928,"other","age.gp2","NoTr","NoTrade","NoGroup",2,0,1,1,0,1,1,0,0,2,1,1,2,0,2
"5879",1931,1932,1932,"other","age.gp2","NoTr","NoTrade","NoGroup",2,0,2,0,0,1,1,0,0,2,0,2,2,0,2
"5880",2432,2433,2433,"white","age.gp4","NoTr","NoTrade","NoGroup",3,0,0,0,3,0,3,0,1,2,0,3,3,0,2
"5881",2182,2183,2183,"white","age.gp4","NoTr","NoTrade","NoGroup",3,1,0,0,2,0,3,0,1,2,0,3,3,0,2
"5882",2435,2436,2436,"white","age.gp4","NoTr","NoTrade","NoGroup",1,0,0,0,1,0,1,0,0,1,0,1,1,0,2
"5883",2455,2456,2456,"white","age.gp4","NoTr","NoTrade","NoGroup",3,0,0,0,3,0,3,0,0,3,0,3,3,0,2
"5884",1966,1967,1967,"white","age.gp4","Tr","NoTrade","NoGroup",1,0,0,0,1,0,1,0,1,0,0,1,0,1,2
"5885",1982,1983,1983,"white","age.gp4","Tr","NoTrade","NoGroup",1,0,1,0,0,1,0,0,0,1,0,1,1,0,2
"5886",1994,1995,1995,"white","age.gp4","Tr","NoTrade","NoGroup",1,0,1,0,0,1,0,0,1,0,0,1,1,0,2
"5887",1996,1997,1997,"white","age.gp4","Tr","NoTrade","NoGroup",1,0,0,0,1,0,1,0,1,0,0,1,1,0,2
"5888",2204,2205,2205,"white","age.gp4","NoTr","NoTrade","NoGroup",1,0,0,0,1,1,0,0,0,1,0,1,0,1,2
"5889",2002,2003,2003,"black","age.gp4","NoTr","NoTrade","NoGroup",1,0,0,0,1,0,1,0,1,0,0,1,1,0,2
"5890",2011,2012,2012,"black","age.gp4","NoTr","NoTrade","NoGroup",1,0,0,1,0,1,0,0,0,1,0,1,1,0,2
"5891",2012,2013,2013,"black","age.gp4","NoTr","NoTrade","NoGroup",3,0,1,1,1,1,2,0,1,2,1,2,3,0,2
"5892",2628,2629,2629,"white","age.gp4","NoTr","NoTrade","NoGroup",1,0,0,0,1,1,0,0,0,1,0,1,0,1,2
"5893",2018,2019,2019,"black","age.gp4","NoTr","NoTrade","NoGroup",2,0,0,1,1,0,2,0,1,1,1,1,2,0,2
"5894",2024,2025,2025,"black","age.gp4","NoTr","NoTrade","NoGroup",1,0,0,0,1,0,1,0,0,1,0,1,1,0,2
"5895",2635,2636,2636,"white","age.gp4","NoTr","NoTrade","NoGroup",1,0,0,1,0,0,1,0,1,0,0,1,1,0,2
"5896",2176,2177,2177,"white","age.gp4","NoTr","NoTrade","NoGroup",1,0,0,1,0,0,1,0,1,0,0,1,1,0,2
"5897",2190,2191,2191,"white","age.gp4","NoTr","NoTrade","NoGroup",1,0,0,1,0,0,1,0,1,0,0,1,1,0,2
"5898",2088,2089,2089,"black","age.gp3","NoTr","NoTrade","NoGroup",2,0,1,1,0,0,2,0,2,0,0,2,1,1,2
"5899",2191,2192,2192,"white","age.gp4","NoTr","NoTrade","NoGroup",1,0,0,1,0,0,1,0,0,1,1,0,1,0,2
"5900",2196,2197,2197,"white","age.gp4","NoTr","NoTrade","NoGroup",1,0,0,0,1,0,1,0,0,1,0,1,0,1,2
"5901",2203,2204,2204,"white","age.gp4","NoTr","NoTrade","NoGroup",1,0,0,0,1,0,1,0,0,1,0,1,1,0,2
"5902",2530,2531,2531,"other","age.gp1","NoTr","NoTrade","NoGroup",3,1,0,1,1,1,2,0,0,3,1,2,3,0,2
"5903",2364,2365,2365,"white","age.gp3","Tr","NoTrade","NoGroup",4,1,1,1,1,0,3,1,2,2,0,4,3,1,2
"5904",2372,2373,2373,"black","age.gp2","NoTr","NoTrade","NoGroup",3,1,2,0,0,2,0,1,0,3,0,3,0,3,2
"5905",2403,2404,2404,"white","age.gp3","NoTr","NoTrade","NoGroup",1,0,0,1,0,0,1,0,0,1,0,1,0,1,2
"5906",2447,2448,2448,"white","age.gp4","NoTr","NoTrade","NoGroup",2,1,0,1,0,0,2,0,0,2,1,1,1,1,2
"5907",2443,2444,2444,"white","age.gp4","NoTr","NoTrade","NoGroup",1,0,1,0,0,0,1,0,1,0,0,1,1,0,2
"5908",2444,2445,2445,"white","age.gp4","NoTr","NoTrade","NoGroup",1,0,1,0,0,0,1,0,0,1,0,1,1,0,2
"5909",2892,2893,2893,"other","age.gp1","NoTr","NoTrade","NoGroup",2,1,0,1,0,1,1,0,0,2,0,2,1,1,2
"5910",2541,2542,2542,"other","age.gp1","NoTr","NoTrade","NoGroup",3,3,0,0,0,0,3,0,0,3,0,3,1,2,2
"5911",2554,2555,2555,"other","age.gp1","NoTr","NoTrade","NoGroup",1,1,0,0,0,0,1,0,0,1,0,1,0,1,2
"5912",2555,2556,2556,"other","age.gp1","NoTr","NoTrade","NoGroup",2,0,2,0,0,0,2,0,2,0,0,2,1,1,2
"5913",2633,2634,2634,"white","age.gp4","NoTr","NoTrade","NoGroup",1,0,0,0,1,0,1,0,0,1,0,1,1,0,2
