,Unnamed: 0,node,ethcat,agecat,treat,Trade_sex,Group_sex,degree,age.gp1,age.gp2,age.gp3,age.gp4,black,white,other,Tr,NoTr,Trade,NoTrade,Group,NoGroup
0,1,1,black,age.gp3,NoTr,Trade,NoGroup,6,1,1,3,1,3,3,0,2,4,0,6,4,2
16,17,17,black,age.gp2,Tr,NoTrade,Group,16,0,8,6,2,8,8,0,5,11,2,14,12,4
1003,1004,1004,white,age.gp1,Tr,NoTrade,Group,21,12,4,2,3,1,12,8,5,16,3,18,11,10
1064,1065,1065,white,age.gp4,NoTr,NoTrade,Group,8,0,4,3,1,1,6,1,3,5,1,7,4,4
1391,1392,1392,black,age.gp3,NoTr,NoTrade,NoGroup,6,3,1,2,0,5,1,0,1,5,3,3,2,4
1395,1396,1396,black,age.gp3,NoTr,NoTrade,NoGroup,5,1,2,2,0,3,1,1,1,4,2,3,2,3
1867,1868,1868,white,age.gp3,NoTr,NoTrade,Group,22,1,5,10,6,3,18,1,6,16,4,18,16,6
1,2,2,black,age.gp3,NoTr,Trade,NoGroup,4,1,2,0,1,1,3,0,0,4,0,4,0,4
459,460,460,white,age.gp1,NoTr,NoTrade,NoGroup,12,5,3,2,2,2,8,2,4,8,2,10,5,7
780,781,781,white,age.gp2,NoTr,NoTrade,NoGroup,8,1,3,1,3,4,4,0,3,5,3,5,6,2
2025,2026,2026,black,age.gp4,NoTr,NoTrade,NoGroup,1,0,0,1,0,1,0,0,0,1,1,0,0,1
2315,2316,2316,white,age.gp2,NoTr,NoTrade,NoGroup,13,2,6,3,2,1,9,3,7,6,3,10,10,3
2,3,3,black,age.gp3,NoTr,Trade,NoGroup,7,1,2,2,2,2,5,0,4,3,0,7,4,3
92,93,93,white,age.gp3,NoTr,NoTrade,Group,17,4,2,9,2,2,14,1,6,11,3,14,10,7
245,246,246,white,age.gp2,Tr,NoTrade,Group,25,3,6,5,11,1,22,2,5,20,4,21,18,7
787,788,788,black,age.gp1,Tr,NoTrade,NoGroup,15,9,1,2,3,6,5,4,3,12,3,12,6,9
956,957,957,black,age.gp2,Tr,NoTrade,NoGroup,10,3,4,1,2,4,6,0,2,8,1,9,6,4
1337,1338,1338,white,age.gp3,NoTr,NoTrade,NoGroup,10,0,4,3,3,1,8,1,3,7,2,8,8,2
1953,1954,1954,white,age.gp4,NoTr,NoTrade,Group,7,2,1,1,3,1,6,0,1,6,1,6,1,6
2057,2058,2058,white,age.gp4,Tr,NoTrade,Group,12,2,1,3,6,2,8,2,4,8,2,10,5,7
3,4,4,black,age.gp3,NoTr,Trade,NoGroup,5,0,2,3,0,3,2,0,3,2,1,4,3,2
409,410,410,white,age.gp2,Tr,Trade,Group,22,2,7,12,1,4,16,2,7,15,2,20,13,9
515,516,516,black,age.gp3,NoTr,NoTrade,NoGroup,5,0,3,1,1,2,2,1,3,2,2,3,2,3
516,517,517,black,age.gp3,NoTr,NoTrade,NoGroup,6,0,4,2,0,3,2,1,4,2,1,5,3,3
1733,1734,1734,white,age.gp3,Tr,NoTrade,Group,23,4,10,5,4,4,17,2,4,19,5,18,16,7
2368,2369,2369,black,age.gp2,Tr,NoTrade,Group,22,4,5,8,5,11,11,0,8,14,2,20,4,18
4,5,5,black,age.gp3,NoTr,Trade,NoGroup,10,0,3,3,4,4,6,0,2,8,2,8,5,5
96,97,97,white,age.gp3,NoTr,NoTrade,Group,18,2,7,8,1,4,13,1,11,7,1,17,12,6
191,192,192,white,age.gp2,Tr,NoTrade,NoGroup,12,0,6,3,3,1,9,2,2,10,1,11,6,6
443,444,444,white,age.gp4,NoTr,NoTrade,NoGroup,7,0,3,3,1,2,5,0,3,4,1,6,6,1
471,472,472,black,age.gp3,NoTr,Trade,Group,12,2,4,5,1,5,4,3,3,9,1,11,7,5
479,480,480,black,age.gp4,NoTr,NoTrade,NoGroup,5,0,1,2,2,3,2,0,0,5,1,4,1,4
951,952,952,white,age.gp3,Tr,NoTrade,Group,19,2,8,6,3,5,11,3,6,13,1,18,11,8
1537,1538,1538,black,age.gp4,NoTr,NoTrade,NoGroup,8,0,4,3,1,4,3,1,3,5,2,6,6,2
2235,2236,2236,black,age.gp4,NoTr,Trade,Group,10,1,1,5,3,8,2,0,1,9,3,7,4,6
2661,2662,2662,white,age.gp2,NoTr,NoTrade,Group,29,1,14,8,6,5,23,1,13,16,3,26,22,7
2798,2799,2799,white,age.gp2,NoTr,NoTrade,NoGroup,10,0,4,2,4,1,8,1,5,5,1,9,7,3
5,6,6,black,age.gp3,NoTr,Trade,NoGroup,7,0,3,4,0,5,2,0,0,7,2,5,3,4
456,457,457,black,age.gp3,NoTr,NoTrade,NoGroup,3,0,1,2,0,2,1,0,1,2,1,2,1,2
1103,1104,1104,black,age.gp2,NoTr,NoTrade,NoGroup,6,2,1,3,0,5,1,0,2,4,4,2,3,3
2390,2391,2391,black,age.gp2,NoTr,NoTrade,NoGroup,9,0,3,4,2,7,2,0,1,8,2,7,3,6
2418,2419,2419,white,age.gp3,NoTr,Trade,Group,13,2,5,3,3,1,11,1,3,10,2,11,7,6
2423,2424,2424,white,age.gp3,NoTr,Trade,Group,17,3,5,6,3,3,12,2,2,15,1,16,9,8
2609,2610,2610,black,age.gp2,NoTr,NoTrade,Group,24,1,10,10,3,13,11,0,7,17,6,18,12,12
2731,2732,2732,black,age.gp3,NoTr,NoTrade,NoGroup,2,0,0,2,0,2,0,0,0,2,1,1,1,1
6,7,7,black,age.gp3,NoTr,Trade,NoGroup,9,2,2,5,0,4,4,1,1,8,3,6,5,4
181,182,182,white,age.gp3,Tr,NoTrade,NoGroup,14,3,5,2,4,1,9,4,4,10,2,12,6,8
467,468,468,black,age.gp3,NoTr,Trade,Group,12,2,3,4,3,7,3,2,1,11,3,9,8,4
639,640,640,other,age.gp1,NoTr,Trade,Group,6,2,0,2,2,1,5,0,0,6,2,4,2,4
2421,2422,2422,white,age.gp3,NoTr,Trade,Group,18,4,3,7,4,4,13,1,6,12,3,15,9,9
2756,2757,2757,white,age.gp3,NoTr,NoTrade,NoGroup,12,1,4,6,1,1,10,1,4,8,1,11,7,5
2834,2835,2835,black,age.gp2,NoTr,NoTrade,NoGroup,10,1,4,1,4,7,3,0,2,8,3,7,4,6
2852,2853,2853,black,age.gp3,NoTr,NoTrade,Group,15,1,3,7,4,7,7,1,2,13,2,13,7,8
2973,2974,2974,white,age.gp1,NoTr,NoTrade,Group,20,10,2,4,4,3,14,3,6,14,3,17,10,10
7,8,8,black,age.gp3,NoTr,Trade,NoGroup,4,1,2,1,0,4,0,0,2,2,0,4,3,1
15,16,16,black,age.gp2,Tr,NoTrade,Group,14,1,6,4,3,10,4,0,3,11,3,11,10,4
784,785,785,black,age.gp1,Tr,NoTrade,NoGroup,17,7,3,4,3,12,4,1,4,13,4,13,5,12
964,965,965,black,age.gp2,NoTr,NoTrade,Group,16,2,3,10,1,7,6,3,4,12,3,13,8,8
2853,2854,2854,black,age.gp3,NoTr,NoTrade,Group,14,2,5,4,3,6,7,1,3,11,1,13,9,5
8,9,9,black,age.gp3,NoTr,Trade,NoGroup,1,0,0,1,0,1,0,0,0,1,0,1,0,1
9,10,10,black,age.gp3,NoTr,Trade,NoGroup,3,1,2,0,0,2,0,1,1,2,0,3,2,1
18,19,19,black,age.gp2,Tr,NoTrade,Group,27,5,9,6,7,14,12,1,5,22,5,22,13,14
1415,1416,1416,black,age.gp2,NoTr,NoTrade,NoGroup,10,1,4,3,2,6,4,0,2,8,2,8,3,7
1870,1871,1871,other,age.gp1,NoTr,NoTrade,Group,11,4,3,3,1,1,10,0,5,6,3,8,7,4
10,11,11,black,age.gp3,NoTr,Trade,NoGroup,5,1,1,2,1,4,1,0,0,5,1,4,1,4
446,447,447,black,age.gp3,NoTr,NoTrade,NoGroup,7,1,1,3,2,5,2,0,1,6,1,6,3,4
887,888,888,white,age.gp3,NoTr,Trade,Group,13,1,4,4,4,2,11,0,4,9,1,12,11,2
1477,1478,1478,black,age.gp1,NoTr,NoTrade,NoGroup,6,3,0,2,1,2,3,1,3,3,1,5,1,5
1747,1748,1748,black,age.gp4,NoTr,NoTrade,NoGroup,6,0,1,2,3,2,4,0,2,4,1,5,2,4
2165,2166,2166,black,age.gp2,NoTr,NoTrade,NoGroup,7,1,4,1,1,3,2,2,1,6,1,6,4,3
11,12,12,black,age.gp3,NoTr,Trade,NoGroup,4,1,0,3,0,3,1,0,0,4,1,3,3,1
463,464,464,black,age.gp3,NoTr,Trade,Group,13,0,7,3,3,8,4,1,2,11,3,10,8,5
1452,1453,1453,black,age.gp1,NoTr,NoTrade,NoGroup,10,2,1,4,3,4,5,1,3,7,2,8,6,4
1859,1860,1860,white,age.gp3,NoTr,NoTrade,Group,12,0,5,5,2,1,10,1,3,9,2,10,9,3
2847,2848,2848,black,age.gp3,NoTr,NoTrade,Group,14,0,3,6,5,9,5,0,2,12,3,11,6,8
12,13,13,black,age.gp3,NoTr,Trade,NoGroup,1,0,1,0,0,1,0,0,0,1,0,1,0,1
227,228,228,black,age.gp2,NoTr,NoTrade,NoGroup,14,1,7,2,4,8,6,0,6,8,2,12,9,5
13,14,14,black,age.gp3,NoTr,Trade,NoGroup,3,1,0,1,1,3,0,0,1,2,2,1,1,2
464,465,465,black,age.gp3,NoTr,Trade,Group,15,0,5,5,5,10,5,0,4,11,1,14,6,9
1533,1534,1534,black,age.gp4,NoTr,NoTrade,NoGroup,7,0,2,2,3,5,2,0,2,5,1,6,2,5
1594,1595,1595,black,age.gp1,Tr,Trade,NoGroup,17,8,2,3,4,12,5,0,6,11,5,12,9,8
14,15,15,black,age.gp2,Tr,NoTrade,Group,20,4,9,5,2,14,6,0,5,15,5,15,12,8
17,18,18,black,age.gp2,Tr,NoTrade,Group,24,1,10,8,5,11,11,2,8,16,2,22,13,11
292,293,293,black,age.gp2,NoTr,NoTrade,Group,16,1,9,1,5,8,7,1,6,10,2,14,8,8
952,953,953,white,age.gp3,Tr,NoTrade,Group,20,2,6,3,9,5,15,0,5,15,1,19,14,6
1018,1019,1019,white,age.gp2,NoTr,Trade,Group,25,1,10,6,8,4,21,0,12,13,0,25,18,7
1087,1088,1088,black,age.gp2,Tr,NoTrade,NoGroup,5,0,2,3,0,4,1,0,1,4,0,5,3,2
1445,1446,1446,white,age.gp1,NoTr,NoTrade,NoGroup,12,4,4,1,3,2,9,1,5,7,1,11,7,5
1453,1454,1454,black,age.gp1,NoTr,NoTrade,NoGroup,16,6,4,4,2,9,5,2,3,13,2,14,7,9
1629,1630,1630,white,age.gp1,NoTr,NoTrade,NoGroup,9,2,3,2,2,2,5,2,2,7,0,9,7,2
2077,2078,2078,black,age.gp3,NoTr,NoTrade,NoGroup,6,1,1,3,1,5,1,0,1,5,2,4,4,2
2102,2103,2103,white,age.gp2,Tr,NoTrade,Group,31,2,18,5,6,2,21,8,13,18,0,31,20,11
2218,2219,2219,black,age.gp4,NoTr,Trade,Group,7,0,4,1,2,3,4,0,3,4,0,7,6,1
2227,2228,2228,black,age.gp4,NoTr,Trade,Group,5,1,1,0,3,2,3,0,1,4,1,4,4,1
2369,2370,2370,black,age.gp2,Tr,NoTrade,Group,20,1,11,3,5,13,7,0,5,15,2,18,12,8
2414,2415,2415,white,age.gp3,NoTr,Trade,Group,19,0,8,6,5,2,16,1,10,9,2,17,15,4
2516,2517,2517,black,age.gp2,NoTr,NoTrade,Group,17,2,8,4,3,10,6,1,2,15,1,16,12,5
2606,2607,2607,black,age.gp2,NoTr,NoTrade,Group,25,0,11,9,5,15,10,0,5,20,1,24,10,15
2656,2657,2657,black,age.gp1,NoTr,NoTrade,NoGroup,10,2,3,3,2,7,1,2,3,7,1,9,4,6
2764,2765,2765,black,age.gp2,NoTr,NoTrade,NoGroup,9,0,4,3,2,6,3,0,2,7,1,8,5,4
53,54,54,white,age.gp2,Tr,NoTrade,Group,27,2,14,11,0,4,20,3,14,13,4,23,22,5
230,231,231,white,age.gp2,Tr,NoTrade,Group,16,1,9,5,1,1,13,2,8,8,0,16,11,5
468,469,469,black,age.gp3,NoTr,Trade,Group,9,2,3,2,2,5,3,1,5,4,0,9,2,7
727,728,728,black,age.gp4,NoTr,NoTrade,NoGroup,5,1,2,1,1,3,1,1,1,4,0,5,2,3
1090,1091,1091,black,age.gp1,NoTr,NoTrade,NoGroup,5,2,1,2,0,2,2,1,1,4,0,5,2,3
1345,1346,1346,black,age.gp4,NoTr,NoTrade,Group,9,0,3,2,4,4,4,1,3,6,0,9,5,4
1364,1365,1365,black,age.gp4,NoTr,NoTrade,Group,10,0,4,2,4,6,4,0,5,5,2,8,5,5
1390,1391,1391,black,age.gp3,NoTr,NoTrade,NoGroup,4,1,1,1,1,2,2,0,2,2,1,3,3,1
1406,1407,1407,white,age.gp3,NoTr,NoTrade,Group,27,3,9,6,9,2,20,5,14,13,0,27,22,5
2209,2210,2210,black,age.gp2,NoTr,Trade,Group,26,0,15,6,5,15,11,0,11,15,3,23,20,6
2525,2526,2526,white,age.gp2,NoTr,NoTrade,Group,28,0,17,8,3,3,20,5,11,17,2,26,19,9
2607,2608,2608,black,age.gp2,NoTr,NoTrade,Group,15,2,4,4,5,9,5,1,4,11,2,13,8,7
142,143,143,white,age.gp3,NoTr,NoTrade,Group,21,2,9,4,6,2,15,4,10,11,2,19,16,5
662,663,663,white,age.gp2,NoTr,NoTrade,Group,24,3,11,6,4,2,20,2,10,14,0,24,17,7
965,966,966,black,age.gp2,NoTr,NoTrade,Group,16,1,8,5,2,7,7,2,6,10,2,14,9,7
1249,1250,1250,white,age.gp2,Tr,NoTrade,Group,36,3,21,3,9,6,22,8,16,20,0,36,22,14
1560,1561,1561,white,age.gp3,NoTr,NoTrade,Group,17,1,6,3,7,2,13,2,8,9,0,17,11,6
1587,1588,1588,white,age.gp4,Tr,NoTrade,Group,19,3,4,3,9,1,16,2,6,13,0,19,12,7
1718,1719,1719,white,age.gp2,NoTr,NoTrade,Group,27,3,10,11,3,3,21,3,12,15,0,27,18,9
1810,1811,1811,black,age.gp4,NoTr,NoTrade,NoGroup,1,0,1,0,0,1,0,0,1,0,0,1,1,0
2067,2068,2068,white,age.gp3,Tr,NoTrade,Group,23,2,6,9,6,3,17,3,11,12,2,21,13,10
2085,2086,2086,black,age.gp3,NoTr,NoTrade,NoGroup,9,1,5,3,0,6,2,1,3,6,0,9,4,5
2277,2278,2278,black,age.gp2,Tr,Trade,Group,18,0,11,4,3,6,10,2,7,11,1,17,13,5
2527,2528,2528,white,age.gp2,NoTr,NoTrade,Group,18,2,7,5,4,2,15,1,8,10,0,18,13,5
2850,2851,2851,black,age.gp3,NoTr,NoTrade,Group,18,2,8,5,3,9,6,3,2,16,3,15,9,9
137,138,138,white,age.gp2,NoTr,NoTrade,NoGroup,5,1,2,1,1,1,4,0,2,3,0,5,3,2
282,283,283,white,age.gp2,Tr,NoTrade,Group,19,1,10,5,3,2,13,4,9,10,2,17,11,8
405,406,406,black,age.gp4,NoTr,NoTrade,NoGroup,7,0,1,1,5,6,1,0,2,5,2,5,3,4
457,458,458,black,age.gp3,NoTr,NoTrade,NoGroup,4,0,1,3,0,4,0,0,1,3,0,4,2,2
474,475,475,black,age.gp3,NoTr,Trade,Group,8,0,3,3,2,5,3,0,3,5,1,7,3,5
660,661,661,white,age.gp2,NoTr,NoTrade,Group,29,1,15,6,7,3,25,1,18,11,1,28,24,5
862,863,863,other,age.gp2,Tr,NoTrade,Group,16,2,5,6,3,1,15,0,8,8,1,15,11,5
865,866,866,other,age.gp2,Tr,NoTrade,Group,13,2,5,4,2,2,11,0,6,7,2,11,12,1
967,968,968,white,age.gp2,Tr,NoTrade,Group,29,1,11,7,10,4,23,2,6,23,3,26,18,11
1014,1015,1015,white,age.gp1,NoTr,NoTrade,NoGroup,11,5,2,3,1,1,7,3,6,5,0,11,7,4
1294,1295,1295,white,age.gp4,NoTr,NoTrade,Group,7,1,2,1,3,3,4,0,2,5,0,7,4,3
1606,1607,1607,white,age.gp3,Tr,NoTrade,NoGroup,8,2,2,3,1,1,6,1,3,5,1,7,5,3
1749,1750,1750,black,age.gp4,NoTr,NoTrade,NoGroup,5,0,2,1,2,4,1,0,2,3,0,5,4,1
1827,1828,1828,black,age.gp4,NoTr,NoTrade,NoGroup,4,0,2,0,2,2,2,0,2,2,1,3,4,0
1851,1852,1852,black,age.gp3,NoTr,NoTrade,NoGroup,14,1,5,4,4,7,6,1,3,11,1,13,8,6
2064,2065,2065,white,age.gp3,Tr,NoTrade,Group,23,0,9,5,9,4,17,2,11,12,1,22,14,9
2385,2386,2386,white,age.gp2,Tr,NoTrade,Group,29,6,12,6,5,6,20,3,7,22,1,28,17,12
2407,2408,2408,white,age.gp3,NoTr,NoTrade,NoGroup,12,0,4,2,6,1,11,0,5,7,1,11,11,1
2505,2506,2506,black,age.gp2,NoTr,NoTrade,NoGroup,8,0,6,1,1,5,3,0,5,3,2,6,5,3
2745,2746,2746,white,age.gp2,NoTr,NoTrade,Group,16,1,10,3,2,1,12,3,5,11,1,15,11,5
2849,2850,2850,black,age.gp3,NoTr,NoTrade,Group,16,2,3,5,6,8,7,1,7,9,3,13,8,8
264,265,265,white,age.gp4,NoTr,NoTrade,NoGroup,5,1,1,1,2,2,3,0,2,3,0,5,4,1
293,294,294,black,age.gp2,NoTr,NoTrade,Group,19,2,11,5,1,11,8,0,8,11,2,17,13,6
433,434,434,white,age.gp4,NoTr,NoTrade,NoGroup,8,0,4,2,2,1,6,1,4,4,1,7,7,1
566,567,567,other,age.gp4,NoTr,NoTrade,NoGroup,4,0,2,0,2,2,2,0,3,1,1,3,4,0
706,707,707,white,age.gp2,NoTr,NoTrade,Group,22,2,9,9,2,1,18,3,9,13,1,21,12,10
1243,1244,1244,white,age.gp2,Tr,NoTrade,NoGroup,6,0,4,0,2,2,4,0,1,5,0,6,4,2
1259,1260,1260,black,age.gp3,NoTr,NoTrade,NoGroup,7,2,2,1,2,5,2,0,3,4,0,7,4,3
1352,1353,1353,black,age.gp4,NoTr,NoTrade,Group,6,0,2,1,3,4,2,0,2,4,0,6,3,3
1427,1428,1428,white,age.gp2,Tr,NoTrade,Group,29,3,17,5,4,2,23,4,15,14,1,28,22,7
1720,1721,1721,white,age.gp2,NoTr,NoTrade,Group,30,3,19,3,5,1,25,4,12,18,3,27,18,12
2228,2229,2229,black,age.gp4,NoTr,Trade,Group,9,2,3,2,2,5,4,0,4,5,0,9,5,4
2411,2412,2412,white,age.gp3,NoTr,Trade,Group,13,2,6,2,3,2,11,0,5,8,0,13,10,3
2458,2459,2459,black,age.gp1,NoTr,NoTrade,NoGroup,7,2,1,1,3,5,1,1,2,5,1,6,3,4
2460,2461,2461,black,age.gp1,NoTr,NoTrade,NoGroup,8,3,2,1,2,6,0,2,1,7,3,5,4,4
2654,2655,2655,black,age.gp1,NoTr,NoTrade,NoGroup,16,9,5,0,2,9,3,4,7,9,3,13,7,9
2677,2678,2678,black,age.gp3,NoTr,NoTrade,NoGroup,5,0,1,2,2,4,1,0,1,4,0,5,4,1
2681,2682,2682,black,age.gp3,NoTr,NoTrade,NoGroup,3,1,1,0,1,2,1,0,2,1,0,3,3,0
2715,2716,2716,white,age.gp4,NoTr,NoTrade,Group,7,0,3,1,3,1,6,0,5,2,0,7,5,2
2789,2790,2790,white,age.gp2,NoTr,NoTrade,Group,20,5,7,6,2,2,16,2,8,12,3,17,16,4
2838,2839,2839,black,age.gp2,NoTr,NoTrade,NoGroup,16,3,7,4,2,9,7,0,3,13,0,16,8,8
2864,2865,2865,white,age.gp2,Tr,NoTrade,Group,33,3,16,10,4,2,26,5,14,19,3,30,22,11
2887,2888,2888,white,age.gp1,NoTr,NoTrade,Group,35,16,7,5,7,4,21,10,14,21,4,31,19,16
19,20,20,black,age.gp4,NoTr,Trade,NoGroup,3,0,1,1,1,2,1,0,1,2,0,3,3,0
1936,1937,1937,white,age.gp4,NoTr,NoTrade,Group,9,1,0,2,6,3,6,0,2,7,1,8,6,3
2845,2846,2846,black,age.gp3,NoTr,NoTrade,Group,19,1,7,4,7,11,7,1,4,15,6,13,12,7
20,21,21,black,age.gp4,NoTr,Trade,NoGroup,5,0,2,1,2,3,1,1,1,4,2,3,5,0
466,467,467,black,age.gp3,NoTr,Trade,Group,17,2,5,7,3,6,9,2,4,13,2,15,5,12
869,870,870,other,age.gp2,Tr,NoTrade,Group,11,2,5,1,3,1,9,1,4,7,2,9,8,3
1373,1374,1374,black,age.gp4,NoTr,NoTrade,Group,12,0,4,4,4,8,4,0,4,8,1,11,7,5
2216,2217,2217,black,age.gp4,NoTr,Trade,Group,7,2,0,0,5,4,3,0,2,5,1,6,2,5
2659,2660,2660,white,age.gp2,NoTr,NoTrade,Group,25,1,9,9,6,3,19,3,8,17,3,22,16,9
21,22,22,black,age.gp4,NoTr,Trade,NoGroup,1,0,0,0,1,0,1,0,0,1,0,1,1,0
1071,1072,1072,white,age.gp4,NoTr,NoTrade,Group,12,0,4,4,4,1,11,0,5,7,2,10,8,4
22,23,23,black,age.gp4,NoTr,Trade,NoGroup,8,0,1,4,3,6,2,0,1,7,0,8,4,4
360,361,361,black,age.gp4,NoTr,NoTrade,NoGroup,4,0,0,0,4,3,1,0,0,4,1,3,2,2
396,397,397,black,age.gp4,NoTr,NoTrade,NoGroup,12,0,1,1,10,9,3,0,2,10,2,10,9,3
1401,1402,1402,white,age.gp3,NoTr,NoTrade,Group,20,4,8,4,4,3,16,1,8,12,3,17,13,7
1621,1622,1622,white,age.gp2,Tr,NoTrade,Group,24,2,11,2,9,2,19,3,8,16,5,19,15,9
1760,1761,1761,black,age.gp4,NoTr,NoTrade,NoGroup,4,0,2,0,2,4,0,0,1,3,2,2,2,2
2854,2855,2855,black,age.gp3,NoTr,NoTrade,Group,12,2,7,1,2,9,3,0,4,8,2,10,4,8
23,24,24,black,age.gp4,NoTr,Trade,NoGroup,3,0,3,0,0,2,1,0,0,3,1,2,2,1
2206,2207,2207,black,age.gp2,NoTr,Trade,Group,23,2,10,5,6,17,5,1,4,19,4,19,10,13
2319,2320,2320,white,age.gp2,NoTr,NoTrade,NoGroup,10,0,6,2,2,3,6,1,3,7,3,7,7,3
24,25,25,black,age.gp4,NoTr,Trade,NoGroup,3,0,0,3,0,2,1,0,0,3,0,3,2,1
2735,2736,2736,black,age.gp3,NoTr,NoTrade,NoGroup,11,0,8,1,2,7,4,0,4,7,1,10,7,4
25,26,26,black,age.gp4,NoTr,Trade,NoGroup,3,0,1,0,2,2,1,0,0,3,1,2,3,0
315,316,316,white,age.gp4,NoTr,NoTrade,Group,6,1,0,1,4,1,5,0,2,4,1,5,2,4
2219,2220,2220,black,age.gp4,NoTr,Trade,Group,10,1,0,2,7,7,2,1,1,9,4,6,5,5
2346,2347,2347,black,age.gp2,NoTr,NoTrade,Group,11,1,6,1,3,5,6,0,6,5,3,8,7,4
26,27,27,black,age.gp4,NoTr,Trade,NoGroup,4,0,2,1,1,1,2,1,2,2,0,4,2,2
226,227,227,black,age.gp2,NoTr,NoTrade,NoGroup,5,0,3,0,2,2,2,1,2,3,1,4,3,2
610,611,611,other,age.gp4,NoTr,NoTrade,NoGroup,7,2,1,2,2,3,4,0,4,3,2,5,4,3
947,948,948,white,age.gp3,Tr,NoTrade,Group,17,0,6,6,5,1,16,0,9,8,2,15,14,3
1321,1322,1322,white,age.gp2,Tr,NoTrade,Group,25,5,12,3,5,3,19,3,9,16,1,24,17,8
27,28,28,black,age.gp4,NoTr,Trade,NoGroup,4,0,1,0,3,2,2,0,1,3,0,4,3,1
505,506,506,black,age.gp4,NoTr,NoTrade,NoGroup,1,0,0,0,1,1,0,0,0,1,1,0,0,1
704,705,705,white,age.gp2,NoTr,NoTrade,Group,20,2,9,5,4,4,14,2,10,10,3,17,14,6
1354,1355,1355,black,age.gp4,NoTr,NoTrade,Group,10,0,4,1,5,8,2,0,2,8,2,8,5,5
1797,1798,1798,white,age.gp4,Tr,NoTrade,Group,9,1,1,2,5,2,7,0,3,6,1,8,6,3
28,29,29,black,age.gp4,NoTr,Trade,NoGroup,4,0,0,1,3,4,0,0,0,4,0,4,1,3
454,455,455,black,age.gp3,NoTr,NoTrade,NoGroup,4,1,2,0,1,3,0,1,1,3,1,3,2,2
504,505,505,black,age.gp4,NoTr,NoTrade,NoGroup,7,0,0,3,4,5,2,0,0,7,3,4,4,3
1363,1364,1364,black,age.gp4,NoTr,NoTrade,Group,8,2,3,1,2,2,5,1,1,7,3,5,6,2
1527,1528,1528,black,age.gp4,NoTr,NoTrade,NoGroup,4,1,0,1,2,1,3,0,2,2,1,3,2,2
29,30,30,black,age.gp4,NoTr,Trade,NoGroup,1,0,0,0,1,1,0,0,0,1,0,1,0,1
1529,1530,1530,black,age.gp4,NoTr,NoTrade,NoGroup,6,0,3,0,3,5,1,0,0,6,1,5,0,6
30,31,31,black,age.gp4,NoTr,Trade,NoGroup,1,0,0,0,1,1,0,0,0,1,0,1,0,1
1766,1767,1767,black,age.gp4,NoTr,NoTrade,NoGroup,9,0,1,4,4,7,2,0,1,8,2,7,5,4
31,32,32,black,age.gp4,NoTr,Trade,NoGroup,2,0,0,1,1,0,2,0,0,2,0,2,2,0
103,104,104,white,age.gp3,NoTr,NoTrade,Group,21,4,5,6,6,2,17,2,9,12,1,20,9,12
2952,2953,2953,white,age.gp4,NoTr,NoTrade,Group,8,2,2,2,2,1,6,1,3,5,1,7,6,2
32,33,33,black,age.gp4,NoTr,Trade,NoGroup,3,0,1,0,2,3,0,0,0,3,1,2,1,2
370,371,371,black,age.gp4,NoTr,NoTrade,NoGroup,2,0,0,0,2,1,1,0,0,2,1,1,1,1
1416,1417,1417,black,age.gp2,NoTr,NoTrade,NoGroup,8,1,2,2,3,7,1,0,2,6,1,7,2,6
2238,2239,2239,black,age.gp4,NoTr,Trade,Group,11,1,2,1,7,6,5,0,3,8,2,9,9,2
33,34,34,black,age.gp4,NoTr,Trade,NoGroup,4,0,1,1,2,0,4,0,3,1,0,4,4,0
1250,1251,1251,white,age.gp2,Tr,NoTrade,Group,28,3,16,0,9,3,23,2,10,18,2,26,19,9
1583,1584,1584,white,age.gp4,Tr,NoTrade,Group,11,1,4,2,4,2,8,1,4,7,3,8,8,3
2071,2072,2072,white,age.gp3,Tr,NoTrade,Group,16,0,3,3,10,2,14,0,5,11,1,15,11,5
2946,2947,2947,white,age.gp4,NoTr,NoTrade,Group,10,2,2,2,4,1,9,0,2,8,1,9,6,4
34,35,35,black,age.gp4,NoTr,Trade,NoGroup,2,1,0,0,1,0,2,0,1,1,0,2,1,1
1060,1061,1061,white,age.gp4,NoTr,NoTrade,Group,9,0,2,2,5,2,7,0,5,4,1,8,7,2
1722,1723,1723,white,age.gp1,Tr,NoTrade,NoGroup,20,9,3,2,6,3,12,5,5,15,3,17,10,10
35,36,36,black,age.gp4,NoTr,Trade,NoGroup,1,0,0,0,1,1,0,0,0,1,0,1,1,0
1358,1359,1359,black,age.gp4,NoTr,NoTrade,Group,22,1,4,10,7,13,8,1,4,18,1,21,9,13
36,37,37,black,age.gp4,NoTr,Trade,NoGroup,8,0,3,1,4,6,1,1,1,7,1,7,2,6
38,39,39,black,age.gp4,NoTr,Trade,NoGroup,1,0,0,0,1,1,0,0,0,1,1,0,0,1
1046,1047,1047,black,age.gp4,NoTr,NoTrade,NoGroup,8,0,1,1,6,6,2,0,1,7,2,6,4,4
1758,1759,1759,black,age.gp4,NoTr,NoTrade,NoGroup,1,0,0,0,1,1,0,0,0,1,1,0,0,1
1814,1815,1815,black,age.gp4,NoTr,NoTrade,NoGroup,6,0,1,1,4,4,1,1,1,5,1,5,2,4
2137,2138,2138,other,age.gp2,NoTr,NoTrade,NoGroup,4,0,2,1,1,2,2,0,1,3,1,3,2,2
2341,2342,2342,white,age.gp2,Tr,NoTrade,Group,18,1,13,2,2,3,14,1,8,10,4,14,9,9
2608,2609,2609,black,age.gp2,NoTr,NoTrade,Group,25,2,10,7,6,9,12,4,9,16,2,23,8,17
2730,2731,2731,black,age.gp3,NoTr,NoTrade,NoGroup,11,1,3,1,6,6,4,1,2,9,1,10,5,6
37,38,38,black,age.gp4,NoTr,Trade,NoGroup,1,0,0,0,1,1,0,0,0,1,0,1,0,1
493,494,494,black,age.gp4,NoTr,NoTrade,NoGroup,6,1,1,0,4,4,2,0,0,6,3,3,4,2
39,40,40,black,age.gp4,NoTr,Trade,NoGroup,6,1,3,1,1,2,4,0,1,5,2,4,3,3
411,412,412,white,age.gp2,Tr,Trade,Group,20,0,12,5,3,3,16,1,8,12,1,19,11,9
2124,2125,2125,white,age.gp3,NoTr,NoTrade,Group,22,3,10,3,6,1,19,2,7,15,2,20,16,6
2184,2185,2185,white,age.gp4,NoTr,NoTrade,NoGroup,4,0,1,0,3,1,2,1,2,2,1,3,2,2
2207,2208,2208,black,age.gp2,NoTr,Trade,Group,18,4,6,4,4,6,12,0,7,11,2,16,9,9
40,41,41,black,age.gp4,NoTr,Trade,NoGroup,1,0,1,0,0,1,0,0,0,1,0,1,1,0
2518,2519,2519,black,age.gp2,NoTr,NoTrade,Group,20,1,10,5,4,9,9,2,6,14,4,16,10,10
41,42,42,black,age.gp4,NoTr,Trade,NoGroup,1,0,0,0,1,0,1,0,1,0,0,1,1,0
2046,2047,2047,white,age.gp4,Tr,NoTrade,Group,13,1,3,2,7,2,9,2,4,9,1,12,10,3
42,43,43,black,age.gp4,NoTr,Trade,NoGroup,3,0,0,1,2,3,0,0,0,3,1,2,1,2
362,363,363,black,age.gp4,NoTr,NoTrade,NoGroup,8,0,0,1,7,5,3,0,2,6,1,7,4,4
523,524,524,black,age.gp3,NoTr,NoTrade,NoGroup,5,0,1,3,1,4,1,0,1,4,1,4,4,1
2223,2224,2224,black,age.gp4,NoTr,Trade,Group,9,0,2,2,5,4,5,0,4,5,1,8,3,6
43,44,44,black,age.gp4,NoTr,Trade,NoGroup,1,0,0,0,1,0,1,0,0,1,0,1,1,0
60,61,61,white,age.gp4,NoTr,NoTrade,Group,14,1,4,1,8,3,10,1,4,10,1,13,7,7
44,45,45,black,age.gp4,NoTr,Trade,NoGroup,3,0,0,1,2,2,1,0,0,3,2,1,2,1
882,883,883,white,age.gp3,NoTr,Trade,Group,10,0,3,3,4,1,9,0,3,7,3,7,6,4
2213,2214,2214,black,age.gp4,NoTr,Trade,Group,14,0,5,3,6,7,6,1,1,13,3,11,6,8
45,46,46,black,age.gp4,NoTr,Trade,NoGroup,1,1,0,0,0,0,0,1,0,1,0,1,1,0
1875,1876,1876,other,age.gp1,NoTr,NoTrade,Group,6,1,2,0,3,1,5,0,5,1,1,5,2,4
46,47,47,black,age.gp4,NoTr,Trade,NoGroup,11,2,1,2,6,5,5,1,5,6,2,9,7,4
243,244,244,white,age.gp2,Tr,NoTrade,Group,24,4,12,3,5,2,21,1,9,15,4,20,12,12
517,518,518,black,age.gp3,NoTr,NoTrade,NoGroup,8,2,2,1,3,5,1,2,1,7,1,7,1,7
899,900,900,other,age.gp1,Tr,NoTrade,NoGroup,3,0,1,0,2,1,2,0,1,2,1,2,2,1
1231,1232,1232,white,age.gp4,NoTr,NoTrade,NoGroup,9,0,1,1,7,2,7,0,4,5,2,7,7,2
1361,1362,1362,black,age.gp4,NoTr,NoTrade,Group,6,1,0,1,4,3,3,0,1,5,2,4,4,2
1520,1521,1521,black,age.gp4,NoTr,NoTrade,NoGroup,7,1,0,2,4,6,1,0,1,6,2,5,1,6
1669,1670,1670,black,age.gp1,Tr,Trade,Group,12,7,1,2,2,6,4,2,4,8,4,8,4,8
1789,1790,1790,white,age.gp4,Tr,NoTrade,Group,11,2,3,1,5,1,10,0,3,8,1,10,3,8
2123,2124,2124,white,age.gp3,NoTr,NoTrade,Group,19,2,5,7,5,3,15,1,8,11,4,15,10,9
2253,2254,2254,white,age.gp4,Tr,NoTrade,Group,16,1,1,2,12,2,13,1,5,11,1,15,10,6
47,48,48,black,age.gp4,NoTr,Trade,NoGroup,2,1,0,0,1,1,1,0,0,2,0,2,0,2
714,715,715,black,age.gp4,NoTr,NoTrade,NoGroup,9,0,4,2,3,3,4,2,5,4,1,8,4,5
1625,1626,1626,white,age.gp1,NoTr,NoTrade,NoGroup,12,4,4,2,2,3,8,1,6,6,2,10,7,5
48,49,49,black,age.gp4,NoTr,Trade,NoGroup,3,0,2,1,0,1,2,0,0,3,0,3,2,1
921,922,922,white,age.gp2,NoTr,NoTrade,NoGroup,8,1,2,3,2,2,6,0,1,7,1,7,2,6
1553,1554,1554,white,age.gp3,NoTr,NoTrade,Group,15,0,7,3,5,2,12,1,4,11,1,14,8,7
49,50,50,white,age.gp2,Tr,NoTrade,Group,29,4,12,8,5,2,26,1,8,21,3,26,21,8
57,58,58,black,age.gp2,NoTr,NoTrade,NoGroup,10,0,6,3,1,5,4,1,5,5,2,8,7,3
99,100,100,white,age.gp3,NoTr,NoTrade,Group,10,2,3,4,1,1,8,1,2,8,0,10,7,3
156,157,157,white,age.gp1,NoTr,NoTrade,Group,25,13,4,5,3,1,20,4,5,20,3,22,12,13
820,821,821,white,age.gp4,NoTr,NoTrade,NoGroup,5,0,2,0,3,1,3,1,4,1,0,5,4,1
867,868,868,other,age.gp2,Tr,NoTrade,Group,15,0,3,7,5,2,13,0,3,12,2,13,10,5
1022,1023,1023,white,age.gp2,NoTr,Trade,Group,19,0,7,10,2,1,16,2,7,12,0,19,10,9
1097,1098,1098,white,age.gp2,NoTr,NoTrade,Group,36,1,19,10,6,2,32,2,23,13,1,35,25,11
1136,1137,1137,white,age.gp2,Tr,NoTrade,Group,22,1,12,4,5,1,19,2,7,15,1,21,16,6
1257,1258,1258,white,age.gp1,Tr,Trade,Group,26,11,6,5,4,3,17,6,6,20,2,24,15,11
1301,1302,1302,white,age.gp4,NoTr,NoTrade,Group,12,1,4,3,4,2,10,0,4,8,1,11,8,4
1327,1328,1328,white,age.gp3,NoTr,NoTrade,NoGroup,11,2,5,2,2,1,10,0,6,5,1,10,9,2
1442,1443,1443,white,age.gp3,Tr,NoTrade,NoGroup,15,2,8,1,4,0,13,2,5,10,1,14,10,5
1468,1469,1469,white,age.gp2,NoTr,Trade,Group,14,2,7,3,2,1,12,1,8,6,2,12,10,4
1618,1619,1619,white,age.gp2,Tr,NoTrade,Group,25,3,10,6,6,3,21,1,9,16,1,24,17,8
1623,1624,1624,white,age.gp1,NoTr,NoTrade,NoGroup,15,5,3,5,2,1,11,3,3,12,2,13,11,4
1804,1805,1805,white,age.gp2,Tr,NoTrade,Group,26,3,12,7,4,1,21,4,11,15,0,26,16,10
1863,1864,1864,white,age.gp3,NoTr,NoTrade,Group,14,4,5,2,3,0,14,0,6,8,1,13,7,7
2073,2074,2074,white,age.gp3,Tr,NoTrade,Group,18,0,6,7,5,1,16,1,6,12,0,18,15,3
2169,2170,2170,white,age.gp2,NoTr,NoTrade,Group,27,3,13,4,7,5,20,2,9,18,2,25,16,11
2172,2173,2173,white,age.gp2,NoTr,NoTrade,Group,24,2,11,10,1,3,18,3,10,14,0,24,18,6
2311,2312,2312,white,age.gp2,Tr,NoTrade,NoGroup,12,1,8,1,2,1,7,4,5,7,1,11,6,6
2526,2527,2527,white,age.gp2,NoTr,NoTrade,Group,26,3,13,3,7,2,22,2,13,13,3,23,18,8
2586,2587,2587,white,age.gp4,NoTr,NoTrade,Group,12,0,1,1,10,1,11,0,1,11,1,11,9,3
2593,2594,2594,white,age.gp3,NoTr,NoTrade,Group,19,1,11,2,5,1,16,2,12,7,0,19,14,5
2689,2690,2690,black,age.gp3,NoTr,NoTrade,NoGroup,12,1,3,2,6,7,2,3,2,10,2,10,6,6
2698,2699,2699,white,age.gp4,NoTr,NoTrade,Group,12,1,3,2,6,2,10,0,4,8,1,11,6,6
2749,2750,2750,white,age.gp3,NoTr,NoTrade,NoGroup,9,2,4,0,3,0,7,2,5,4,2,7,9,0
2884,2885,2885,white,age.gp1,NoTr,NoTrade,Group,16,5,5,1,5,1,11,4,6,10,1,15,9,7
50,51,51,white,age.gp2,Tr,NoTrade,Group,18,2,6,6,4,2,14,2,7,11,3,15,15,3
80,81,81,white,age.gp4,NoTr,NoTrade,Group,10,1,2,1,6,0,9,1,5,5,0,10,7,3
95,96,96,white,age.gp3,NoTr,NoTrade,Group,18,3,8,2,5,2,16,0,8,10,1,17,11,7
281,282,282,white,age.gp2,Tr,NoTrade,Group,21,1,11,6,3,0,19,2,6,15,2,19,14,7
328,329,329,white,age.gp1,NoTr,NoTrade,NoGroup,3,1,2,0,0,0,3,0,1,2,0,3,2,1
1286,1287,1287,white,age.gp4,NoTr,NoTrade,Group,14,0,4,3,7,1,11,2,3,11,1,13,5,9
1421,1422,1422,white,age.gp2,NoTr,NoTrade,Group,19,4,8,5,2,0,17,2,8,11,5,14,14,5
1430,1431,1431,white,age.gp3,Tr,NoTrade,NoGroup,12,1,7,2,2,0,11,1,5,7,0,12,10,2
1467,1468,1468,white,age.gp2,NoTr,Trade,Group,23,3,11,4,5,1,18,4,10,13,0,23,15,8
1588,1589,1589,white,age.gp4,Tr,NoTrade,Group,6,1,3,1,1,0,5,1,2,4,2,4,4,2
2301,2302,2302,other,age.gp2,Tr,NoTrade,Group,11,1,5,3,2,0,11,0,4,7,2,9,9,2
2338,2339,2339,white,age.gp3,Tr,NoTrade,Group,20,1,9,7,3,2,16,2,9,11,1,19,16,4
2739,2740,2740,white,age.gp2,Tr,NoTrade,Group,24,1,18,3,2,2,16,6,8,16,2,22,14,10
2855,2856,2856,black,age.gp3,NoTr,NoTrade,Group,19,1,7,5,6,10,8,1,4,15,0,19,11,8
2913,2914,2914,other,age.gp1,NoTr,NoTrade,NoGroup,7,3,2,2,0,1,5,1,2,5,2,5,3,4
51,52,52,white,age.gp2,Tr,NoTrade,Group,27,2,16,4,5,1,20,6,12,15,2,25,16,11
140,141,141,white,age.gp2,NoTr,NoTrade,NoGroup,10,0,8,1,1,1,7,2,4,6,2,8,7,3
234,235,235,white,age.gp2,Tr,NoTrade,Group,25,3,14,5,3,1,20,4,12,13,2,23,19,6
242,243,243,white,age.gp2,Tr,NoTrade,Group,28,3,9,8,8,4,21,3,8,20,2,26,17,11
246,247,247,white,age.gp2,Tr,NoTrade,Group,19,2,9,5,3,0,15,4,11,8,2,17,12,7
344,345,345,white,age.gp2,NoTr,NoTrade,Group,30,3,13,11,3,2,26,2,16,14,2,28,19,11
445,446,446,black,age.gp3,NoTr,NoTrade,NoGroup,10,0,4,3,3,7,3,0,3,7,1,9,4,6
663,664,664,white,age.gp2,NoTr,NoTrade,Group,30,4,12,7,7,4,22,4,10,20,2,28,20,10
841,842,842,white,age.gp2,Tr,NoTrade,NoGroup,12,0,7,4,1,0,12,0,5,7,0,12,10,2
847,848,848,other,age.gp2,Tr,NoTrade,Group,13,1,5,1,6,1,12,0,5,8,1,12,8,5
873,874,874,white,age.gp3,NoTr,Trade,Group,19,2,9,4,4,0,19,0,8,11,1,18,12,7
911,912,912,other,age.gp1,Tr,NoTrade,NoGroup,5,0,2,3,0,0,5,0,3,2,0,5,4,1
1098,1099,1099,white,age.gp2,NoTr,NoTrade,Group,19,4,10,2,3,2,15,2,10,9,0,19,13,6
1226,1227,1227,white,age.gp4,NoTr,NoTrade,NoGroup,6,0,2,0,4,0,6,0,4,2,1,5,3,3
1562,1563,1563,white,age.gp4,Tr,NoTrade,Group,8,2,3,1,2,1,5,2,4,4,0,8,4,4
1731,1732,1732,white,age.gp3,Tr,NoTrade,Group,24,2,12,4,6,2,21,1,10,14,3,21,18,6
1907,1908,1908,other,age.gp2,NoTr,NoTrade,NoGroup,4,1,2,1,0,1,3,0,1,3,0,4,3,1
2029,2030,2030,white,age.gp4,Tr,NoTrade,Group,10,1,4,0,5,1,9,0,3,7,0,10,7,3
2058,2059,2059,white,age.gp4,Tr,NoTrade,Group,16,1,4,2,9,1,14,1,7,9,2,14,11,5
2290,2291,2291,other,age.gp2,Tr,NoTrade,Group,13,0,8,3,2,0,13,0,8,5,0,13,11,2
2305,2306,2306,white,age.gp2,NoTr,NoTrade,NoGroup,12,0,5,5,2,1,10,1,4,8,1,11,10,2
2416,2417,2417,white,age.gp3,NoTr,Trade,Group,24,4,6,8,6,0,23,1,8,16,2,22,16,8
2645,2646,2646,white,age.gp1,NoTr,NoTrade,NoGroup,8,6,1,1,0,0,8,0,2,6,1,7,4,4
2658,2659,2659,white,age.gp2,NoTr,NoTrade,Group,24,1,14,6,3,2,20,2,13,11,1,23,16,8
2809,2810,2810,other,age.gp2,NoTr,NoTrade,NoGroup,3,0,2,0,1,0,3,0,3,0,0,3,3,0
2819,2820,2820,other,age.gp2,NoTr,NoTrade,NoGroup,6,0,4,2,0,0,6,0,3,3,0,6,5,1
2879,2880,2880,white,age.gp2,NoTr,NoTrade,NoGroup,14,0,10,3,1,2,11,1,10,4,1,13,13,1
52,53,53,white,age.gp2,Tr,NoTrade,Group,20,1,7,7,5,2,16,2,7,13,4,16,16,4
470,471,471,black,age.gp3,NoTr,Trade,Group,18,0,6,5,7,10,7,1,6,12,1,17,12,6
711,712,712,white,age.gp2,Tr,NoTrade,Group,17,1,7,8,1,2,14,1,7,10,3,14,10,7
768,769,769,white,age.gp4,NoTr,NoTrade,NoGroup,8,0,3,1,4,1,7,0,1,7,1,7,7,1
857,858,858,other,age.gp2,Tr,NoTrade,Group,10,0,7,1,2,2,8,0,4,6,1,9,4,6
941,942,942,white,age.gp3,Tr,NoTrade,Group,20,2,7,6,5,1,18,1,4,16,2,18,16,4
1383,1384,1384,white,age.gp1,NoTr,NoTrade,NoGroup,15,10,4,1,0,2,11,2,7,8,2,13,6,9
1547,1548,1548,white,age.gp3,NoTr,NoTrade,Group,22,4,8,7,3,3,18,1,12,10,4,18,14,8
1717,1718,1718,white,age.gp2,NoTr,NoTrade,Group,21,1,9,8,3,1,20,0,8,13,0,21,15,6
1918,1919,1919,other,age.gp2,NoTr,NoTrade,NoGroup,6,0,3,0,3,0,6,0,3,3,0,6,4,2
1948,1949,1949,white,age.gp4,NoTr,NoTrade,Group,14,1,3,2,8,1,12,1,3,11,1,13,11,3
2162,2163,2163,white,age.gp2,Tr,NoTrade,NoGroup,12,2,8,1,1,2,9,1,4,8,1,11,6,6
2208,2209,2209,black,age.gp2,NoTr,Trade,Group,10,0,6,1,3,7,3,0,2,8,0,10,6,4
2247,2248,2248,white,age.gp4,Tr,NoTrade,Group,7,0,2,1,4,1,6,0,2,5,0,7,5,2
2331,2332,2332,white,age.gp3,Tr,NoTrade,Group,23,2,7,8,6,6,15,2,12,11,3,20,15,8
2596,2597,2597,white,age.gp3,NoTr,NoTrade,Group,18,0,8,6,4,2,16,0,8,10,3,15,16,2
2696,2697,2697,white,age.gp4,NoTr,NoTrade,Group,10,0,5,1,4,4,5,1,5,5,0,10,7,3
2716,2717,2717,white,age.gp4,NoTr,NoTrade,Group,13,2,2,3,6,2,10,1,5,8,1,12,11,2
244,245,245,white,age.gp2,Tr,NoTrade,Group,23,1,8,9,5,3,17,3,8,15,2,21,18,5
280,281,281,white,age.gp2,Tr,NoTrade,Group,27,2,12,8,5,3,23,1,13,14,2,25,19,8
878,879,879,white,age.gp3,NoTr,Trade,Group,15,0,8,3,4,1,12,2,8,7,0,15,11,4
881,882,882,white,age.gp3,NoTr,Trade,Group,20,1,7,4,8,1,16,3,10,10,1,19,14,6
883,884,884,white,age.gp3,NoTr,Trade,Group,19,1,8,5,5,0,18,1,11,8,0,19,15,4
926,927,927,white,age.gp3,NoTr,NoTrade,NoGroup,6,1,3,1,1,1,4,1,4,2,0,6,5,1
1120,1121,1121,other,age.gp1,NoTr,NoTrade,NoGroup,4,2,2,0,0,1,3,0,3,1,1,3,4,0
1135,1136,1136,white,age.gp2,Tr,NoTrade,Group,36,3,16,10,7,7,25,4,15,21,3,33,21,15
1668,1669,1669,black,age.gp1,Tr,Trade,Group,14,5,4,2,3,5,8,1,3,11,1,13,4,10
1738,1739,1739,white,age.gp3,Tr,NoTrade,Group,24,4,11,5,4,4,17,3,8,16,2,22,14,10
1740,1741,1741,white,age.gp3,Tr,NoTrade,Group,19,2,11,4,2,1,15,3,11,8,1,18,13,6
2303,2304,2304,other,age.gp2,Tr,NoTrade,Group,10,1,5,1,3,2,8,0,6,4,0,10,7,3
2345,2346,2346,black,age.gp2,NoTr,NoTrade,Group,14,1,5,6,2,9,5,0,4,10,1,13,7,7
2409,2410,2410,white,age.gp3,NoTr,NoTrade,NoGroup,6,1,3,0,2,1,4,1,2,4,0,6,4,2
2520,2521,2521,white,age.gp2,Tr,NoTrade,Group,30,3,15,7,5,2,24,4,13,17,2,28,19,11
2594,2595,2595,white,age.gp3,NoTr,NoTrade,Group,11,0,4,2,5,1,9,1,4,7,0,11,4,7
2599,2600,2600,white,age.gp3,NoTr,NoTrade,Group,25,1,14,4,6,4,19,2,10,15,0,25,18,7
2741,2742,2742,white,age.gp2,Tr,NoTrade,Group,17,2,5,8,2,2,11,4,6,11,1,16,10,7
2797,2798,2798,white,age.gp2,NoTr,NoTrade,NoGroup,7,1,5,1,0,0,5,2,5,2,0,7,4,3
2953,2954,2954,white,age.gp2,Tr,NoTrade,Group,21,3,14,2,2,2,15,4,9,12,0,21,11,10
2972,2973,2973,white,age.gp2,NoTr,NoTrade,Group,25,2,19,3,1,1,16,8,13,12,2,23,18,7
54,55,55,black,age.gp2,NoTr,NoTrade,NoGroup,8,1,3,3,1,3,4,1,4,4,1,7,4,4
299,300,300,white,age.gp4,NoTr,NoTrade,Group,13,0,4,1,8,1,10,2,3,10,0,13,7,6
833,834,834,white,age.gp3,NoTr,NoTrade,NoGroup,8,0,3,2,3,1,7,0,2,6,1,7,6,2
963,964,964,black,age.gp2,NoTr,NoTrade,Group,18,5,5,2,6,9,5,4,4,14,2,16,10,8
1432,1433,1433,white,age.gp3,Tr,NoTrade,NoGroup,10,2,1,2,5,1,8,1,2,8,0,10,5,5
2160,2161,2161,white,age.gp2,Tr,NoTrade,NoGroup,17,1,11,2,3,3,11,3,4,13,1,16,10,7
2283,2284,2284,other,age.gp2,Tr,NoTrade,Group,10,0,7,0,3,1,9,0,4,6,2,8,7,3
2679,2680,2680,black,age.gp3,NoTr,NoTrade,NoGroup,6,1,3,2,0,3,1,2,2,4,1,5,4,2
55,56,56,black,age.gp2,NoTr,NoTrade,NoGroup,14,1,6,6,1,5,8,1,4,10,2,12,10,4
115,116,116,white,age.gp3,NoTr,NoTrade,NoGroup,5,0,1,1,3,1,4,0,2,3,1,4,4,1
247,248,248,white,age.gp2,Tr,NoTrade,Group,27,3,16,4,4,3,20,4,12,15,3,24,19,8
336,337,337,white,age.gp2,Tr,NoTrade,NoGroup,14,0,8,5,1,1,11,2,5,9,2,12,10,4
473,474,474,black,age.gp3,NoTr,Trade,Group,12,1,4,6,1,6,5,1,2,10,0,12,6,6
637,638,638,other,age.gp1,NoTr,Trade,Group,7,4,2,1,0,2,5,0,2,5,1,6,4,3
1556,1557,1557,white,age.gp3,NoTr,NoTrade,Group,14,2,4,5,3,1,13,0,5,9,1,13,12,2
2387,2388,2388,white,age.gp2,Tr,NoTrade,Group,18,1,10,3,4,1,15,2,5,13,2,16,13,5
2705,2706,2706,white,age.gp4,NoTr,NoTrade,Group,12,1,2,3,6,2,9,1,4,8,0,12,9,3
2958,2959,2959,white,age.gp2,NoTr,NoTrade,Group,24,4,13,3,4,1,22,1,16,8,2,22,17,7
56,57,57,black,age.gp2,NoTr,NoTrade,NoGroup,5,1,1,2,1,3,2,0,1,4,0,5,1,4
225,226,226,black,age.gp2,NoTr,NoTrade,NoGroup,6,0,4,0,2,6,0,0,0,6,0,6,2,4
402,403,403,black,age.gp4,NoTr,NoTrade,NoGroup,7,3,2,2,0,4,2,1,1,6,2,5,4,3
955,956,956,white,age.gp3,Tr,NoTrade,Group,21,4,7,5,5,1,18,2,7,14,0,21,13,8
1261,1262,1262,black,age.gp3,NoTr,NoTrade,NoGroup,9,2,2,3,2,5,4,0,3,6,2,7,4,5
1630,1631,1631,white,age.gp1,NoTr,NoTrade,NoGroup,11,4,4,2,1,1,7,3,4,7,0,11,6,5
864,865,865,other,age.gp2,Tr,NoTrade,Group,12,0,3,5,4,3,9,0,4,8,1,11,7,5
1386,1387,1387,black,age.gp3,NoTr,NoTrade,NoGroup,10,1,4,4,1,9,1,0,1,9,2,8,5,5
2039,2040,2040,white,age.gp4,Tr,NoTrade,Group,11,0,2,0,9,3,8,0,4,7,1,10,5,6
2365,2366,2366,black,age.gp2,Tr,NoTrade,Group,21,0,7,9,5,10,10,1,7,14,1,20,10,11
2366,2367,2367,black,age.gp2,Tr,NoTrade,Group,16,2,7,5,2,8,7,1,5,11,0,16,8,8
2408,2409,2409,white,age.gp3,NoTr,NoTrade,NoGroup,5,1,2,1,1,1,3,1,4,1,0,5,3,2
58,59,59,black,age.gp2,NoTr,NoTrade,NoGroup,7,0,3,1,3,7,0,0,1,6,1,6,5,2
350,351,351,black,age.gp4,NoTr,NoTrade,NoGroup,4,0,1,1,2,3,1,0,0,4,1,3,3,1
453,454,454,black,age.gp3,NoTr,NoTrade,NoGroup,10,0,3,5,2,8,1,1,0,10,1,9,2,8
1368,1369,1369,black,age.gp4,NoTr,NoTrade,Group,6,1,1,2,2,2,3,1,0,6,1,5,4,2
2236,2237,2237,black,age.gp4,NoTr,Trade,Group,5,0,1,1,3,2,3,0,0,5,0,5,2,3
2349,2350,2350,black,age.gp2,NoTr,NoTrade,Group,23,1,12,6,4,13,9,1,5,18,1,22,13,10
59,60,60,white,age.gp4,NoTr,NoTrade,Group,14,1,2,2,9,1,13,0,3,11,1,13,8,6
62,63,63,white,age.gp4,NoTr,NoTrade,Group,14,0,0,4,10,3,11,0,1,13,3,11,9,5
692,693,693,white,age.gp4,Tr,NoTrade,Group,21,0,1,5,15,1,20,0,10,11,0,21,15,6
721,722,722,black,age.gp4,NoTr,NoTrade,NoGroup,5,1,1,0,3,1,4,0,1,4,0,5,3,2
1295,1296,1296,white,age.gp4,NoTr,NoTrade,Group,8,1,4,1,2,1,5,2,2,6,0,8,5,3
1300,1301,1301,white,age.gp4,NoTr,NoTrade,Group,10,0,2,0,8,2,8,0,3,7,2,8,9,1
2041,2042,2042,white,age.gp4,Tr,NoTrade,Group,13,0,5,3,5,1,12,0,5,8,0,13,9,4
2318,2319,2319,white,age.gp2,NoTr,NoTrade,NoGroup,12,1,4,4,3,0,12,0,8,4,1,11,9,3
2592,2593,2593,white,age.gp3,NoTr,NoTrade,Group,25,3,11,3,8,0,24,1,12,13,3,22,18,7
2613,2614,2614,white,age.gp4,NoTr,NoTrade,NoGroup,3,0,0,0,3,1,2,0,0,3,0,3,2,1
2614,2615,2615,white,age.gp4,NoTr,NoTrade,NoGroup,4,0,2,0,2,0,4,0,1,3,1,3,4,0
2869,2870,2870,white,age.gp1,NoTr,NoTrade,Group,28,21,2,2,3,3,18,7,5,23,4,24,15,13
70,71,71,white,age.gp4,NoTr,NoTrade,Group,7,0,1,3,3,1,6,0,3,4,1,6,6,1
75,76,76,white,age.gp4,NoTr,NoTrade,Group,10,1,3,1,5,0,9,1,5,5,0,10,7,3
82,83,83,white,age.gp4,NoTr,NoTrade,Group,12,0,1,0,11,0,12,0,3,9,0,12,9,3
107,108,108,white,age.gp2,NoTr,NoTrade,NoGroup,13,2,5,2,4,0,13,0,6,7,0,13,9,4
670,671,671,white,age.gp4,Tr,NoTrade,Group,12,0,3,0,9,1,11,0,4,8,1,11,8,4
742,743,743,white,age.gp2,Tr,NoTrade,Group,24,2,11,3,8,3,18,3,10,14,2,22,15,9
1125,1126,1126,other,age.gp1,NoTr,NoTrade,NoGroup,5,0,2,0,3,0,5,0,3,2,0,5,5,0
1167,1168,1168,white,age.gp4,NoTr,NoTrade,NoGroup,6,0,1,2,3,1,5,0,2,4,1,5,5,1
1271,1272,1272,black,age.gp3,NoTr,NoTrade,NoGroup,9,0,4,2,3,2,7,0,2,7,0,9,9,0
1673,1674,1674,white,age.gp2,Tr,NoTrade,NoGroup,7,0,4,1,2,1,5,1,3,4,1,6,5,2
2028,2029,2029,white,age.gp4,Tr,NoTrade,Group,15,1,3,2,9,1,14,0,4,11,0,15,9,6
2509,2510,2510,black,age.gp2,NoTr,NoTrade,NoGroup,10,0,7,1,2,5,5,0,3,7,0,10,5,5
2579,2580,2580,white,age.gp4,NoTr,NoTrade,Group,10,4,0,1,5,2,7,1,2,8,1,9,5,5
61,62,62,white,age.gp4,NoTr,NoTrade,Group,13,1,4,1,7,1,12,0,2,11,1,12,11,2
312,313,313,white,age.gp4,NoTr,NoTrade,Group,7,0,1,3,3,0,6,1,4,3,0,7,4,3
313,314,314,white,age.gp4,NoTr,NoTrade,Group,10,0,3,2,5,0,10,0,5,5,0,10,9,1
321,322,322,white,age.gp4,NoTr,NoTrade,Group,3,0,1,0,2,0,3,0,1,2,0,3,2,1
1304,1305,1305,white,age.gp4,NoTr,NoTrade,Group,10,1,1,2,6,0,10,0,3,7,1,9,8,2
1933,1934,1934,white,age.gp4,NoTr,NoTrade,Group,10,2,3,2,3,0,10,0,3,7,0,10,5,5
1958,1959,1959,white,age.gp4,NoTr,NoTrade,Group,13,0,4,0,9,1,12,0,11,2,1,12,11,2
2454,2455,2455,white,age.gp4,NoTr,NoTrade,NoGroup,3,0,1,0,2,0,3,0,0,3,0,3,2,1
2473,2474,2474,white,age.gp2,Tr,NoTrade,Group,20,6,10,1,3,1,15,4,7,13,2,18,8,12
2790,2791,2791,white,age.gp2,NoTr,NoTrade,Group,17,1,10,4,2,0,17,0,9,8,2,15,12,5
2843,2844,2844,white,age.gp2,Tr,NoTrade,Group,25,2,12,6,5,2,22,1,11,14,2,23,17,8
2977,2978,2978,white,age.gp1,NoTr,NoTrade,Group,25,13,3,5,4,2,19,4,7,18,0,25,16,9
314,315,315,white,age.gp4,NoTr,NoTrade,Group,11,0,3,2,6,2,9,0,4,7,2,9,7,4
874,875,875,white,age.gp3,NoTr,Trade,Group,12,2,6,0,4,0,11,1,5,7,1,11,6,6
1262,1263,1263,black,age.gp3,NoTr,NoTrade,NoGroup,9,0,3,3,3,5,4,0,2,7,1,8,8,1
1292,1293,1293,white,age.gp4,NoTr,NoTrade,Group,16,2,1,2,11,1,14,1,5,11,1,15,8,8
1499,1500,1500,white,age.gp4,NoTr,NoTrade,NoGroup,3,0,1,0,2,0,3,0,1,2,0,3,3,0
1510,1511,1511,white,age.gp4,NoTr,NoTrade,NoGroup,4,0,0,0,4,0,4,0,2,2,0,4,4,0
1534,1535,1535,black,age.gp4,NoTr,NoTrade,NoGroup,1,0,0,0,1,0,1,0,0,1,0,1,1,0
2250,2251,2251,white,age.gp4,Tr,NoTrade,Group,10,0,6,1,3,0,10,0,4,6,0,10,6,4
2675,2676,2676,white,age.gp3,NoTr,NoTrade,NoGroup,11,0,1,7,3,1,10,0,5,6,2,9,8,3
63,64,64,white,age.gp4,NoTr,NoTrade,Group,16,1,5,5,5,2,12,2,7,9,3,13,13,3
166,167,167,white,age.gp3,NoTr,NoTrade,NoGroup,11,3,1,4,3,2,9,0,2,9,2,9,6,5
300,301,301,white,age.gp4,NoTr,NoTrade,Group,17,1,5,2,9,2,15,0,9,8,0,17,12,5
1019,1020,1020,white,age.gp2,NoTr,Trade,Group,20,0,10,6,4,4,15,1,8,12,0,20,11,9
1078,1079,1079,white,age.gp4,NoTr,NoTrade,Group,14,5,3,2,4,3,11,0,3,11,0,14,7,7
1323,1324,1324,white,age.gp2,Tr,NoTrade,Group,16,1,10,3,2,1,13,2,7,9,2,14,14,2
2070,2071,2071,white,age.gp3,Tr,NoTrade,Group,21,1,8,8,4,2,19,0,5,16,5,16,16,5
2246,2247,2247,white,age.gp4,Tr,NoTrade,Group,12,0,1,5,6,1,11,0,2,10,1,11,9,3
2282,2283,2283,other,age.gp2,Tr,NoTrade,Group,14,1,5,3,5,2,12,0,8,6,2,12,10,4
2480,2481,2481,other,age.gp1,NoTr,NoTrade,NoGroup,7,4,0,2,1,1,5,1,1,6,2,5,3,4
2575,2576,2576,white,age.gp4,NoTr,NoTrade,Group,8,1,2,0,5,0,8,0,4,4,0,8,6,2
2673,2674,2674,white,age.gp3,NoTr,NoTrade,NoGroup,5,0,3,0,2,0,5,0,3,2,0,5,5,0
64,65,65,white,age.gp4,NoTr,NoTrade,Group,14,0,4,6,4,3,10,1,4,10,0,14,8,6
163,164,164,white,age.gp3,NoTr,NoTrade,NoGroup,12,2,7,2,1,1,7,4,6,6,1,11,8,4
764,765,765,white,age.gp4,NoTr,NoTrade,NoGroup,8,0,3,0,5,0,8,0,2,6,0,8,5,3
949,950,950,white,age.gp3,Tr,NoTrade,Group,18,1,4,7,6,0,18,0,10,8,1,17,13,5
1072,1073,1073,white,age.gp4,NoTr,NoTrade,Group,8,1,2,0,5,0,6,2,3,5,0,8,5,3
1549,1550,1550,white,age.gp3,NoTr,NoTrade,Group,23,3,8,10,2,1,20,2,11,12,2,21,16,7
1848,1849,1849,black,age.gp3,NoTr,NoTrade,NoGroup,10,5,2,1,2,3,6,1,3,7,1,9,5,5
1954,1955,1955,white,age.gp4,NoTr,NoTrade,Group,14,1,2,3,8,2,12,0,6,8,1,13,8,6
2602,2603,2603,white,age.gp3,NoTr,NoTrade,Group,14,1,4,5,4,1,13,0,4,10,2,12,11,3
2740,2741,2741,white,age.gp2,Tr,NoTrade,Group,24,2,14,5,3,2,20,2,9,15,3,21,15,9
2815,2816,2816,other,age.gp2,NoTr,NoTrade,NoGroup,4,1,1,0,2,0,4,0,1,3,0,4,2,2
65,66,66,white,age.gp4,NoTr,NoTrade,Group,13,3,2,3,5,1,11,1,5,8,0,13,11,2
231,232,232,white,age.gp2,Tr,NoTrade,Group,16,0,9,4,3,0,14,2,4,12,0,16,11,5
1727,1728,1728,white,age.gp3,Tr,NoTrade,Group,9,1,5,0,3,0,8,1,3,6,0,9,5,4
1798,1799,1799,white,age.gp4,Tr,NoTrade,Group,14,0,4,2,8,0,13,1,4,10,0,14,13,1
1946,1947,1947,white,age.gp4,NoTr,NoTrade,Group,14,0,4,1,9,3,11,0,3,11,1,13,10,4
2051,2052,2052,white,age.gp4,Tr,NoTrade,Group,10,0,0,3,7,1,9,0,5,5,0,10,6,4
2710,2711,2711,white,age.gp4,NoTr,NoTrade,Group,6,0,1,1,4,0,6,0,2,4,0,6,4,2
2713,2714,2714,white,age.gp4,NoTr,NoTrade,Group,6,2,0,2,2,1,5,0,1,5,0,6,3,3
2780,2781,2781,white,age.gp3,NoTr,NoTrade,Group,23,1,6,5,11,1,17,5,11,12,0,23,17,6
66,67,67,white,age.gp4,NoTr,NoTrade,Group,10,0,3,2,5,4,5,1,3,7,1,9,4,6
395,396,396,black,age.gp4,NoTr,NoTrade,NoGroup,3,0,0,1,2,1,2,0,0,3,0,3,2,1
524,525,525,black,age.gp3,NoTr,NoTrade,NoGroup,10,3,1,1,5,4,5,1,0,10,1,9,6,4
842,843,843,white,age.gp2,Tr,NoTrade,NoGroup,8,0,2,4,2,1,7,0,2,6,1,7,6,2
1002,1003,1003,white,age.gp4,NoTr,NoTrade,NoGroup,5,0,0,1,4,0,5,0,1,4,0,5,4,1
1370,1371,1371,black,age.gp4,NoTr,NoTrade,Group,13,0,1,2,10,6,7,0,3,10,1,12,10,3
1748,1749,1749,black,age.gp4,NoTr,NoTrade,NoGroup,2,0,0,0,2,1,1,0,0,2,1,1,2,0
2037,2038,2038,white,age.gp4,Tr,NoTrade,Group,15,1,6,2,6,1,13,1,4,11,3,12,11,4
2412,2413,2413,white,age.gp3,NoTr,Trade,Group,15,1,5,6,3,5,9,1,4,11,1,14,10,5
2806,2807,2807,other,age.gp2,NoTr,NoTrade,NoGroup,3,0,0,1,2,0,3,0,0,3,0,3,2,1
67,68,68,white,age.gp4,NoTr,NoTrade,Group,8,1,2,1,4,0,8,0,4,4,1,7,7,1
228,229,229,white,age.gp2,Tr,NoTrade,Group,33,2,11,13,7,3,28,2,10,23,1,32,25,8
461,462,462,white,age.gp1,NoTr,NoTrade,NoGroup,19,11,2,2,4,1,12,6,5,14,3,16,11,8
1586,1587,1587,white,age.gp4,Tr,NoTrade,Group,7,1,1,0,5,1,6,0,1,6,0,7,2,5
2243,2244,2244,white,age.gp4,Tr,NoTrade,Group,13,2,2,2,7,2,8,3,2,11,1,12,7,6
2419,2420,2420,white,age.gp3,NoTr,Trade,Group,24,3,8,6,7,0,22,2,9,15,6,18,17,7
2928,2929,2929,white,age.gp4,NoTr,NoTrade,Group,15,0,3,1,11,1,11,3,4,11,0,15,11,4
2944,2945,2945,white,age.gp4,NoTr,NoTrade,Group,14,0,5,2,7,2,11,1,7,7,1,13,11,3
68,69,69,white,age.gp4,NoTr,NoTrade,Group,10,0,2,2,6,1,8,1,5,5,0,10,8,2
178,179,179,white,age.gp3,Tr,NoTrade,NoGroup,8,1,3,1,3,0,7,1,4,4,3,5,8,0
296,297,297,white,age.gp4,NoTr,NoTrade,Group,12,1,3,2,6,1,10,1,7,5,0,12,10,2
398,399,399,black,age.gp4,NoTr,NoTrade,NoGroup,7,0,1,2,4,4,3,0,1,6,0,7,4,3
2260,2261,2261,white,age.gp4,Tr,NoTrade,Group,11,1,2,2,6,1,9,1,3,8,1,10,7,4
2288,2289,2289,other,age.gp2,Tr,NoTrade,Group,15,1,7,3,4,0,15,0,9,6,0,15,12,3
2925,2926,2926,white,age.gp4,NoTr,NoTrade,Group,20,4,4,3,9,2,15,3,5,15,4,16,12,8
2962,2963,2963,white,age.gp2,NoTr,NoTrade,Group,14,1,6,3,4,1,11,2,3,11,1,13,8,6
69,70,70,white,age.gp4,NoTr,NoTrade,Group,10,1,1,4,4,1,9,0,2,8,0,10,6,4
722,723,723,black,age.gp4,NoTr,NoTrade,NoGroup,7,0,2,2,3,5,2,0,0,7,1,6,3,4
758,759,759,white,age.gp4,NoTr,NoTrade,NoGroup,9,0,1,1,7,1,8,0,3,6,0,9,7,2
1447,1448,1448,white,age.gp1,NoTr,NoTrade,NoGroup,15,10,3,0,2,1,9,5,3,12,3,12,8,7
1554,1555,1555,white,age.gp3,NoTr,NoTrade,Group,18,3,8,5,2,2,14,2,6,12,2,16,14,4
2339,2340,2340,white,age.gp3,Tr,NoTrade,Group,18,1,7,5,5,1,16,1,6,12,0,18,17,1
2344,2345,2345,white,age.gp2,Tr,NoTrade,Group,26,1,12,5,8,2,22,2,9,17,0,26,17,9
2427,2428,2428,white,age.gp4,NoTr,NoTrade,NoGroup,4,0,0,2,2,1,3,0,0,4,0,4,1,3
2591,2592,2592,white,age.gp3,NoTr,NoTrade,Group,26,7,8,7,4,1,18,7,9,17,0,26,16,10
97,98,98,white,age.gp3,NoTr,NoTrade,Group,18,2,7,6,3,2,12,4,6,12,2,16,13,5
188,189,189,white,age.gp3,Tr,NoTrade,NoGroup,12,1,2,6,3,0,12,0,3,9,1,11,9,3
701,702,702,white,age.gp4,Tr,NoTrade,Group,15,2,3,1,9,4,9,2,2,13,0,15,10,5
1709,1710,1710,white,age.gp2,Tr,NoTrade,Group,31,1,12,8,10,3,24,4,11,20,4,27,19,12
2211,2212,2212,black,age.gp4,NoTr,Trade,Group,4,0,1,1,2,1,3,0,1,3,0,4,3,1
71,72,72,white,age.gp4,NoTr,NoTrade,Group,9,0,2,1,6,0,9,0,5,4,0,9,8,1
93,94,94,white,age.gp3,NoTr,NoTrade,Group,26,6,7,7,6,4,18,4,7,19,2,24,17,9
259,260,260,white,age.gp4,NoTr,NoTrade,NoGroup,8,2,1,0,5,2,6,0,1,7,0,8,5,3
683,684,684,white,age.gp4,Tr,NoTrade,Group,11,2,0,1,8,0,10,1,3,8,2,9,7,4
746,747,747,white,age.gp2,Tr,NoTrade,Group,25,3,11,5,6,2,19,4,7,18,1,24,18,7
969,970,970,white,age.gp2,Tr,NoTrade,Group,26,3,11,5,7,0,21,5,10,16,0,26,17,9
1276,1277,1277,white,age.gp4,NoTr,NoTrade,Group,14,0,4,4,6,0,14,0,6,8,0,14,10,4
1780,1781,1781,white,age.gp4,Tr,NoTrade,Group,6,0,3,0,3,1,5,0,2,4,0,6,4,2
2249,2250,2250,white,age.gp4,Tr,NoTrade,Group,12,1,4,3,4,0,11,1,4,8,1,11,7,5
2560,2561,2561,white,age.gp4,NoTr,NoTrade,Group,14,0,2,5,7,1,13,0,6,8,0,14,9,5
72,73,73,white,age.gp4,NoTr,NoTrade,Group,12,1,2,2,7,1,11,0,6,6,0,12,10,2
154,155,155,white,age.gp3,NoTr,NoTrade,Group,16,4,2,3,7,2,10,4,2,14,1,15,8,8
179,180,180,white,age.gp3,Tr,NoTrade,NoGroup,9,1,1,4,3,2,6,1,1,8,0,9,5,4
309,310,310,white,age.gp4,NoTr,NoTrade,Group,10,0,1,2,7,0,10,0,4,6,1,9,10,0
1777,1778,1778,white,age.gp4,Tr,NoTrade,Group,22,1,3,3,15,1,21,0,6,16,1,21,16,6
2038,2039,2039,white,age.gp4,Tr,NoTrade,Group,9,0,3,0,6,0,9,0,1,8,0,9,5,4
2040,2041,2041,white,age.gp4,Tr,NoTrade,Group,15,0,5,4,6,3,12,0,6,9,1,14,11,4
2053,2054,2054,white,age.gp4,Tr,NoTrade,Group,17,1,2,5,9,3,14,0,2,15,1,16,13,4
2393,2394,2394,black,age.gp2,NoTr,NoTrade,NoGroup,7,0,2,2,3,5,2,0,1,6,2,5,5,2
2863,2864,2864,white,age.gp2,Tr,NoTrade,Group,22,1,13,5,3,0,20,2,5,17,0,22,12,10
2974,2975,2975,white,age.gp1,NoTr,NoTrade,Group,24,12,0,5,7,6,14,4,9,15,4,20,10,14
73,74,74,white,age.gp4,NoTr,NoTrade,Group,8,0,0,2,6,1,7,0,3,5,1,7,6,2
84,85,85,white,age.gp4,NoTr,NoTrade,Group,12,0,3,6,3,2,9,1,4,8,0,12,6,6
812,813,813,white,age.gp4,NoTr,NoTrade,NoGroup,7,2,3,0,2,0,5,2,3,4,1,6,6,1
1570,1571,1571,white,age.gp4,Tr,NoTrade,Group,6,0,0,1,5,0,6,0,1,5,0,6,5,1
1584,1585,1585,white,age.gp4,Tr,NoTrade,Group,15,0,4,2,9,2,13,0,5,10,1,14,12,3
1698,1699,1699,white,age.gp4,NoTr,Trade,NoGroup,5,0,0,2,3,0,5,0,0,5,2,3,4,1
2330,2331,2331,white,age.gp3,Tr,NoTrade,Group,18,3,4,6,5,1,17,0,4,14,1,17,17,1
2856,2857,2857,black,age.gp3,NoTr,NoTrade,Group,19,2,6,7,4,11,8,0,4,15,3,16,11,8
2939,2940,2940,white,age.gp4,NoTr,NoTrade,Group,13,3,1,1,8,1,10,2,4,9,0,13,9,4
74,75,75,white,age.gp4,NoTr,NoTrade,Group,6,1,3,1,1,1,4,1,2,4,0,6,4,2
87,88,88,white,age.gp4,NoTr,NoTrade,Group,11,2,3,2,4,0,11,0,1,10,1,10,5,6
138,139,139,white,age.gp2,NoTr,NoTrade,NoGroup,11,0,3,5,3,2,9,0,3,8,0,11,6,5
2389,2390,2390,white,age.gp2,Tr,NoTrade,Group,18,2,6,4,6,2,15,1,5,13,0,18,12,6
2848,2849,2849,black,age.gp3,NoTr,NoTrade,Group,8,1,2,3,2,1,7,0,5,3,2,6,7,1
871,872,872,other,age.gp2,Tr,NoTrade,Group,10,1,5,2,2,0,10,0,2,8,1,9,7,3
1133,1134,1134,white,age.gp2,Tr,NoTrade,Group,27,4,14,6,3,3,20,4,13,14,3,24,19,8
2612,2613,2613,white,age.gp4,NoTr,NoTrade,NoGroup,5,0,1,0,4,0,5,0,1,4,0,5,3,2
2858,2859,2859,white,age.gp1,Tr,NoTrade,NoGroup,16,10,1,3,2,2,13,1,4,12,2,14,9,7
2931,2932,2932,white,age.gp4,NoTr,NoTrade,Group,13,2,2,2,7,1,10,2,2,11,1,12,6,7
2941,2942,2942,white,age.gp4,NoTr,NoTrade,Group,21,4,4,2,11,4,16,1,10,11,1,20,15,6
76,77,77,white,age.gp4,NoTr,NoTrade,Group,15,0,2,2,11,3,11,1,3,12,1,14,8,7
311,312,312,white,age.gp4,NoTr,NoTrade,Group,15,1,3,1,10,0,15,0,4,11,0,15,7,8
427,428,428,white,age.gp4,NoTr,NoTrade,NoGroup,4,1,0,2,1,0,4,0,0,4,0,4,3,1
607,608,608,other,age.gp4,NoTr,NoTrade,NoGroup,5,0,0,0,5,1,4,0,0,5,1,4,2,3
672,673,673,white,age.gp4,Tr,NoTrade,Group,14,0,4,3,7,2,12,0,3,11,4,10,10,4
724,725,725,black,age.gp4,NoTr,NoTrade,NoGroup,5,0,2,0,3,2,3,0,0,5,1,4,4,1
809,810,810,white,age.gp4,NoTr,NoTrade,NoGroup,3,0,1,0,2,0,3,0,1,2,0,3,2,1
814,815,815,white,age.gp4,NoTr,NoTrade,NoGroup,4,0,1,0,3,0,4,0,2,2,0,4,3,1
1284,1285,1285,white,age.gp4,NoTr,NoTrade,Group,10,2,3,2,3,2,8,0,2,8,1,9,6,4
1781,1782,1782,white,age.gp4,Tr,NoTrade,Group,13,0,4,1,8,2,10,1,5,8,0,13,9,4
2097,2098,2098,black,age.gp3,NoTr,NoTrade,NoGroup,5,0,1,1,3,1,4,0,2,3,1,4,3,2
2181,2182,2182,white,age.gp4,NoTr,NoTrade,NoGroup,1,0,0,0,1,0,1,0,0,1,0,1,1,0
2239,2240,2240,black,age.gp4,NoTr,Trade,Group,12,1,4,1,6,5,6,1,4,8,1,11,9,3
2647,2648,2648,white,age.gp2,NoTr,NoTrade,Group,12,1,5,4,2,2,6,4,5,7,1,11,8,4
77,78,78,white,age.gp4,NoTr,NoTrade,Group,9,1,1,2,5,2,7,0,3,6,1,8,6,3
100,101,101,white,age.gp3,NoTr,NoTrade,Group,18,0,4,7,7,5,13,0,7,11,0,18,12,6
1256,1257,1257,white,age.gp1,Tr,Trade,Group,25,15,1,2,7,1,16,8,4,21,1,24,12,13
1773,1774,1774,white,age.gp4,Tr,NoTrade,Group,9,0,1,4,4,0,8,1,2,7,0,9,5,4
1945,1946,1946,white,age.gp4,NoTr,NoTrade,Group,17,1,2,3,11,3,13,1,7,10,1,16,9,8
2087,2088,2088,black,age.gp3,NoTr,NoTrade,NoGroup,9,0,4,2,3,5,3,1,2,7,0,9,5,4
2430,2431,2431,white,age.gp4,NoTr,NoTrade,NoGroup,12,2,4,0,6,3,8,1,7,5,0,12,4,8
2841,2842,2842,white,age.gp2,Tr,NoTrade,Group,24,1,11,4,8,3,20,1,8,16,3,21,14,10
2934,2935,2935,white,age.gp4,NoTr,NoTrade,Group,9,0,2,2,5,0,9,0,4,5,0,9,5,4
78,79,79,white,age.gp4,NoTr,NoTrade,Group,11,1,2,2,6,0,10,1,7,4,1,10,9,2
511,512,512,white,age.gp2,Tr,NoTrade,NoGroup,10,1,8,0,1,0,8,2,4,6,0,10,3,7
696,697,697,white,age.gp4,Tr,NoTrade,Group,11,2,3,1,5,0,10,1,4,7,1,10,7,4
877,878,878,white,age.gp3,NoTr,Trade,Group,17,3,3,8,3,1,14,2,5,12,3,14,12,5
1062,1063,1063,white,age.gp4,NoTr,NoTrade,Group,11,0,5,1,5,1,9,1,6,5,0,11,8,3
1581,1582,1582,white,age.gp4,Tr,NoTrade,Group,14,0,2,5,7,2,12,0,4,10,0,14,10,4
1792,1793,1793,white,age.gp4,Tr,NoTrade,Group,13,2,4,3,4,2,9,2,6,7,2,11,9,4
2069,2070,2070,white,age.gp3,Tr,NoTrade,Group,22,0,4,10,8,4,17,1,4,18,2,20,12,10
2544,2545,2545,other,age.gp1,NoTr,NoTrade,NoGroup,7,3,2,0,2,0,7,0,3,4,0,7,6,1
79,80,80,white,age.gp4,NoTr,NoTrade,Group,13,0,3,4,6,3,9,1,6,7,2,11,11,2
237,238,238,white,age.gp2,Tr,NoTrade,Group,19,2,7,6,4,4,13,2,5,14,5,14,14,5
866,867,867,other,age.gp2,Tr,NoTrade,Group,6,0,2,2,2,1,5,0,1,5,0,6,4,2
1073,1074,1074,white,age.gp4,NoTr,NoTrade,Group,13,1,2,3,7,0,13,0,4,9,1,12,8,5
1414,1415,1415,black,age.gp2,NoTr,NoTrade,NoGroup,6,0,5,0,1,3,3,0,2,4,0,6,3,3
1561,1562,1562,white,age.gp4,Tr,NoTrade,Group,12,0,0,4,8,2,10,0,3,9,1,11,9,3
2125,2126,2126,white,age.gp3,NoTr,NoTrade,Group,20,0,8,7,5,1,17,2,9,11,1,19,19,1
2232,2233,2233,black,age.gp4,NoTr,Trade,Group,3,0,1,0,2,1,2,0,1,2,0,3,2,1
2233,2234,2234,black,age.gp4,NoTr,Trade,Group,7,0,1,0,6,2,5,0,1,6,0,7,4,3
2329,2330,2330,white,age.gp3,Tr,NoTrade,Group,16,1,4,5,6,2,13,1,2,14,1,15,8,8
2782,2783,2783,white,age.gp3,NoTr,NoTrade,Group,20,1,10,5,4,2,16,2,7,13,3,17,12,8
2948,2949,2949,white,age.gp4,NoTr,NoTrade,Group,7,2,2,1,2,0,5,2,2,5,0,7,5,2
817,818,818,white,age.gp4,NoTr,NoTrade,NoGroup,7,0,2,1,4,0,7,0,5,2,0,7,5,2
896,897,897,other,age.gp1,Tr,NoTrade,NoGroup,2,1,0,0,1,1,1,0,1,1,0,2,1,1
1283,1284,1284,white,age.gp4,NoTr,NoTrade,Group,10,0,2,3,5,1,8,1,3,7,2,8,9,1
1546,1547,1547,white,age.gp3,NoTr,NoTrade,Group,22,2,6,9,5,3,18,1,8,14,2,20,12,10
1783,1784,1784,white,age.gp4,Tr,NoTrade,Group,14,2,2,4,6,2,11,1,4,10,1,13,10,4
1796,1797,1797,white,age.gp4,Tr,NoTrade,Group,13,2,4,1,6,0,10,3,3,10,2,11,7,6
2637,2638,2638,white,age.gp4,NoTr,NoTrade,NoGroup,5,0,1,0,4,1,4,0,2,3,0,5,4,1
2712,2713,2713,white,age.gp4,NoTr,NoTrade,Group,17,0,5,5,7,3,14,0,5,12,0,17,11,6
81,82,82,white,age.gp4,NoTr,NoTrade,Group,13,1,5,4,3,1,9,3,5,8,1,12,8,5
147,148,148,white,age.gp3,NoTr,NoTrade,Group,18,2,7,4,5,2,14,2,4,14,2,16,10,8
277,278,278,white,age.gp4,NoTr,NoTrade,NoGroup,5,0,0,2,3,1,4,0,1,4,0,5,4,1
306,307,307,white,age.gp4,NoTr,NoTrade,Group,11,2,2,2,5,2,8,1,4,7,1,10,5,6
649,650,650,other,age.gp1,NoTr,Trade,Group,11,4,3,1,3,2,9,0,6,5,0,11,6,5
1308,1309,1309,white,age.gp2,Tr,NoTrade,NoGroup,8,0,5,1,2,1,5,2,4,4,1,7,5,3
1402,1403,1403,white,age.gp3,NoTr,NoTrade,Group,14,2,3,6,3,1,12,1,8,6,2,12,12,2
1411,1412,1412,white,age.gp3,NoTr,NoTrade,Group,16,0,8,2,6,0,12,4,6,10,0,16,10,6
2285,2286,2286,other,age.gp2,Tr,NoTrade,Group,9,2,2,3,2,1,8,0,1,8,0,9,5,4
2828,2829,2829,other,age.gp2,NoTr,NoTrade,NoGroup,6,1,1,3,1,1,5,0,2,4,0,6,2,4
2829,2830,2830,white,age.gp2,Tr,NoTrade,NoGroup,8,1,2,2,3,1,7,0,2,6,0,8,5,3
86,87,87,white,age.gp4,NoTr,NoTrade,Group,15,2,1,5,7,1,14,0,5,10,0,15,8,7
297,298,298,white,age.gp4,NoTr,NoTrade,Group,17,2,5,2,8,0,17,0,5,12,0,17,9,8
301,302,302,white,age.gp4,NoTr,NoTrade,Group,14,1,3,1,9,0,11,3,5,9,0,14,12,2
797,798,798,white,age.gp4,NoTr,NoTrade,NoGroup,7,1,3,1,2,0,5,2,2,5,0,7,4,3
816,817,817,white,age.gp4,NoTr,NoTrade,NoGroup,6,1,2,0,3,0,4,2,2,4,1,5,4,2
1213,1214,1214,white,age.gp4,NoTr,NoTrade,NoGroup,6,0,2,2,2,1,5,0,2,4,0,6,4,2
1589,1590,1590,white,age.gp4,Tr,NoTrade,Group,14,0,1,2,11,0,14,0,4,10,1,13,11,3
1959,1960,1960,white,age.gp4,NoTr,NoTrade,Group,21,1,2,5,13,2,18,1,13,8,1,20,16,5
2269,2270,2270,white,age.gp4,Tr,NoTrade,Group,7,0,1,0,6,1,6,0,2,5,0,7,4,3
2474,2475,2475,white,age.gp2,Tr,NoTrade,Group,20,0,10,5,5,2,16,2,5,15,0,20,10,10
83,84,84,white,age.gp4,NoTr,NoTrade,Group,13,0,5,1,7,0,12,1,6,7,0,13,8,5
1290,1291,1291,white,age.gp4,NoTr,NoTrade,Group,10,1,2,2,5,2,7,1,2,8,0,10,4,6
1309,1310,1310,white,age.gp2,Tr,NoTrade,NoGroup,15,2,4,7,2,2,12,1,6,9,0,15,10,5
1426,1427,1427,white,age.gp2,Tr,NoTrade,Group,24,3,8,7,6,2,20,2,9,15,2,22,15,9
1482,1483,1483,white,age.gp4,NoTr,NoTrade,NoGroup,9,2,2,1,4,1,7,1,3,6,0,9,6,3
1559,1560,1560,white,age.gp3,NoTr,NoTrade,Group,13,1,2,6,4,2,11,0,4,9,1,12,11,2
1775,1776,1776,white,age.gp4,Tr,NoTrade,Group,11,0,2,3,6,1,9,1,4,7,0,11,7,4
1908,1909,1909,other,age.gp2,NoTr,NoTrade,NoGroup,6,0,4,1,1,1,5,0,2,4,0,6,4,2
1960,1961,1961,white,age.gp4,NoTr,NoTrade,Group,12,0,2,2,8,3,9,0,2,10,0,12,6,6
1993,1994,1994,white,age.gp4,Tr,NoTrade,NoGroup,3,0,0,1,2,1,2,0,0,3,1,2,2,1
2922,2923,2923,white,age.gp4,NoTr,NoTrade,Group,7,0,1,3,3,0,6,1,3,4,1,6,7,0
2966,2967,2967,white,age.gp2,NoTr,NoTrade,NoGroup,13,0,10,1,2,1,12,0,7,6,0,13,8,5
125,126,126,white,age.gp3,NoTr,NoTrade,NoGroup,6,0,2,2,2,1,4,1,3,3,0,6,2,4
202,203,203,other,age.gp2,Tr,NoTrade,NoGroup,7,0,4,0,3,1,6,0,3,4,1,6,6,1
1039,1040,1040,black,age.gp4,NoTr,NoTrade,NoGroup,4,0,2,0,2,1,3,0,2,2,0,4,2,2
1612,1613,1613,white,age.gp3,Tr,NoTrade,NoGroup,8,1,2,3,2,2,4,2,3,5,1,7,5,3
1856,1857,1857,white,age.gp3,NoTr,NoTrade,Group,17,0,4,5,8,2,15,0,6,11,0,17,11,6
2066,2067,2067,white,age.gp3,Tr,NoTrade,Group,20,4,9,6,1,1,14,5,8,12,1,19,13,7
2113,2114,2114,white,age.gp2,NoTr,NoTrade,NoGroup,13,3,3,2,5,0,13,0,5,8,1,12,8,5
85,86,86,white,age.gp4,NoTr,NoTrade,Group,12,0,4,3,5,2,8,2,6,6,1,11,10,2
679,680,680,white,age.gp4,Tr,NoTrade,Group,10,0,5,3,2,1,9,0,3,7,0,10,9,1
849,850,850,other,age.gp2,Tr,NoTrade,Group,16,0,9,2,5,0,16,0,8,8,0,16,14,2
953,954,954,white,age.gp3,Tr,NoTrade,Group,14,1,4,4,5,1,13,0,3,11,1,13,11,3
1387,1388,1388,black,age.gp3,NoTr,NoTrade,NoGroup,9,0,3,2,4,5,3,1,1,8,2,7,6,3
2047,2048,2048,white,age.gp4,Tr,NoTrade,Group,12,0,2,3,7,2,9,1,4,8,0,12,8,4
2128,2129,2129,white,age.gp3,NoTr,NoTrade,Group,15,3,5,4,3,1,12,2,5,10,0,15,9,6
2142,2143,2143,other,age.gp2,NoTr,NoTrade,NoGroup,5,0,2,0,3,1,4,0,2,3,0,5,3,2
2263,2264,2264,white,age.gp4,Tr,NoTrade,Group,16,3,3,4,6,2,11,3,4,12,1,15,13,3
2570,2571,2571,white,age.gp4,NoTr,NoTrade,Group,8,0,3,1,4,0,8,0,5,3,0,8,6,2
677,678,678,white,age.gp4,Tr,NoTrade,Group,9,0,1,0,8,2,7,0,4,5,0,9,7,2
827,828,828,white,age.gp3,NoTr,NoTrade,NoGroup,6,3,0,2,1,1,4,1,1,5,0,6,1,5
1017,1018,1018,white,age.gp1,NoTr,NoTrade,NoGroup,12,5,4,1,2,0,9,3,2,10,1,11,6,6
1853,1854,1854,white,age.gp3,NoTr,NoTrade,Group,18,2,8,2,6,1,16,1,8,10,3,15,12,6
2245,2246,2246,white,age.gp4,Tr,NoTrade,Group,10,3,1,1,5,4,6,0,3,7,1,9,5,5
2254,2255,2255,white,age.gp4,Tr,NoTrade,Group,15,0,5,2,8,1,13,1,5,10,2,13,8,7
2362,2363,2363,white,age.gp3,Tr,NoTrade,NoGroup,9,0,2,3,4,1,7,1,2,7,0,9,4,5
2402,2403,2403,white,age.gp3,NoTr,NoTrade,NoGroup,7,1,1,2,3,0,5,2,1,6,0,7,5,2
2512,2513,2513,white,age.gp1,NoTr,NoTrade,NoGroup,14,6,0,3,5,0,12,2,3,11,0,14,9,5
2624,2625,2625,white,age.gp4,NoTr,NoTrade,NoGroup,6,0,1,2,3,2,4,0,0,6,0,6,6,0
2943,2944,2944,white,age.gp4,NoTr,NoTrade,Group,13,2,3,2,6,0,11,2,2,11,1,12,7,6
114,115,115,white,age.gp3,NoTr,NoTrade,NoGroup,13,1,5,5,2,0,13,0,4,9,4,9,11,2
528,529,529,white,age.gp4,NoTr,NoTrade,NoGroup,1,0,0,0,1,0,1,0,0,1,0,1,1,0
836,837,837,white,age.gp2,NoTr,NoTrade,Group,24,3,9,6,6,3,17,4,10,14,1,23,11,13
1237,1238,1238,white,age.gp4,NoTr,NoTrade,NoGroup,2,0,0,0,2,0,2,0,0,2,0,2,1,1
1409,1410,1410,white,age.gp3,NoTr,NoTrade,Group,16,3,10,1,2,0,13,3,6,10,1,15,10,6
1457,1458,1458,white,age.gp1,NoTr,NoTrade,NoGroup,11,7,2,0,2,0,7,4,3,8,1,10,7,4
2170,2171,2171,white,age.gp2,NoTr,NoTrade,Group,23,2,10,4,7,2,19,2,6,17,3,20,17,6
2381,2382,2382,white,age.gp1,NoTr,NoTrade,NoGroup,7,4,0,1,2,1,5,1,1,6,0,7,4,3
88,89,89,white,age.gp4,NoTr,NoTrade,Group,14,2,4,1,7,2,11,1,5,9,1,13,11,3
744,745,745,white,age.gp2,Tr,NoTrade,Group,18,0,10,2,6,4,12,2,6,12,0,18,11,7
966,967,967,white,age.gp2,Tr,NoTrade,Group,34,2,11,10,11,2,30,2,10,24,1,33,23,11
989,990,990,white,age.gp4,NoTr,NoTrade,NoGroup,4,0,0,0,4,0,4,0,1,3,0,4,2,2
1296,1297,1297,white,age.gp4,NoTr,NoTrade,Group,11,0,1,0,10,3,7,1,2,9,0,11,7,4
1372,1373,1373,black,age.gp4,NoTr,NoTrade,Group,7,0,0,0,7,5,2,0,1,6,0,7,4,3
2273,2274,2274,black,age.gp2,Tr,Trade,Group,17,2,6,3,6,8,8,1,5,12,1,16,9,8
2296,2297,2297,other,age.gp2,Tr,NoTrade,Group,7,0,3,2,2,1,6,0,1,6,0,7,2,5
2646,2647,2647,white,age.gp1,NoTr,NoTrade,NoGroup,10,3,4,1,2,1,7,2,1,9,1,9,8,2
2676,2677,2677,white,age.gp3,NoTr,NoTrade,NoGroup,8,1,4,2,1,1,5,2,3,5,1,7,6,2
2714,2715,2715,white,age.gp4,NoTr,NoTrade,Group,19,3,2,3,11,1,16,2,8,11,1,18,12,7
2872,2873,2873,white,age.gp1,NoTr,NoTrade,Group,32,16,8,4,4,3,22,7,9,23,2,30,11,21
89,90,90,white,age.gp4,NoTr,NoTrade,Group,10,2,1,3,4,3,6,1,2,8,0,10,6,4
168,169,169,white,age.gp3,NoTr,NoTrade,NoGroup,15,2,4,0,9,0,13,2,6,9,0,15,9,6
290,291,291,black,age.gp2,NoTr,NoTrade,Group,11,0,5,2,4,6,5,0,2,9,3,8,9,2
794,795,795,white,age.gp4,NoTr,NoTrade,NoGroup,5,0,0,0,5,1,4,0,2,3,0,5,4,1
1093,1094,1094,black,age.gp1,NoTr,NoTrade,NoGroup,10,2,3,3,2,4,4,2,0,10,0,10,4,6
1157,1158,1158,white,age.gp4,NoTr,NoTrade,NoGroup,5,0,1,2,2,2,3,0,0,5,0,5,3,2
1362,1363,1363,black,age.gp4,NoTr,NoTrade,Group,10,2,2,3,3,5,5,0,3,7,2,8,6,4
1894,1895,1895,other,age.gp1,NoTr,NoTrade,Group,8,3,1,3,1,3,5,0,3,5,1,7,6,2
2583,2584,2584,white,age.gp4,NoTr,NoTrade,Group,12,2,2,1,7,3,9,0,5,7,1,11,9,3
90,91,91,white,age.gp4,NoTr,NoTrade,Group,12,0,6,3,3,0,12,0,10,2,0,12,9,3
238,239,239,white,age.gp2,Tr,NoTrade,Group,27,3,15,3,6,4,20,3,12,15,0,27,19,8
437,438,438,white,age.gp4,NoTr,NoTrade,NoGroup,5,1,2,0,2,0,4,1,1,4,0,5,4,1
676,677,677,white,age.gp4,Tr,NoTrade,Group,15,0,2,6,7,0,15,0,2,13,1,14,13,2
1580,1581,1581,white,age.gp4,Tr,NoTrade,Group,14,2,2,2,8,2,11,1,4,10,1,13,12,2
1739,1740,1740,white,age.gp3,Tr,NoTrade,Group,21,1,5,12,3,0,21,0,6,15,3,18,17,4
1808,1809,1809,white,age.gp2,Tr,NoTrade,Group,29,4,10,7,8,0,24,5,15,14,1,28,19,10
2355,2356,2356,white,age.gp3,Tr,NoTrade,NoGroup,9,1,1,2,5,0,9,0,3,6,0,9,7,2
2742,2743,2743,white,age.gp2,NoTr,NoTrade,Group,17,1,11,2,3,2,12,3,9,8,1,16,13,4
2840,2841,2841,white,age.gp2,Tr,NoTrade,Group,27,4,10,9,4,4,18,5,4,23,2,25,17,10
2865,2866,2866,white,age.gp2,Tr,NoTrade,Group,21,2,7,5,7,0,19,2,9,12,0,21,14,7
91,92,92,white,age.gp3,NoTr,NoTrade,Group,23,6,9,5,3,4,17,2,10,13,0,23,11,12
155,156,156,white,age.gp3,NoTr,NoTrade,Group,17,5,3,7,2,2,14,1,7,10,1,16,9,8
652,653,653,black,age.gp2,NoTr,NoTrade,NoGroup,12,0,6,5,1,6,6,0,3,9,0,12,9,3
708,709,709,white,age.gp2,Tr,NoTrade,Group,25,3,7,7,8,2,21,2,7,18,3,22,18,7
843,844,844,white,age.gp2,Tr,NoTrade,NoGroup,12,2,8,2,0,0,10,2,4,8,0,12,8,4
1353,1354,1354,black,age.gp4,NoTr,NoTrade,Group,11,1,4,4,2,4,6,1,3,8,1,10,7,4
1425,1426,1426,white,age.gp2,Tr,NoTrade,Group,19,1,5,7,6,3,13,3,8,11,1,18,12,7
1544,1545,1545,white,age.gp2,NoTr,NoTrade,NoGroup,9,2,2,2,3,0,9,0,4,5,0,9,7,2
1555,1556,1556,white,age.gp3,NoTr,NoTrade,Group,23,0,13,7,3,3,18,2,8,15,0,23,18,5
1891,1892,1892,other,age.gp1,NoTr,NoTrade,Group,7,5,0,1,1,2,5,0,4,3,2,5,3,4
1903,1904,1904,black,age.gp1,NoTr,NoTrade,NoGroup,8,3,1,4,0,4,3,1,2,6,3,5,4,4
1983,1984,1984,white,age.gp4,Tr,NoTrade,NoGroup,7,0,0,2,5,1,6,0,1,6,0,7,4,3
2115,2116,2116,white,age.gp2,NoTr,NoTrade,NoGroup,8,0,3,5,0,2,5,1,1,7,1,7,6,2
2322,2323,2323,white,age.gp1,NoTr,NoTrade,NoGroup,14,7,2,3,2,2,9,3,3,11,1,13,11,3
2630,2631,2631,white,age.gp4,NoTr,NoTrade,NoGroup,7,0,0,3,4,1,6,0,3,4,0,7,5,2
136,137,137,white,age.gp2,NoTr,NoTrade,NoGroup,17,1,8,7,1,0,15,2,7,10,1,16,9,8
472,473,473,black,age.gp3,NoTr,Trade,Group,11,1,4,6,0,7,4,0,2,9,0,11,6,5
936,937,937,white,age.gp3,NoTr,NoTrade,NoGroup,4,0,1,2,1,0,3,1,1,3,0,4,2,2
1004,1005,1005,white,age.gp1,Tr,NoTrade,Group,30,13,7,8,2,0,21,9,11,19,0,30,20,10
1006,1007,1007,white,age.gp1,Tr,NoTrade,Group,26,13,4,5,4,1,19,6,3,23,4,22,13,13
1431,1432,1432,white,age.gp3,Tr,NoTrade,NoGroup,13,2,6,4,1,0,12,1,3,10,2,11,10,3
1493,1494,1494,white,age.gp4,NoTr,NoTrade,NoGroup,3,0,1,1,1,0,2,1,0,3,0,3,2,1
1550,1551,1551,white,age.gp3,NoTr,NoTrade,Group,17,5,3,5,4,0,15,2,5,12,0,17,10,7
1734,1735,1735,white,age.gp3,Tr,NoTrade,Group,17,1,6,4,6,1,15,1,6,11,2,15,12,5
1858,1859,1859,white,age.gp3,NoTr,NoTrade,Group,17,2,3,5,7,2,14,1,3,14,0,17,10,7
1892,1893,1893,other,age.gp1,NoTr,NoTrade,Group,14,8,3,2,1,2,12,0,5,9,0,14,7,7
2354,2355,2355,white,age.gp3,Tr,NoTrade,NoGroup,10,0,6,3,1,0,9,1,3,7,0,10,6,4
2424,2425,2425,white,age.gp3,NoTr,Trade,Group,10,1,3,5,1,1,7,2,2,8,1,9,8,2
2511,2512,2512,white,age.gp1,NoTr,NoTrade,NoGroup,7,3,1,1,2,0,4,3,0,7,1,6,3,4
2738,2739,2739,white,age.gp2,Tr,NoTrade,Group,24,1,13,4,6,1,18,5,10,14,0,24,18,6
410,411,411,white,age.gp2,Tr,Trade,Group,27,3,11,7,6,1,20,6,9,18,0,27,14,13
534,535,535,white,age.gp4,NoTr,NoTrade,NoGroup,2,0,0,1,1,0,2,0,0,2,0,2,2,0
635,636,636,other,age.gp1,NoTr,Trade,Group,4,1,0,3,0,0,4,0,1,3,0,4,4,0
664,665,665,white,age.gp2,NoTr,NoTrade,Group,22,1,7,9,5,1,20,1,5,17,1,21,15,7
705,706,706,white,age.gp2,NoTr,NoTrade,Group,20,1,11,7,1,1,18,1,11,9,0,20,15,5
1119,1120,1120,other,age.gp1,NoTr,NoTrade,NoGroup,7,3,0,1,3,0,7,0,2,5,0,7,4,3
1246,1247,1247,white,age.gp1,NoTr,NoTrade,NoGroup,10,5,1,2,2,1,7,2,0,10,2,8,3,7
1322,1323,1323,white,age.gp2,Tr,NoTrade,Group,26,2,9,11,4,3,21,2,5,21,1,25,20,6
1357,1358,1358,black,age.gp4,NoTr,NoTrade,Group,14,1,1,2,10,9,5,0,0,14,2,12,7,7
1802,1803,1803,white,age.gp4,Tr,NoTrade,Group,13,1,2,4,6,3,9,1,5,8,0,13,7,6
1849,1850,1850,black,age.gp3,NoTr,NoTrade,NoGroup,8,0,2,3,3,6,2,0,0,8,0,8,3,5
1876,1877,1877,other,age.gp1,NoTr,NoTrade,Group,16,8,5,3,0,2,14,0,4,12,1,15,9,7
2083,2084,2084,black,age.gp3,NoTr,NoTrade,NoGroup,6,0,1,5,0,4,2,0,0,6,1,5,4,2
2117,2118,2118,white,age.gp3,NoTr,NoTrade,Group,13,4,4,2,3,1,9,3,4,9,0,13,7,6
2325,2326,2326,white,age.gp3,Tr,NoTrade,Group,20,3,10,4,3,1,17,2,7,13,2,18,12,8
2557,2558,2558,other,age.gp1,NoTr,NoTrade,NoGroup,5,4,0,1,0,0,5,0,2,3,0,5,2,3
2636,2637,2637,white,age.gp4,NoTr,NoTrade,NoGroup,4,0,1,1,2,1,3,0,2,2,0,4,3,1
94,95,95,white,age.gp3,NoTr,NoTrade,Group,16,0,9,4,3,0,16,0,10,6,0,16,14,2
164,165,165,white,age.gp3,NoTr,NoTrade,NoGroup,8,1,4,2,1,0,7,1,3,5,0,8,4,4
283,284,284,white,age.gp2,Tr,NoTrade,Group,36,3,14,11,8,4,27,5,10,26,1,35,23,13
743,744,744,white,age.gp2,Tr,NoTrade,Group,19,1,8,6,4,3,16,0,4,15,2,17,15,4
837,838,838,white,age.gp2,NoTr,NoTrade,Group,21,4,7,3,7,2,16,3,8,13,1,20,16,5
934,935,935,white,age.gp3,NoTr,NoTrade,NoGroup,8,0,4,3,1,1,5,2,4,4,1,7,6,2
2103,2104,2104,white,age.gp2,Tr,NoTrade,Group,23,2,8,7,6,2,19,2,9,14,1,22,16,7
2104,2105,2105,white,age.gp2,Tr,NoTrade,Group,22,1,9,9,3,1,19,2,11,11,2,20,15,7
2264,2265,2265,white,age.gp4,Tr,NoTrade,Group,16,3,4,3,6,0,14,2,5,11,2,14,12,4
2588,2589,2589,white,age.gp4,NoTr,NoTrade,Group,10,0,2,1,7,0,10,0,3,7,0,10,9,1
779,780,780,white,age.gp2,NoTr,NoTrade,NoGroup,9,0,2,6,1,3,5,1,3,6,1,8,6,3
1210,1211,1211,white,age.gp4,NoTr,NoTrade,NoGroup,12,0,1,2,9,0,12,0,5,7,0,12,9,3
1725,1726,1726,white,age.gp1,Tr,NoTrade,NoGroup,7,4,0,3,0,2,4,1,3,4,2,5,4,3
1735,1736,1736,white,age.gp3,Tr,NoTrade,Group,17,0,1,9,7,0,17,0,6,11,0,17,13,4
2394,2395,2395,black,age.gp2,NoTr,NoTrade,NoGroup,5,0,2,2,1,2,3,0,1,4,0,5,4,1
2717,2718,2718,white,age.gp4,NoTr,NoTrade,Group,7,0,1,3,3,0,7,0,4,3,0,7,5,2
2920,2921,2921,white,age.gp1,NoTr,NoTrade,NoGroup,10,6,1,2,1,0,9,1,3,7,1,9,5,5
2929,2930,2930,white,age.gp4,NoTr,NoTrade,Group,20,1,6,8,5,1,18,1,13,7,3,17,18,2
331,332,332,white,age.gp1,NoTr,NoTrade,NoGroup,11,6,2,3,0,1,7,3,1,10,5,6,9,2
332,333,333,white,age.gp2,Tr,NoTrade,NoGroup,18,2,8,6,2,2,14,2,7,11,1,17,8,10
901,902,902,other,age.gp1,Tr,NoTrade,NoGroup,5,2,1,2,0,1,4,0,2,3,0,5,3,2
968,969,969,white,age.gp2,Tr,NoTrade,Group,29,4,11,7,7,0,25,4,9,20,2,27,23,6
1404,1405,1405,white,age.gp3,NoTr,NoTrade,Group,18,2,4,7,5,2,14,2,6,12,0,18,13,5
1710,1711,1711,white,age.gp2,Tr,NoTrade,Group,24,3,5,10,6,1,20,3,10,14,1,23,14,10
1711,1712,1712,white,age.gp2,Tr,NoTrade,Group,27,2,12,7,6,0,22,5,10,17,2,25,16,11
2032,2033,2033,white,age.gp4,Tr,NoTrade,Group,11,0,1,4,6,3,8,0,1,10,0,11,8,3
2072,2073,2073,white,age.gp3,Tr,NoTrade,Group,17,1,6,7,3,2,14,1,8,9,0,17,12,5
2336,2337,2337,white,age.gp3,Tr,NoTrade,Group,23,3,6,8,6,2,19,2,10,13,2,21,13,10
2391,2392,2392,black,age.gp2,NoTr,NoTrade,NoGroup,7,1,2,1,3,3,3,1,0,7,0,7,2,5
823,824,824,white,age.gp3,NoTr,NoTrade,NoGroup,9,0,3,3,3,1,8,0,3,6,0,9,5,4
876,877,877,white,age.gp3,NoTr,Trade,Group,18,2,2,11,3,0,17,1,6,12,3,15,14,4
1055,1056,1056,white,age.gp4,NoTr,NoTrade,Group,11,0,3,5,3,0,10,1,3,8,1,10,7,4
1464,1465,1465,white,age.gp2,NoTr,Trade,Group,13,4,3,5,1,0,9,4,4,9,1,12,8,5
1873,1874,1874,other,age.gp1,NoTr,NoTrade,Group,12,5,3,3,1,2,10,0,4,8,1,11,5,7
1893,1894,1894,other,age.gp1,NoTr,NoTrade,Group,11,5,1,2,3,1,10,0,4,7,1,10,4,7
2333,2334,2334,white,age.gp3,Tr,NoTrade,Group,24,4,10,5,5,2,19,3,6,18,1,23,20,4
2519,2520,2520,black,age.gp2,NoTr,NoTrade,Group,17,0,6,10,1,8,9,0,7,10,1,16,12,5
2777,2778,2778,white,age.gp3,NoTr,NoTrade,Group,16,1,5,7,3,0,14,2,8,8,1,15,13,3
98,99,99,white,age.gp3,NoTr,NoTrade,Group,19,2,7,6,4,4,15,0,9,10,2,17,11,8
167,168,168,white,age.gp3,NoTr,NoTrade,NoGroup,8,0,4,2,2,0,7,1,3,5,0,8,8,0
186,187,187,white,age.gp3,Tr,NoTrade,NoGroup,7,1,2,3,1,0,7,0,1,6,1,6,5,2
655,656,656,white,age.gp2,Tr,NoTrade,NoGroup,10,1,4,3,2,2,7,1,3,7,0,10,6,4
948,949,949,white,age.gp3,Tr,NoTrade,Group,16,1,8,5,2,0,14,2,5,11,0,16,12,4
1007,1008,1008,white,age.gp1,Tr,NoTrade,Group,30,11,9,8,2,2,25,3,9,21,2,28,18,12
1471,1472,1472,white,age.gp1,NoTr,NoTrade,NoGroup,13,7,3,2,1,1,11,1,3,10,1,12,7,6
1565,1566,1566,white,age.gp4,Tr,NoTrade,Group,16,1,2,5,8,2,11,3,2,14,0,16,9,7
1601,1602,1602,white,age.gp2,Tr,NoTrade,NoGroup,14,0,5,3,6,2,11,1,3,11,2,12,9,5
2063,2064,2064,white,age.gp3,Tr,NoTrade,Group,22,2,9,8,3,4,17,1,7,15,1,21,17,5
2237,2238,2238,black,age.gp4,NoTr,Trade,Group,9,1,1,1,6,3,6,0,3,6,0,9,6,3
2623,2624,2624,white,age.gp4,NoTr,NoTrade,NoGroup,7,0,2,3,2,0,7,0,2,5,0,7,7,0
1857,1858,1858,white,age.gp3,NoTr,NoTrade,Group,15,5,2,5,3,0,14,1,5,10,0,15,9,6
2327,2328,2328,white,age.gp3,Tr,NoTrade,Group,16,1,8,1,6,1,12,3,7,9,1,15,11,5
2582,2583,2583,white,age.gp4,NoTr,NoTrade,Group,12,0,5,5,2,2,10,0,3,9,2,10,10,2
2817,2818,2818,other,age.gp2,NoTr,NoTrade,NoGroup,7,1,1,4,1,1,6,0,0,7,0,7,3,4
2969,2970,2970,white,age.gp2,NoTr,NoTrade,Group,22,0,11,6,5,1,19,2,13,9,0,22,15,7
363,364,364,black,age.gp4,NoTr,NoTrade,NoGroup,2,0,1,1,0,1,1,0,0,2,0,2,2,0
556,557,557,white,age.gp4,NoTr,NoTrade,NoGroup,1,0,0,1,0,0,1,0,0,1,0,1,1,0
710,711,711,white,age.gp2,Tr,NoTrade,Group,20,2,6,8,4,3,14,3,4,16,1,19,9,11
942,943,943,white,age.gp3,Tr,NoTrade,Group,14,1,6,4,3,0,13,1,4,10,0,14,9,5
1050,1051,1051,black,age.gp4,NoTr,NoTrade,NoGroup,3,0,0,1,2,1,2,0,0,3,0,3,2,1
2649,2650,2650,white,age.gp2,NoTr,NoTrade,Group,18,1,6,8,3,2,15,1,10,8,1,17,15,3
2786,2787,2787,white,age.gp3,NoTr,NoTrade,Group,16,1,4,9,2,2,14,0,5,11,1,15,8,8
101,102,102,white,age.gp3,NoTr,NoTrade,Group,17,2,6,7,2,1,14,2,9,8,3,14,9,8
622,623,623,other,age.gp1,NoTr,Trade,Group,13,3,5,3,2,1,12,0,5,8,0,13,7,6
709,710,710,white,age.gp2,Tr,NoTrade,Group,27,6,5,9,7,4,20,3,10,17,4,23,18,9
1137,1138,1138,white,age.gp2,Tr,NoTrade,Group,23,2,11,7,3,2,16,5,6,17,2,21,13,10
1333,1334,1334,white,age.gp3,NoTr,NoTrade,NoGroup,7,0,2,2,3,1,6,0,4,3,1,6,5,2
1600,1601,1601,white,age.gp2,Tr,NoTrade,NoGroup,14,2,7,2,3,1,11,2,4,10,3,11,9,5
2154,2155,2155,other,age.gp2,NoTr,NoTrade,NoGroup,5,1,1,2,1,0,5,0,1,4,0,5,3,2
2426,2427,2427,white,age.gp4,NoTr,NoTrade,NoGroup,4,1,0,2,1,0,4,0,1,3,0,4,2,2
2686,2687,2687,black,age.gp3,NoTr,NoTrade,NoGroup,4,0,2,1,1,1,3,0,2,2,0,4,2,2
102,103,103,white,age.gp3,NoTr,NoTrade,Group,13,2,8,2,1,0,10,3,6,7,1,12,7,6
667,668,668,white,age.gp2,Tr,NoTrade,NoGroup,8,0,5,2,1,0,8,0,7,1,0,8,5,3
854,855,855,other,age.gp2,Tr,NoTrade,Group,4,0,2,1,1,0,4,0,1,3,0,4,3,1
1721,1722,1722,white,age.gp2,NoTr,NoTrade,Group,18,1,9,6,2,3,14,1,11,7,1,17,15,3
1986,1987,1987,white,age.gp4,Tr,NoTrade,NoGroup,2,1,0,1,0,0,2,0,0,2,0,2,1,1
2114,2115,2115,white,age.gp2,NoTr,NoTrade,NoGroup,11,0,7,3,1,0,11,0,7,4,1,10,8,3
2321,2322,2322,white,age.gp1,NoTr,NoTrade,NoGroup,13,5,5,3,0,1,7,5,2,11,1,12,5,8
2475,2476,2476,white,age.gp2,Tr,NoTrade,Group,17,1,10,6,0,3,12,2,5,12,0,17,11,6
2535,2536,2536,other,age.gp1,NoTr,NoTrade,NoGroup,9,3,4,2,0,1,8,0,5,4,2,7,6,3
2827,2828,2828,other,age.gp2,NoTr,NoTrade,NoGroup,5,0,1,2,2,0,5,0,3,2,0,5,5,0
334,335,335,white,age.gp2,Tr,NoTrade,NoGroup,9,1,5,3,0,1,6,2,3,6,0,9,7,2
754,755,755,white,age.gp4,NoTr,NoTrade,NoGroup,9,2,1,2,4,1,8,0,4,5,0,9,5,4
1028,1029,1029,black,age.gp4,NoTr,NoTrade,NoGroup,4,0,2,1,1,2,2,0,0,4,1,3,2,2
1058,1059,1059,white,age.gp4,NoTr,NoTrade,Group,15,0,2,3,10,1,14,0,5,10,0,15,14,1
1203,1204,1204,white,age.gp4,Tr,NoTrade,NoGroup,5,0,0,3,2,1,4,0,0,5,0,5,3,2
1247,1248,1248,white,age.gp1,NoTr,NoTrade,NoGroup,9,5,2,1,1,0,9,0,2,7,1,8,4,5
1605,1606,1606,white,age.gp3,Tr,NoTrade,NoGroup,7,1,1,3,2,0,7,0,2,5,1,6,7,0
1715,1716,1716,white,age.gp1,Tr,NoTrade,NoGroup,9,3,2,2,2,0,7,2,4,5,0,9,5,4
1724,1725,1725,white,age.gp1,Tr,NoTrade,NoGroup,9,5,0,2,2,1,6,2,1,8,1,8,4,5
2111,2112,2112,white,age.gp2,NoTr,NoTrade,NoGroup,10,1,5,3,1,1,8,1,4,6,0,10,7,3
2126,2127,2127,white,age.gp3,NoTr,NoTrade,Group,19,1,12,4,2,1,17,1,13,6,0,19,12,7
2289,2290,2290,other,age.gp2,Tr,NoTrade,Group,9,0,3,5,1,1,8,0,1,8,2,7,7,2
2337,2338,2338,white,age.gp3,Tr,NoTrade,Group,19,3,3,5,8,1,17,1,3,16,2,17,12,7
2528,2529,2529,white,age.gp2,NoTr,NoTrade,Group,19,4,7,5,3,1,14,4,10,9,0,19,14,5
2597,2598,2598,white,age.gp3,NoTr,NoTrade,Group,29,3,15,9,2,5,22,2,14,15,3,26,20,9
104,105,105,white,age.gp3,NoTr,NoTrade,Group,19,1,6,6,6,0,15,4,7,12,0,19,10,9
210,211,211,other,age.gp2,Tr,NoTrade,NoGroup,4,1,0,2,1,0,4,0,1,3,0,4,3,1
845,846,846,white,age.gp2,Tr,NoTrade,NoGroup,7,1,2,3,1,0,6,1,1,6,0,7,2,5
922,923,923,white,age.gp2,NoTr,NoTrade,NoGroup,11,0,5,2,4,0,11,0,9,2,0,11,10,1
1288,1289,1289,white,age.gp4,NoTr,NoTrade,Group,15,2,2,4,7,0,15,0,4,11,0,15,12,3
1607,1608,1608,white,age.gp3,Tr,NoTrade,NoGroup,10,1,2,3,4,1,8,1,2,8,0,10,7,3
1864,1865,1865,white,age.gp3,NoTr,NoTrade,Group,18,3,8,4,3,4,12,2,10,8,1,17,11,7
1906,1907,1907,other,age.gp2,NoTr,NoTrade,NoGroup,5,1,1,2,1,1,4,0,2,3,0,5,3,2
2055,2056,2056,white,age.gp4,Tr,NoTrade,Group,15,2,3,5,5,1,11,3,6,9,0,15,7,8
2171,2172,2172,white,age.gp2,NoTr,NoTrade,Group,20,4,10,4,2,1,16,3,11,9,1,19,15,5
2401,2402,2402,white,age.gp3,NoTr,NoTrade,NoGroup,11,0,5,5,1,2,7,2,4,7,1,10,6,5
2908,2909,2909,other,age.gp1,NoTr,NoTrade,NoGroup,3,0,0,3,0,1,2,0,0,3,0,3,1,2
105,106,106,white,age.gp3,NoTr,NoTrade,Group,16,3,6,6,1,1,12,3,6,10,2,14,7,9
851,852,852,other,age.gp2,Tr,NoTrade,Group,9,0,4,3,2,0,9,0,3,6,0,9,6,3
875,876,876,white,age.gp3,NoTr,Trade,Group,24,4,8,6,6,2,18,4,7,17,2,22,14,10
1178,1179,1179,white,age.gp4,Tr,NoTrade,NoGroup,7,0,2,3,2,0,6,1,3,4,0,7,5,2
1344,1345,1345,white,age.gp1,Tr,NoTrade,NoGroup,14,9,0,1,4,0,12,2,3,11,2,12,8,6
1389,1390,1390,black,age.gp3,NoTr,NoTrade,NoGroup,5,2,1,2,0,1,4,0,0,5,0,5,3,2
2145,2146,2146,other,age.gp2,NoTr,NoTrade,NoGroup,4,1,1,2,0,0,4,0,2,2,0,4,4,0
2549,2550,2550,other,age.gp1,NoTr,NoTrade,NoGroup,2,0,0,1,1,0,2,0,0,2,0,2,2,0
2881,2882,2882,white,age.gp2,NoTr,NoTrade,NoGroup,13,0,9,3,1,1,10,2,6,7,0,13,11,2
2975,2976,2976,white,age.gp1,NoTr,NoTrade,Group,19,7,6,3,3,2,13,4,10,9,0,19,12,7
106,107,107,white,age.gp2,NoTr,NoTrade,NoGroup,7,0,5,2,0,0,5,2,3,4,0,7,6,1
198,199,199,other,age.gp2,Tr,NoTrade,NoGroup,6,0,4,1,1,0,6,0,1,5,0,6,3,3
703,704,704,white,age.gp2,NoTr,NoTrade,Group,24,3,14,5,2,2,19,3,11,13,0,24,15,9
1399,1400,1400,white,age.gp3,NoTr,NoTrade,Group,19,4,5,5,5,2,14,3,7,12,0,19,13,6
2287,2288,2288,other,age.gp2,Tr,NoTrade,Group,9,0,4,3,2,0,9,0,3,6,0,9,4,5
2476,2477,2477,white,age.gp2,Tr,NoTrade,Group,26,4,13,6,3,2,19,5,10,16,1,25,15,11
2601,2602,2602,white,age.gp3,NoTr,NoTrade,Group,22,2,8,9,3,2,19,1,8,14,3,19,18,4
2971,2972,2972,white,age.gp2,NoTr,NoTrade,Group,17,2,9,5,1,3,14,0,5,12,4,13,12,5
174,175,175,white,age.gp3,NoTr,NoTrade,NoGroup,8,1,2,2,3,0,7,1,3,5,0,8,3,5
689,690,690,white,age.gp4,Tr,NoTrade,Group,13,1,4,2,6,3,9,1,7,6,2,11,10,3
1142,1143,1143,white,age.gp1,NoTr,NoTrade,NoGroup,8,6,1,0,1,1,5,2,0,8,0,8,1,7
1419,1420,1420,white,age.gp2,NoTr,NoTrade,Group,27,5,11,8,3,2,23,2,11,16,1,26,16,11
1567,1568,1568,white,age.gp4,Tr,NoTrade,Group,12,0,4,2,6,0,10,2,6,6,0,12,8,4
2173,2174,2174,white,age.gp2,NoTr,NoTrade,Group,34,3,23,4,4,1,31,2,17,17,0,34,23,11
2873,2874,2874,white,age.gp1,NoTr,NoTrade,NoGroup,10,4,2,3,1,1,6,3,4,6,1,9,6,4
108,109,109,white,age.gp2,NoTr,NoTrade,NoGroup,10,2,2,4,2,3,7,0,3,7,1,9,4,6
514,515,515,black,age.gp3,NoTr,NoTrade,NoGroup,5,1,2,1,1,2,3,0,1,4,0,5,2,3
1057,1058,1058,white,age.gp4,NoTr,NoTrade,Group,7,2,1,1,3,1,6,0,2,5,0,7,4,3
1258,1259,1259,white,age.gp1,Tr,Trade,Group,24,11,6,3,4,2,17,5,6,18,2,22,11,13
1338,1339,1339,white,age.gp3,NoTr,NoTrade,NoGroup,7,0,5,1,1,0,6,1,4,3,0,7,4,3
1671,1672,1672,white,age.gp2,Tr,NoTrade,NoGroup,10,0,6,2,2,1,8,1,6,4,0,10,7,3
2513,2514,2514,white,age.gp1,NoTr,NoTrade,NoGroup,6,1,2,2,1,0,6,0,4,2,0,6,3,3
2725,2726,2726,black,age.gp3,NoTr,NoTrade,NoGroup,10,0,5,3,2,3,7,0,5,5,1,9,6,4
109,110,110,white,age.gp2,NoTr,NoTrade,NoGroup,4,1,2,0,1,0,2,2,3,1,0,4,2,2
897,898,898,other,age.gp1,Tr,NoTrade,NoGroup,7,2,4,1,0,1,6,0,1,6,0,7,3,4
2267,2268,2268,white,age.gp4,Tr,NoTrade,Group,14,0,2,3,9,3,9,2,3,11,0,14,7,7
110,111,111,white,age.gp2,NoTr,NoTrade,NoGroup,16,0,13,1,2,1,13,2,10,6,0,16,10,6
656,657,657,white,age.gp2,Tr,NoTrade,NoGroup,10,3,4,1,2,0,8,2,1,9,0,10,5,5
658,659,659,white,age.gp2,Tr,NoTrade,NoGroup,7,1,2,1,3,1,5,1,3,4,0,7,4,3
688,689,689,white,age.gp4,Tr,NoTrade,Group,19,1,4,5,9,0,18,1,8,11,1,18,10,9
1099,1100,1100,white,age.gp2,NoTr,NoTrade,Group,26,2,12,7,5,3,20,3,8,18,1,25,15,11
1317,1318,1318,white,age.gp2,NoTr,NoTrade,NoGroup,12,2,8,2,0,1,9,2,5,7,1,11,6,6
1652,1653,1653,other,age.gp2,NoTr,NoTrade,NoGroup,5,0,3,1,1,0,5,0,2,3,1,4,4,1
2198,2199,2199,white,age.gp4,NoTr,NoTrade,NoGroup,5,1,2,2,0,0,3,2,1,4,2,3,2,3
2343,2344,2344,white,age.gp2,Tr,NoTrade,Group,26,3,13,4,6,6,18,2,9,17,2,24,15,11
2957,2958,2958,white,age.gp2,Tr,NoTrade,Group,20,1,7,10,2,2,18,0,6,14,0,20,12,8
111,112,112,white,age.gp3,NoTr,NoTrade,NoGroup,6,1,3,2,0,0,5,1,5,1,0,6,3,3
1441,1442,1442,white,age.gp3,Tr,NoTrade,NoGroup,6,0,3,2,1,0,5,1,1,5,0,6,3,3
2956,2957,2957,white,age.gp2,Tr,NoTrade,Group,32,6,12,5,9,3,22,7,10,22,4,28,22,10
112,113,113,white,age.gp3,NoTr,NoTrade,NoGroup,7,0,3,2,2,1,6,0,3,4,1,6,4,3
1957,1958,1958,white,age.gp4,NoTr,NoTrade,Group,14,1,1,4,8,1,12,1,2,12,1,13,9,5
2310,2311,2311,white,age.gp2,Tr,NoTrade,NoGroup,10,1,5,4,0,1,9,0,5,5,0,10,8,2
113,114,114,white,age.gp3,NoTr,NoTrade,NoGroup,6,1,3,2,0,0,5,1,3,3,0,6,6,0
2060,2061,2061,white,age.gp3,Tr,NoTrade,Group,18,3,3,4,8,2,14,2,7,11,0,18,9,9
2955,2956,2956,white,age.gp2,Tr,NoTrade,Group,22,3,11,4,4,1,18,3,9,13,0,22,14,8
240,241,241,white,age.gp2,Tr,NoTrade,Group,24,4,10,4,6,2,19,3,7,17,3,21,17,7
885,886,886,white,age.gp3,NoTr,Trade,Group,12,1,4,5,2,1,11,0,5,7,1,11,9,3
917,918,918,white,age.gp1,NoTr,Trade,NoGroup,16,5,5,4,2,1,11,4,4,12,2,14,7,9
935,936,936,white,age.gp3,NoTr,NoTrade,NoGroup,10,2,4,1,3,1,6,3,4,6,0,10,5,5
2340,2341,2341,white,age.gp2,Tr,NoTrade,Group,17,2,5,3,7,2,14,1,6,11,3,14,9,8
2242,2243,2243,white,age.gp4,Tr,NoTrade,Group,14,2,2,3,7,1,11,2,5,9,0,14,7,7
2585,2586,2586,white,age.gp4,NoTr,NoTrade,Group,9,2,1,3,3,0,8,1,2,7,3,6,6,3
116,117,117,white,age.gp3,NoTr,NoTrade,NoGroup,5,0,2,2,1,0,4,1,3,2,0,5,4,1
1429,1430,1430,white,age.gp3,Tr,NoTrade,NoGroup,11,2,4,2,3,0,9,2,5,6,1,10,6,5
2842,2843,2843,white,age.gp2,Tr,NoTrade,Group,14,1,5,6,2,2,11,1,2,12,1,13,9,5
117,118,118,white,age.gp3,NoTr,NoTrade,NoGroup,5,1,3,1,0,1,2,2,1,4,2,3,4,1
640,641,641,other,age.gp1,NoTr,Trade,Group,10,2,6,2,0,2,8,0,5,5,1,9,6,4
848,849,849,other,age.gp2,Tr,NoTrade,Group,7,0,3,2,2,0,7,0,2,5,0,7,5,2
2375,2376,2376,white,age.gp2,NoTr,NoTrade,NoGroup,14,1,6,7,0,0,12,2,7,7,1,13,10,4
118,119,119,white,age.gp3,NoTr,NoTrade,NoGroup,1,1,0,0,0,0,1,0,1,0,0,1,0,1
119,120,120,white,age.gp3,NoTr,NoTrade,NoGroup,7,2,1,2,2,0,6,1,4,3,1,6,5,2
1790,1791,1791,white,age.gp4,Tr,NoTrade,Group,14,0,4,2,8,2,11,1,4,10,0,14,9,5
1951,1952,1952,white,age.gp4,NoTr,NoTrade,Group,17,1,1,3,12,4,13,0,5,12,2,15,8,9
2465,2466,2466,white,age.gp1,Tr,NoTrade,NoGroup,14,3,4,4,3,1,11,2,4,10,0,14,6,8
2832,2833,2833,white,age.gp2,Tr,NoTrade,NoGroup,7,1,2,2,2,0,7,0,3,4,1,6,4,3
120,121,121,white,age.gp3,NoTr,NoTrade,NoGroup,10,0,3,4,3,3,7,0,2,8,4,6,6,4
381,382,382,black,age.gp4,NoTr,NoTrade,NoGroup,7,0,1,2,4,3,3,1,2,5,0,7,3,4
886,887,887,white,age.gp3,NoTr,Trade,Group,12,1,4,4,3,1,11,0,6,6,0,12,8,4
1989,1990,1990,white,age.gp4,Tr,NoTrade,NoGroup,5,0,2,2,1,1,4,0,1,4,1,4,4,1
2108,2109,2109,white,age.gp2,NoTr,NoTrade,NoGroup,13,3,5,1,4,1,8,4,6,7,1,12,9,4
2410,2411,2411,white,age.gp3,NoTr,Trade,Group,13,0,5,5,3,0,13,0,2,11,1,12,10,3
2563,2564,2564,white,age.gp4,NoTr,NoTrade,Group,11,1,3,2,5,1,10,0,3,8,0,11,6,5
2776,2777,2777,white,age.gp3,NoTr,NoTrade,Group,18,2,6,6,4,2,15,1,8,10,4,14,12,6
121,122,122,white,age.gp3,NoTr,NoTrade,NoGroup,6,3,1,2,0,2,4,0,3,3,1,5,1,5
327,328,328,white,age.gp1,NoTr,NoTrade,NoGroup,14,9,1,4,0,0,9,5,5,9,1,13,4,10
1597,1598,1598,black,age.gp1,Tr,Trade,NoGroup,9,2,3,3,1,3,5,1,2,7,1,8,6,3
1613,1614,1614,white,age.gp3,Tr,NoTrade,NoGroup,6,0,3,1,2,0,5,1,2,4,0,6,3,3
2771,2772,2772,white,age.gp1,NoTr,NoTrade,NoGroup,11,5,3,3,0,1,5,5,3,8,0,11,5,6
122,123,123,white,age.gp3,NoTr,NoTrade,NoGroup,13,4,5,1,3,0,9,4,5,8,3,10,6,7
132,133,133,white,age.gp2,NoTr,NoTrade,NoGroup,12,3,4,3,2,0,10,2,4,8,2,10,9,3
408,409,409,white,age.gp2,Tr,Trade,Group,23,2,12,8,1,1,21,1,8,15,1,22,15,8
846,847,847,other,age.gp2,Tr,NoTrade,Group,11,0,5,3,3,1,10,0,5,6,0,11,7,4
1697,1698,1698,white,age.gp4,NoTr,Trade,NoGroup,4,0,2,1,1,0,4,0,2,2,0,4,2,2
2284,2285,2285,other,age.gp2,Tr,NoTrade,Group,9,0,4,5,0,1,8,0,3,6,0,9,6,3
2438,2439,2439,white,age.gp4,NoTr,NoTrade,NoGroup,2,0,1,1,0,0,2,0,1,1,0,2,0,2
2467,2468,2468,white,age.gp1,NoTr,NoTrade,NoGroup,12,5,2,4,1,0,10,2,6,6,2,10,6,6
2478,2479,2479,other,age.gp1,NoTr,NoTrade,NoGroup,7,4,0,2,1,0,7,0,1,6,2,5,4,3
2919,2920,2920,white,age.gp1,NoTr,NoTrade,NoGroup,12,4,1,7,0,1,10,1,4,8,2,10,7,5
123,124,124,white,age.gp3,NoTr,NoTrade,NoGroup,4,1,1,1,1,0,3,1,2,2,1,3,3,1
628,629,629,other,age.gp1,NoTr,Trade,Group,1,0,0,1,0,0,1,0,0,1,0,1,0,1
124,125,125,white,age.gp3,NoTr,NoTrade,NoGroup,6,0,2,3,1,0,6,0,3,3,1,5,6,0
691,692,692,white,age.gp4,Tr,NoTrade,Group,12,1,4,4,3,0,11,1,4,8,0,12,5,7
2960,2961,2961,white,age.gp2,NoTr,NoTrade,Group,16,0,12,4,0,1,11,4,8,8,4,12,11,5
219,220,220,other,age.gp2,Tr,NoTrade,NoGroup,4,0,1,1,2,1,3,0,2,2,1,3,2,2
824,825,825,white,age.gp3,NoTr,NoTrade,NoGroup,3,0,1,2,0,0,2,1,1,2,0,3,1,2
2724,2725,2725,black,age.gp3,NoTr,NoTrade,NoGroup,7,1,1,3,2,3,3,1,2,5,0,7,4,3
126,127,127,white,age.gp1,NoTr,NoTrade,NoGroup,7,3,3,1,0,0,7,0,3,4,3,4,5,2
1254,1255,1255,white,age.gp1,Tr,Trade,Group,32,18,5,4,5,4,23,5,6,26,1,31,18,14
1463,1464,1464,white,age.gp1,NoTr,NoTrade,NoGroup,12,8,4,0,0,0,9,3,1,11,2,10,5,7
2643,2644,2644,white,age.gp1,NoTr,NoTrade,NoGroup,15,9,2,3,1,0,12,3,5,10,4,11,10,5
127,128,128,white,age.gp1,NoTr,NoTrade,NoGroup,13,7,4,1,1,3,7,3,4,9,3,10,8,5
641,642,642,other,age.gp1,NoTr,Trade,Group,10,5,2,3,0,0,9,1,3,7,0,10,5,5
715,716,716,black,age.gp4,NoTr,NoTrade,NoGroup,3,1,0,1,1,1,2,0,1,2,0,3,1,2
1138,1139,1139,white,age.gp1,NoTr,NoTrade,NoGroup,10,5,1,1,3,2,8,0,1,9,0,10,4,6
1380,1381,1381,white,age.gp1,NoTr,NoTrade,NoGroup,16,10,2,2,2,1,11,4,2,14,2,14,4,12
1644,1645,1645,other,age.gp2,NoTr,NoTrade,NoGroup,7,1,4,1,1,1,6,0,3,4,0,7,4,3
1667,1668,1668,black,age.gp1,Tr,Trade,Group,13,6,3,3,1,7,5,1,2,11,1,12,5,8
2326,2327,2327,white,age.gp3,Tr,NoTrade,Group,20,2,4,10,4,2,16,2,6,14,3,17,12,8
2457,2458,2458,black,age.gp1,NoTr,NoTrade,NoGroup,6,2,3,0,1,2,2,2,1,5,0,6,1,5
128,129,129,white,age.gp1,NoTr,NoTrade,NoGroup,10,4,4,0,2,0,8,2,4,6,0,10,4,6
286,287,287,white,age.gp1,NoTr,NoTrade,NoGroup,12,7,3,1,1,1,8,3,2,10,2,10,8,4
509,510,510,white,age.gp2,Tr,NoTrade,NoGroup,7,1,4,1,1,0,7,0,2,5,0,7,5,2
1012,1013,1013,white,age.gp1,Tr,NoTrade,NoGroup,13,7,3,2,1,0,11,2,3,10,0,13,5,8
2255,2256,2256,white,age.gp4,Tr,NoTrade,Group,12,4,1,1,6,3,7,2,4,8,0,12,6,6
2807,2808,2808,other,age.gp2,NoTr,NoTrade,NoGroup,4,1,0,1,2,0,4,0,0,4,0,4,3,1
2897,2898,2898,other,age.gp1,NoTr,NoTrade,NoGroup,4,2,1,1,0,0,4,0,1,3,0,4,2,2
2949,2950,2950,white,age.gp4,NoTr,NoTrade,Group,8,1,4,1,2,0,7,1,4,4,0,8,6,2
129,130,130,white,age.gp1,NoTr,NoTrade,NoGroup,6,3,0,0,3,1,5,0,3,3,1,5,1,5
1191,1192,1192,white,age.gp4,Tr,NoTrade,NoGroup,4,1,0,1,2,1,3,0,0,4,1,3,2,2
1201,1202,1202,white,age.gp4,Tr,NoTrade,NoGroup,4,1,1,0,2,1,3,0,0,4,0,4,2,2
1340,1341,1341,white,age.gp1,Tr,NoTrade,NoGroup,9,5,1,1,2,0,8,1,3,6,0,9,4,5
1478,1479,1479,black,age.gp1,NoTr,NoTrade,NoGroup,10,5,1,3,1,3,6,1,5,5,0,10,2,8
1706,1707,1707,white,age.gp4,NoTr,Trade,NoGroup,5,1,2,1,1,1,4,0,1,4,0,5,1,4
2976,2977,2977,white,age.gp1,NoTr,NoTrade,Group,19,8,5,3,3,2,15,2,9,10,2,17,10,9
130,131,131,white,age.gp1,NoTr,NoTrade,NoGroup,11,7,3,1,0,2,8,1,4,7,1,10,5,6
1315,1316,1316,white,age.gp2,NoTr,NoTrade,NoGroup,13,1,6,2,4,2,11,0,5,8,1,12,10,3
1324,1325,1325,white,age.gp2,Tr,NoTrade,Group,20,5,9,4,2,4,13,3,6,14,4,16,12,8
1449,1450,1450,black,age.gp1,NoTr,NoTrade,NoGroup,11,5,5,1,0,6,5,0,3,8,1,10,5,6
1737,1738,1738,white,age.gp3,Tr,NoTrade,Group,19,2,9,3,5,2,14,3,5,14,3,16,9,10
1902,1903,1903,black,age.gp1,NoTr,NoTrade,NoGroup,5,1,0,2,2,2,2,1,0,5,1,4,2,3
2470,2471,2471,white,age.gp1,NoTr,NoTrade,NoGroup,12,4,5,2,1,1,10,1,2,10,2,10,7,5
131,132,132,white,age.gp2,NoTr,NoTrade,NoGroup,12,2,6,3,1,0,12,0,5,7,2,10,10,2
236,237,237,white,age.gp2,Tr,NoTrade,Group,18,2,7,5,4,1,16,1,9,9,2,16,12,6
546,547,547,white,age.gp4,NoTr,NoTrade,NoGroup,5,1,2,1,1,0,5,0,2,3,0,5,3,2
1005,1006,1006,white,age.gp1,Tr,NoTrade,Group,24,9,5,4,6,2,19,3,4,20,3,21,13,11
1435,1436,1436,white,age.gp3,Tr,NoTrade,NoGroup,8,1,4,0,3,1,7,0,5,3,0,8,6,2
1466,1467,1467,white,age.gp2,NoTr,Trade,Group,19,1,10,3,5,1,15,3,8,11,1,18,10,9
1736,1737,1737,white,age.gp3,Tr,NoTrade,Group,20,3,8,5,4,1,18,1,6,14,1,19,13,7
2651,2652,2652,white,age.gp2,NoTr,NoTrade,Group,12,1,7,2,2,2,10,0,5,7,0,12,6,6
288,289,289,white,age.gp1,NoTr,NoTrade,NoGroup,9,3,4,0,2,1,6,2,4,5,1,8,4,5
638,639,639,other,age.gp1,NoTr,Trade,Group,11,4,2,2,3,1,10,0,1,10,0,11,5,6
1408,1409,1409,white,age.gp3,NoTr,NoTrade,Group,11,1,6,3,1,2,8,1,7,4,0,11,3,8
1939,1940,1940,white,age.gp4,NoTr,NoTrade,Group,16,0,6,3,7,2,13,1,7,9,2,14,12,4
2910,2911,2911,other,age.gp1,NoTr,NoTrade,NoGroup,5,1,2,1,1,0,5,0,0,5,0,5,2,3
133,134,134,white,age.gp2,NoTr,NoTrade,NoGroup,12,2,8,1,1,0,12,0,6,6,1,11,9,3
693,694,694,white,age.gp4,Tr,NoTrade,Group,9,0,1,1,7,2,7,0,3,6,0,9,4,5
1708,1709,1709,white,age.gp2,Tr,NoTrade,Group,23,2,14,2,5,3,17,3,9,14,2,21,17,6
2307,2308,2308,white,age.gp2,NoTr,NoTrade,NoGroup,6,1,2,2,1,0,5,1,2,4,0,6,4,2
2788,2789,2789,white,age.gp2,NoTr,NoTrade,Group,25,5,10,8,2,2,19,4,12,13,1,24,17,8
134,135,135,white,age.gp2,NoTr,NoTrade,NoGroup,10,0,9,1,0,0,9,1,6,4,1,9,8,2
1707,1708,1708,white,age.gp2,Tr,NoTrade,Group,26,3,12,6,5,2,21,3,10,16,3,23,18,8
2131,2132,2132,white,age.gp3,NoTr,NoTrade,Group,17,4,4,7,2,0,14,3,7,10,2,15,10,7
135,136,136,white,age.gp2,NoTr,NoTrade,NoGroup,11,1,4,3,3,0,11,0,6,5,0,11,7,4
342,343,343,white,age.gp2,NoTr,NoTrade,Group,24,1,14,5,4,3,17,4,9,15,1,23,12,12
1602,1603,1603,white,age.gp2,Tr,NoTrade,NoGroup,13,1,6,4,2,2,10,1,4,9,1,12,9,4
1978,1979,1979,white,age.gp4,Tr,NoTrade,NoGroup,4,0,1,2,1,0,4,0,1,3,1,3,1,3
2061,2062,2062,white,age.gp3,Tr,NoTrade,Group,20,3,5,5,7,1,17,2,8,12,0,20,8,12
2573,2574,2574,white,age.gp4,NoTr,NoTrade,Group,11,1,4,1,5,2,9,0,7,4,1,10,8,3
208,209,209,other,age.gp2,Tr,NoTrade,NoGroup,10,1,5,1,3,4,5,1,2,8,1,9,5,5
1273,1274,1274,white,age.gp4,NoTr,NoTrade,Group,14,1,1,4,8,3,11,0,4,10,0,14,10,4
1331,1332,1332,white,age.gp3,NoTr,NoTrade,NoGroup,9,1,5,2,1,1,7,1,2,7,1,8,4,5
1860,1861,1861,white,age.gp3,NoTr,NoTrade,Group,15,2,5,4,4,1,12,2,6,9,0,15,7,8
2132,2133,2133,other,age.gp2,NoTr,NoTrade,NoGroup,2,0,2,0,0,0,2,0,1,1,0,2,1,1
2314,2315,2315,white,age.gp2,Tr,NoTrade,NoGroup,12,0,8,3,1,0,12,0,5,7,0,12,7,5
2358,2359,2359,white,age.gp3,Tr,NoTrade,NoGroup,10,0,6,2,2,1,9,0,5,5,0,10,5,5
2670,2671,2671,white,age.gp3,NoTr,NoTrade,NoGroup,9,2,4,2,1,0,8,1,2,7,1,8,3,6
2746,2747,2747,white,age.gp2,NoTr,NoTrade,Group,21,3,10,4,4,0,18,3,9,12,1,20,15,6
1335,1336,1336,white,age.gp3,NoTr,NoTrade,NoGroup,3,0,1,1,1,0,3,0,1,2,0,3,2,1
2248,2249,2249,white,age.gp4,Tr,NoTrade,Group,18,1,6,2,9,1,16,1,4,14,1,17,11,7
2648,2649,2649,white,age.gp2,NoTr,NoTrade,Group,18,2,12,3,1,2,12,4,8,10,1,17,12,6
150,151,151,white,age.gp3,NoTr,NoTrade,Group,26,3,10,6,7,3,21,2,11,15,0,26,18,8
229,230,230,white,age.gp2,Tr,NoTrade,Group,25,0,16,5,4,3,18,4,10,15,3,22,14,11
1265,1266,1266,black,age.gp3,NoTr,NoTrade,NoGroup,5,0,2,1,2,3,2,0,1,4,0,5,3,2
2177,2178,2178,white,age.gp4,NoTr,NoTrade,NoGroup,11,1,4,1,5,2,9,0,3,8,0,11,4,7
2425,2426,2426,white,age.gp4,NoTr,NoTrade,NoGroup,6,0,2,2,2,1,4,1,1,5,1,5,3,3
2763,2764,2764,black,age.gp2,NoTr,NoTrade,NoGroup,8,1,3,2,2,3,4,1,2,6,0,8,3,5
2784,2785,2785,white,age.gp3,NoTr,NoTrade,Group,18,1,7,9,1,0,15,3,6,12,2,16,13,5
139,140,140,white,age.gp2,NoTr,NoTrade,NoGroup,11,2,2,6,1,0,10,1,8,3,0,11,8,3
148,149,149,white,age.gp3,NoTr,NoTrade,Group,19,1,7,6,5,1,16,2,8,11,0,19,14,5
943,944,944,white,age.gp3,Tr,NoTrade,Group,16,1,6,3,6,2,12,2,4,12,1,15,6,10
2265,2266,2266,white,age.gp4,Tr,NoTrade,Group,13,0,4,3,6,1,12,0,6,7,3,10,8,5
1407,1408,1408,white,age.gp3,NoTr,NoTrade,Group,15,0,9,4,2,1,11,3,8,7,0,15,8,7
1465,1466,1466,white,age.gp2,NoTr,Trade,Group,23,5,13,3,2,0,21,2,11,12,1,22,13,10
1820,1821,1821,black,age.gp4,NoTr,NoTrade,NoGroup,4,1,1,2,0,1,3,0,0,4,0,4,2,2
2805,2806,2806,other,age.gp2,NoTr,NoTrade,NoGroup,10,0,7,3,0,2,8,0,4,6,1,9,7,3
141,142,142,white,age.gp3,NoTr,NoTrade,Group,14,2,9,2,1,1,8,5,8,6,2,12,8,6
284,285,285,white,age.gp2,Tr,NoTrade,Group,17,1,8,4,4,2,13,2,7,10,0,17,12,5
909,910,910,other,age.gp1,Tr,NoTrade,NoGroup,4,1,0,3,0,1,3,0,1,3,0,4,3,1
1670,1671,1671,white,age.gp2,Tr,NoTrade,NoGroup,12,0,5,6,1,2,9,1,3,9,1,11,8,4
1801,1802,1802,white,age.gp4,Tr,NoTrade,Group,8,0,1,3,4,0,8,0,3,5,0,8,7,1
1855,1856,1856,white,age.gp3,NoTr,NoTrade,Group,19,3,4,6,6,2,16,1,7,12,3,16,11,8
2533,2534,2534,other,age.gp1,NoTr,NoTrade,NoGroup,5,3,1,1,0,0,5,0,2,3,0,5,3,2
2810,2811,2811,other,age.gp2,NoTr,NoTrade,NoGroup,5,0,3,2,0,1,4,0,1,4,1,4,5,0
2968,2969,2969,white,age.gp2,NoTr,NoTrade,Group,22,3,5,6,8,3,15,4,7,15,1,21,12,10
432,433,433,white,age.gp4,NoTr,NoTrade,NoGroup,7,0,1,1,5,0,6,1,0,7,0,7,5,2
695,696,696,white,age.gp4,Tr,NoTrade,Group,16,1,5,3,7,1,13,2,5,11,1,15,13,3
1077,1078,1078,white,age.gp4,NoTr,NoTrade,Group,11,0,2,4,5,0,11,0,4,7,1,10,8,3
1862,1863,1863,white,age.gp3,NoTr,NoTrade,Group,16,3,4,4,5,2,13,1,4,12,1,15,8,8
1919,1920,1920,other,age.gp2,NoTr,NoTrade,NoGroup,8,0,3,2,3,0,8,0,3,5,1,7,5,3
2022,2023,2023,black,age.gp4,NoTr,NoTrade,NoGroup,3,0,0,3,0,1,2,0,0,3,1,2,3,0
2122,2123,2123,white,age.gp3,NoTr,NoTrade,Group,19,4,6,4,5,0,18,1,7,12,1,18,11,8
143,144,144,white,age.gp3,NoTr,NoTrade,Group,21,4,6,7,4,2,14,5,6,15,2,19,14,7
175,176,176,white,age.gp3,NoTr,NoTrade,NoGroup,9,1,6,1,1,0,6,3,4,5,1,8,7,2
645,646,646,other,age.gp1,NoTr,Trade,Group,10,5,2,3,0,0,10,0,4,6,1,9,5,5
961,962,962,black,age.gp2,NoTr,NoTrade,Group,12,3,5,3,1,7,5,0,2,10,1,11,7,5
1069,1070,1070,white,age.gp4,NoTr,NoTrade,Group,7,0,0,3,4,1,6,0,2,5,1,6,5,2
1169,1170,1170,white,age.gp4,NoTr,NoTrade,NoGroup,7,0,0,2,5,1,6,0,2,5,0,7,4,3
1886,1887,1887,other,age.gp1,NoTr,NoTrade,Group,11,3,1,3,4,3,8,0,3,8,2,9,7,4
2112,2113,2113,white,age.gp2,NoTr,NoTrade,NoGroup,4,1,2,1,0,0,4,0,0,4,0,4,3,1
2878,2879,2879,white,age.gp2,NoTr,NoTrade,NoGroup,13,0,7,3,3,0,12,1,7,6,0,13,11,2
144,145,145,white,age.gp3,NoTr,NoTrade,Group,13,1,3,5,4,0,12,1,5,8,0,13,8,5
185,186,186,white,age.gp3,Tr,NoTrade,NoGroup,7,0,2,1,4,0,7,0,3,4,1,6,7,0
597,598,598,other,age.gp4,NoTr,NoTrade,NoGroup,6,0,1,2,3,0,6,0,2,4,0,6,4,2
680,681,681,white,age.gp4,Tr,NoTrade,Group,6,0,0,3,3,0,6,0,2,4,0,6,5,1
1552,1553,1553,white,age.gp3,NoTr,NoTrade,Group,11,1,5,4,1,1,6,4,4,7,1,10,8,3
1598,1599,1599,white,age.gp2,Tr,NoTrade,NoGroup,10,0,3,5,2,1,9,0,3,7,1,9,6,4
1716,1717,1717,white,age.gp1,Tr,NoTrade,NoGroup,4,2,0,2,0,0,4,0,1,3,0,4,2,2
2257,2258,2258,white,age.gp4,Tr,NoTrade,Group,9,0,0,4,5,3,6,0,0,9,2,7,6,3
2700,2701,2701,white,age.gp4,NoTr,NoTrade,Group,12,1,3,2,6,1,11,0,4,8,1,11,9,3
2753,2754,2754,white,age.gp3,NoTr,NoTrade,NoGroup,12,2,5,2,3,0,7,5,6,6,1,11,8,4
2787,2788,2788,white,age.gp2,NoTr,NoTrade,Group,21,0,12,6,3,2,18,1,11,10,4,17,19,2
145,146,146,white,age.gp3,NoTr,NoTrade,Group,16,1,6,6,3,1,12,3,9,7,2,14,10,6
149,150,150,white,age.gp3,NoTr,NoTrade,Group,16,3,5,7,1,3,12,1,7,9,1,15,10,6
187,188,188,white,age.gp3,Tr,NoTrade,NoGroup,5,0,2,3,0,0,5,0,2,3,0,5,5,0
927,928,928,white,age.gp3,NoTr,NoTrade,NoGroup,5,1,1,2,1,0,4,1,4,1,0,5,4,1
950,951,951,white,age.gp3,Tr,NoTrade,Group,20,1,5,8,6,4,16,0,7,13,2,18,15,5
1063,1064,1064,white,age.gp4,NoTr,NoTrade,Group,11,0,1,3,7,1,10,0,3,8,0,11,7,4
1279,1280,1280,white,age.gp4,NoTr,NoTrade,Group,11,1,0,4,6,0,11,0,7,4,0,11,9,2
1609,1610,1610,white,age.gp3,Tr,NoTrade,NoGroup,14,3,3,4,4,1,12,1,4,10,0,14,9,5
2313,2314,2314,white,age.gp2,Tr,NoTrade,NoGroup,12,0,6,3,3,1,9,2,7,5,0,12,8,4
2472,2473,2473,white,age.gp2,Tr,NoTrade,Group,16,0,7,7,2,1,13,2,6,10,1,15,12,4
2562,2563,2563,white,age.gp4,NoTr,NoTrade,Group,9,0,2,3,4,0,9,0,6,3,0,9,4,5
146,147,147,white,age.gp3,NoTr,NoTrade,Group,18,3,6,6,3,1,16,1,6,12,2,16,14,4
232,233,233,white,age.gp2,Tr,NoTrade,Group,23,2,8,8,5,3,20,0,8,15,1,22,16,7
631,632,632,other,age.gp1,NoTr,Trade,Group,13,8,1,1,3,1,12,0,3,10,1,12,5,8
879,880,880,white,age.gp3,NoTr,Trade,Group,18,3,7,4,4,3,13,2,7,11,0,18,12,6
944,945,945,white,age.gp3,Tr,NoTrade,Group,20,3,5,8,4,1,17,2,7,13,0,20,13,7
1277,1278,1278,white,age.gp4,NoTr,NoTrade,Group,10,0,1,3,6,0,10,0,5,5,0,10,8,2
1314,1315,1315,white,age.gp1,NoTr,NoTrade,NoGroup,15,5,6,4,0,0,13,2,9,6,0,15,5,10
1325,1326,1326,white,age.gp3,NoTr,NoTrade,NoGroup,12,1,3,7,1,1,11,0,2,10,2,10,9,3
2054,2055,2055,white,age.gp4,Tr,NoTrade,Group,12,0,1,2,9,0,12,0,4,8,0,12,9,3
2110,2111,2111,white,age.gp2,NoTr,NoTrade,NoGroup,9,0,4,2,3,1,8,0,4,5,2,7,6,3
2603,2604,2604,white,age.gp3,NoTr,NoTrade,Group,17,2,1,8,6,3,13,1,6,11,0,17,11,6
2833,2834,2834,white,age.gp2,Tr,NoTrade,NoGroup,12,0,4,4,4,2,9,1,5,7,0,12,9,3
2885,2886,2886,white,age.gp1,NoTr,NoTrade,Group,24,13,3,6,2,1,20,3,8,16,3,21,13,11
452,453,453,black,age.gp3,NoTr,NoTrade,NoGroup,6,0,2,3,1,3,2,1,1,5,0,6,4,2
1021,1022,1022,white,age.gp2,NoTr,Trade,Group,16,1,9,5,1,0,13,3,6,10,1,15,8,8
1134,1135,1135,white,age.gp2,Tr,NoTrade,Group,28,3,16,3,6,0,21,7,12,16,1,27,24,4
1950,1951,1951,white,age.gp4,NoTr,NoTrade,Group,16,1,0,4,11,0,15,1,4,12,0,16,9,7
2107,2108,2108,white,age.gp2,NoTr,NoTrade,NoGroup,12,1,5,1,5,1,11,0,3,9,1,11,9,3
2109,2110,2110,white,age.gp2,NoTr,NoTrade,NoGroup,7,0,3,4,0,0,7,0,4,3,0,7,5,2
2119,2120,2120,white,age.gp3,NoTr,NoTrade,Group,20,3,5,5,7,2,15,3,5,15,4,16,15,5
2482,2483,2483,other,age.gp1,NoTr,NoTrade,NoGroup,4,2,0,1,1,0,4,0,0,4,0,4,2,2
2514,2515,2515,white,age.gp1,NoTr,NoTrade,NoGroup,9,2,1,3,3,2,6,1,2,7,1,8,4,5
707,708,708,white,age.gp2,Tr,NoTrade,Group,21,2,10,8,1,3,13,5,7,14,0,21,11,10
1151,1152,1152,white,age.gp4,NoTr,NoTrade,NoGroup,6,0,2,1,3,1,5,0,3,3,0,6,5,1
1774,1775,1775,white,age.gp4,Tr,NoTrade,Group,10,0,1,2,7,2,7,1,4,6,1,9,6,4
1788,1789,1789,white,age.gp4,Tr,NoTrade,Group,10,1,3,1,5,1,9,0,3,7,1,9,6,4
2062,2063,2063,white,age.gp3,Tr,NoTrade,Group,17,5,4,5,3,0,17,0,4,13,2,15,15,2
2439,2440,2440,white,age.gp4,NoTr,NoTrade,NoGroup,8,2,1,2,3,0,7,1,3,5,0,8,5,3
2783,2784,2784,white,age.gp3,NoTr,NoTrade,Group,21,2,8,7,4,3,16,2,7,14,2,19,13,8
2875,2876,2876,white,age.gp1,NoTr,NoTrade,NoGroup,9,3,2,3,1,1,5,3,2,7,1,8,6,3
2924,2925,2925,white,age.gp4,NoTr,NoTrade,Group,12,1,3,2,6,0,11,1,6,6,0,12,8,4
465,466,466,black,age.gp3,NoTr,Trade,Group,13,1,4,6,2,4,7,2,4,9,1,12,7,6
826,827,827,white,age.gp3,NoTr,NoTrade,NoGroup,12,1,4,2,5,2,10,0,5,7,1,11,8,4
1053,1054,1054,white,age.gp4,NoTr,NoTrade,Group,11,1,2,4,4,1,9,1,3,8,0,11,7,4
1272,1273,1273,black,age.gp3,NoTr,NoTrade,NoGroup,10,1,2,5,2,5,4,1,3,7,2,8,4,6
1616,1617,1617,white,age.gp3,Tr,NoTrade,NoGroup,9,0,5,2,2,0,8,1,4,5,1,8,7,2
1807,1808,1808,white,age.gp2,Tr,NoTrade,Group,21,1,8,7,5,2,16,3,10,11,3,18,18,3
2517,2518,2518,black,age.gp2,NoTr,NoTrade,Group,16,0,9,5,2,8,7,1,1,15,3,13,11,5
2876,2877,2877,white,age.gp1,NoTr,NoTrade,NoGroup,8,3,2,1,2,0,8,0,2,6,0,8,6,2
211,212,212,other,age.gp2,Tr,NoTrade,NoGroup,10,2,4,4,0,1,9,0,2,8,0,10,7,3
346,347,347,white,age.gp2,NoTr,NoTrade,Group,23,3,10,5,5,3,18,2,6,17,1,22,17,6
557,558,558,white,age.gp4,NoTr,NoTrade,NoGroup,3,1,1,1,0,0,1,2,1,2,0,3,2,1
1253,1254,1254,white,age.gp2,Tr,NoTrade,Group,31,3,14,9,5,3,21,7,10,21,1,30,21,10
1394,1395,1395,black,age.gp3,NoTr,NoTrade,NoGroup,7,0,4,3,0,4,2,1,1,6,1,6,4,3
1446,1447,1447,white,age.gp1,NoTr,NoTrade,NoGroup,12,4,3,3,2,1,9,2,3,9,2,10,10,2
1585,1586,1586,white,age.gp4,Tr,NoTrade,Group,14,0,2,1,11,0,14,0,3,11,0,14,13,1
1884,1885,1885,other,age.gp1,NoTr,NoTrade,Group,8,4,1,2,1,0,8,0,3,5,0,8,3,5
1941,1942,1942,white,age.gp4,NoTr,NoTrade,Group,8,0,2,3,3,0,8,0,3,5,0,8,6,2
2105,2106,2106,white,age.gp2,Tr,NoTrade,Group,31,4,17,4,6,2,24,5,14,17,1,30,21,10
2270,2271,2271,white,age.gp4,Tr,NoTrade,Group,14,2,3,4,5,1,11,2,6,8,2,12,10,4
2335,2336,2336,white,age.gp3,Tr,NoTrade,Group,13,1,8,3,1,0,11,2,5,8,1,12,7,6
2392,2393,2393,black,age.gp2,NoTr,NoTrade,NoGroup,7,1,3,2,1,3,3,1,0,7,3,4,7,0
2449,2450,2450,white,age.gp4,NoTr,NoTrade,NoGroup,5,0,2,2,1,1,4,0,3,2,0,5,5,0
151,152,152,white,age.gp3,NoTr,NoTrade,Group,16,0,8,5,3,2,14,0,8,8,2,14,12,4
777,778,778,white,age.gp4,NoTr,NoTrade,NoGroup,9,0,2,3,4,1,8,0,3,6,0,9,8,1
1393,1394,1394,black,age.gp3,NoTr,NoTrade,NoGroup,4,0,0,3,1,2,2,0,1,3,1,3,4,0
1971,1972,1972,white,age.gp4,Tr,NoTrade,NoGroup,11,1,3,1,6,2,7,2,2,9,0,11,5,6
2524,2525,2525,white,age.gp2,Tr,NoTrade,Group,17,0,12,2,3,1,14,2,6,11,1,16,13,4
2709,2710,2710,white,age.gp4,NoTr,NoTrade,Group,14,2,4,5,3,0,12,2,4,10,1,13,5,9
152,153,153,white,age.gp3,NoTr,NoTrade,Group,14,2,3,5,4,1,13,0,5,9,2,12,9,5
171,172,172,white,age.gp3,NoTr,NoTrade,NoGroup,6,1,3,1,1,1,3,2,4,2,0,6,4,2
337,338,338,white,age.gp1,NoTr,Trade,Group,12,6,2,2,2,2,7,3,4,8,1,11,7,5
929,930,930,white,age.gp3,NoTr,NoTrade,NoGroup,9,1,3,4,1,0,7,2,3,6,0,9,8,1
2231,2232,2232,black,age.gp4,NoTr,Trade,Group,6,2,1,1,2,3,3,0,0,6,2,4,4,2
153,154,154,white,age.gp3,NoTr,NoTrade,Group,16,4,7,2,3,1,13,2,6,10,3,13,10,6
341,342,342,white,age.gp1,NoTr,Trade,Group,13,10,0,1,2,0,9,4,0,13,0,13,6,7
1628,1629,1629,white,age.gp1,NoTr,NoTrade,NoGroup,15,6,4,4,1,0,15,0,5,10,1,14,9,6
1654,1655,1655,other,age.gp2,NoTr,NoTrade,NoGroup,5,1,1,3,0,1,4,0,2,3,0,5,4,1
2031,2032,2032,white,age.gp4,Tr,NoTrade,Group,23,1,5,5,12,4,17,2,6,17,3,20,13,10
2130,2131,2131,white,age.gp3,NoTr,NoTrade,Group,20,2,4,7,7,2,16,2,6,14,0,20,15,5
2469,2470,2470,white,age.gp1,NoTr,NoTrade,NoGroup,16,8,3,4,1,0,15,1,6,10,0,16,9,7
2804,2805,2805,other,age.gp2,NoTr,NoTrade,NoGroup,8,1,4,3,0,0,8,0,4,4,0,8,5,3
212,213,213,other,age.gp2,Tr,NoTrade,NoGroup,7,1,2,2,2,0,7,0,2,5,0,7,5,2
320,321,321,white,age.gp4,NoTr,NoTrade,Group,10,0,1,3,6,1,7,2,2,8,0,10,5,5
601,602,602,other,age.gp4,NoTr,NoTrade,NoGroup,3,0,0,2,1,0,3,0,2,1,0,3,2,1
675,676,676,white,age.gp4,Tr,NoTrade,Group,9,0,1,2,6,0,9,0,2,7,0,9,7,2
1942,1943,1943,white,age.gp4,NoTr,NoTrade,Group,10,0,1,2,7,0,10,0,3,7,0,10,7,3
2212,2213,2213,black,age.gp4,NoTr,Trade,Group,2,1,0,1,0,1,1,0,0,2,0,2,1,1
2399,2400,2400,white,age.gp3,NoTr,NoTrade,NoGroup,11,1,4,4,2,1,10,0,5,6,1,10,6,5
2491,2492,2492,other,age.gp1,NoTr,NoTrade,NoGroup,4,3,0,1,0,0,4,0,1,3,0,4,2,2
2665,2666,2666,white,age.gp3,NoTr,NoTrade,NoGroup,16,3,6,4,3,2,14,0,4,12,1,15,7,9
2703,2704,2704,white,age.gp4,NoTr,NoTrade,Group,8,0,1,4,3,0,8,0,2,6,1,7,5,3
2877,2878,2878,white,age.gp1,NoTr,NoTrade,NoGroup,10,6,1,2,1,0,8,2,2,8,1,9,5,5
2891,2892,2892,other,age.gp1,NoTr,NoTrade,NoGroup,6,1,1,2,2,2,4,0,2,4,0,6,3,3
1038,1039,1039,black,age.gp4,NoTr,NoTrade,NoGroup,6,0,2,2,2,4,2,0,1,5,1,5,2,4
1342,1343,1343,white,age.gp1,Tr,NoTrade,NoGroup,18,11,4,1,2,2,10,6,4,14,0,18,5,13
2049,2050,2050,white,age.gp4,Tr,NoTrade,Group,11,2,1,1,7,1,9,1,4,7,1,10,7,4
2129,2130,2130,white,age.gp3,NoTr,NoTrade,Group,13,0,3,6,4,0,13,0,6,7,1,12,9,4
2728,2729,2729,black,age.gp3,NoTr,NoTrade,NoGroup,6,0,3,1,2,3,3,0,1,5,0,6,3,3
308,309,309,white,age.gp4,NoTr,NoTrade,Group,15,2,3,6,4,2,11,2,5,10,2,13,11,4
338,339,339,white,age.gp1,NoTr,Trade,Group,24,11,7,2,4,4,16,4,7,17,2,22,13,11
1113,1114,1114,other,age.gp1,NoTr,NoTrade,NoGroup,2,2,0,0,0,0,1,1,0,2,1,1,2,0
1128,1129,1129,other,age.gp1,NoTr,NoTrade,NoGroup,2,1,0,1,0,0,2,0,1,1,0,2,2,0
1248,1249,1249,white,age.gp1,NoTr,NoTrade,NoGroup,7,5,0,1,1,0,4,3,1,6,2,5,3,4
1310,1311,1311,white,age.gp1,NoTr,NoTrade,NoGroup,12,9,2,1,0,2,7,3,6,6,3,9,7,5
1444,1445,1445,white,age.gp1,NoTr,NoTrade,NoGroup,10,6,1,1,2,1,8,1,3,7,1,9,7,3
1469,1470,1470,white,age.gp1,NoTr,NoTrade,NoGroup,12,10,2,0,0,0,11,1,3,9,2,10,7,5
1665,1666,1666,black,age.gp1,Tr,Trade,Group,13,6,4,2,1,5,8,0,4,9,3,10,5,8
1888,1889,1889,other,age.gp1,NoTr,NoTrade,Group,7,6,0,1,0,2,5,0,1,6,0,7,3,4
2135,2136,2136,other,age.gp2,NoTr,NoTrade,NoGroup,5,2,2,1,0,1,4,0,2,3,0,5,4,1
2334,2335,2335,white,age.gp3,Tr,NoTrade,Group,25,5,7,8,5,4,17,4,9,16,4,21,16,9
2380,2381,2381,white,age.gp1,NoTr,NoTrade,NoGroup,9,4,2,1,2,1,8,0,4,5,0,9,5,4
2752,2753,2753,white,age.gp3,NoTr,NoTrade,NoGroup,14,3,6,1,4,0,13,1,7,7,1,13,9,5
2768,2769,2769,white,age.gp1,NoTr,NoTrade,NoGroup,10,5,3,1,1,0,9,1,5,5,2,8,6,4
2773,2774,2774,white,age.gp3,NoTr,NoTrade,Group,13,2,3,4,4,3,9,1,5,8,2,11,8,5
2830,2831,2831,white,age.gp2,Tr,NoTrade,NoGroup,10,1,5,3,1,1,9,0,2,8,1,9,8,2
157,158,158,white,age.gp1,NoTr,NoTrade,Group,24,9,5,6,4,5,17,2,10,14,1,23,14,10
1714,1715,1715,white,age.gp1,Tr,NoTrade,NoGroup,15,11,0,4,0,2,12,1,4,11,1,14,9,6
1878,1879,1879,other,age.gp1,NoTr,NoTrade,Group,5,2,3,0,0,0,5,0,1,4,0,5,4,1
1897,1898,1898,white,age.gp1,Tr,NoTrade,NoGroup,16,9,2,2,3,1,10,5,4,12,1,15,7,9
2030,2031,2031,white,age.gp4,Tr,NoTrade,Group,14,1,6,3,4,1,11,2,6,8,0,14,8,6
2312,2313,2313,white,age.gp2,Tr,NoTrade,NoGroup,7,1,1,3,2,0,7,0,3,4,0,7,3,4
2350,2351,2351,white,age.gp3,Tr,NoTrade,NoGroup,6,3,2,0,1,1,5,0,1,5,0,6,4,2
2600,2601,2601,white,age.gp3,NoTr,NoTrade,Group,16,2,6,4,4,1,11,4,10,6,0,16,12,4
2652,2653,2653,black,age.gp1,NoTr,NoTrade,NoGroup,7,2,1,1,3,2,5,0,2,5,1,6,6,1
2800,2801,2801,white,age.gp2,NoTr,NoTrade,NoGroup,12,1,8,2,1,0,11,1,7,5,1,11,7,5
2868,2869,2869,white,age.gp1,NoTr,NoTrade,Group,32,14,6,7,5,3,23,6,11,21,3,29,17,15
2900,2901,2901,other,age.gp1,NoTr,NoTrade,NoGroup,6,3,2,0,1,0,6,0,3,3,0,6,3,3
158,159,159,white,age.gp1,NoTr,NoTrade,Group,27,16,4,2,5,0,22,5,6,21,7,20,19,8
159,160,160,white,age.gp1,NoTr,NoTrade,Group,20,10,2,2,6,2,13,5,6,14,1,19,10,10
295,296,296,white,age.gp4,NoTr,NoTrade,Group,14,1,4,2,7,1,12,1,6,8,0,14,7,7
339,340,340,white,age.gp1,NoTr,Trade,Group,17,10,5,2,0,2,9,6,6,11,1,16,10,7
340,341,341,white,age.gp1,NoTr,Trade,Group,26,12,5,7,2,3,19,4,9,17,3,23,14,12
343,344,344,white,age.gp2,NoTr,NoTrade,Group,26,4,13,6,3,3,21,2,10,16,1,25,19,7
441,442,442,white,age.gp4,NoTr,NoTrade,NoGroup,3,1,0,1,1,0,3,0,0,3,0,3,2,1
1195,1196,1196,white,age.gp4,Tr,NoTrade,NoGroup,5,2,0,0,3,1,4,0,0,5,2,3,3,2
1883,1884,1884,other,age.gp1,NoTr,NoTrade,Group,10,5,1,2,2,1,9,0,4,6,2,8,8,2
1889,1890,1890,other,age.gp1,NoTr,NoTrade,Group,9,5,3,1,0,0,9,0,4,5,1,8,6,3
2027,2028,2028,white,age.gp4,Tr,NoTrade,Group,10,1,1,3,5,0,9,1,4,6,0,10,7,3
2383,2384,2384,white,age.gp1,NoTr,NoTrade,NoGroup,8,3,2,3,0,0,6,2,3,5,0,8,4,4
2489,2490,2490,other,age.gp1,NoTr,NoTrade,NoGroup,3,1,0,1,1,0,3,0,1,2,0,3,1,2
981,982,982,white,age.gp4,NoTr,NoTrade,NoGroup,8,1,3,1,3,0,7,1,5,3,0,8,6,2
1094,1095,1095,black,age.gp1,NoTr,NoTrade,NoGroup,10,4,0,3,3,5,5,0,1,9,1,9,5,5
1458,1459,1459,white,age.gp1,NoTr,NoTrade,NoGroup,4,2,2,0,0,1,3,0,0,4,0,4,2,2
1504,1505,1505,white,age.gp4,NoTr,NoTrade,NoGroup,8,1,1,1,5,0,8,0,4,4,0,8,8,0
1771,1772,1772,black,age.gp4,NoTr,NoTrade,NoGroup,4,1,0,1,2,1,3,0,1,3,0,4,1,3
1900,1901,1901,white,age.gp1,Tr,NoTrade,NoGroup,8,2,1,2,3,0,8,0,2,6,1,7,6,2
2707,2708,2708,white,age.gp4,NoTr,NoTrade,Group,6,1,0,2,3,0,6,0,2,4,0,6,3,3
2888,2889,2889,other,age.gp1,NoTr,NoTrade,NoGroup,5,4,0,0,1,0,5,0,2,3,0,5,3,2
2893,2894,2894,other,age.gp1,NoTr,NoTrade,NoGroup,2,2,0,0,0,0,2,0,0,2,0,2,2,0
2917,2918,2918,white,age.gp1,NoTr,NoTrade,NoGroup,11,5,1,3,2,2,8,1,4,7,1,10,5,6
160,161,161,white,age.gp1,NoTr,NoTrade,Group,20,9,5,5,1,2,13,5,5,15,1,19,9,11
285,286,286,white,age.gp1,NoTr,NoTrade,NoGroup,13,9,1,0,3,0,10,3,4,9,1,12,9,4
512,513,513,black,age.gp3,NoTr,NoTrade,NoGroup,9,3,2,3,1,3,5,1,2,7,1,8,4,5
646,647,647,other,age.gp1,NoTr,Trade,Group,9,7,0,2,0,1,8,0,2,7,0,9,2,7
1015,1016,1016,white,age.gp1,NoTr,NoTrade,NoGroup,10,5,1,2,2,0,9,1,0,10,0,10,4,6
1267,1268,1268,black,age.gp3,NoTr,NoTrade,NoGroup,9,1,2,3,3,4,5,0,2,7,0,9,6,3
1882,1883,1883,other,age.gp1,NoTr,NoTrade,Group,9,3,1,3,2,2,7,0,2,7,1,8,4,5
1926,1927,1927,other,age.gp2,NoTr,NoTrade,NoGroup,5,2,2,1,0,0,5,0,3,2,0,5,4,1
2445,2446,2446,white,age.gp4,NoTr,NoTrade,NoGroup,6,1,2,0,3,1,5,0,1,5,0,6,4,2
161,162,162,white,age.gp3,NoTr,NoTrade,NoGroup,6,1,2,2,1,1,4,1,4,2,0,6,2,4
894,895,895,other,age.gp1,Tr,NoTrade,NoGroup,5,2,0,2,1,0,5,0,2,3,1,4,3,2
1153,1154,1154,white,age.gp4,NoTr,NoTrade,NoGroup,5,0,0,2,3,1,4,0,0,5,0,5,2,3
2084,2085,2085,black,age.gp3,NoTr,NoTrade,NoGroup,3,0,1,1,1,1,2,0,1,2,0,3,2,1
162,163,163,white,age.gp3,NoTr,NoTrade,NoGroup,11,0,4,4,3,2,7,2,5,6,0,11,7,4
1166,1167,1167,white,age.gp4,NoTr,NoTrade,NoGroup,1,0,0,1,0,0,1,0,0,1,0,1,0,1
1523,1524,1524,black,age.gp4,NoTr,NoTrade,NoGroup,6,0,0,2,4,3,3,0,0,6,0,6,3,3
1866,1867,1867,white,age.gp3,NoTr,NoTrade,Group,14,0,6,4,4,1,13,0,8,6,1,13,9,5
2281,2282,2282,other,age.gp2,Tr,NoTrade,Group,16,0,8,4,4,0,15,1,6,10,1,15,11,5
2300,2301,2301,other,age.gp2,Tr,NoTrade,Group,11,1,3,5,2,0,11,0,2,9,0,11,7,4
206,207,207,other,age.gp2,Tr,NoTrade,NoGroup,6,0,3,3,0,0,6,0,3,3,0,6,4,2
702,703,703,white,age.gp2,NoTr,NoTrade,Group,27,4,8,9,6,2,25,0,9,18,3,24,15,12
1726,1727,1727,white,age.gp1,Tr,NoTrade,NoGroup,6,2,1,2,1,1,3,2,1,5,2,4,3,3
2395,2396,2396,white,age.gp3,NoTr,NoTrade,NoGroup,13,0,6,3,4,0,13,0,7,6,2,11,10,3
2551,2552,2552,other,age.gp1,NoTr,NoTrade,NoGroup,7,4,2,1,0,0,7,0,4,3,1,6,3,4
458,459,459,white,age.gp1,NoTr,NoTrade,NoGroup,19,11,3,5,0,0,17,2,10,9,2,17,6,13
781,782,782,white,age.gp2,NoTr,NoTrade,NoGroup,11,1,5,5,0,1,9,1,4,7,1,10,6,5
805,806,806,white,age.gp4,NoTr,NoTrade,NoGroup,3,0,0,1,2,1,1,1,0,3,0,3,1,2
870,871,871,other,age.gp2,Tr,NoTrade,Group,10,1,4,3,2,1,9,0,3,7,1,9,5,5
2664,2665,2665,white,age.gp3,NoTr,NoTrade,NoGroup,10,1,3,5,1,2,8,0,3,7,2,8,6,4
165,166,166,white,age.gp3,NoTr,NoTrade,NoGroup,8,1,2,2,3,0,6,2,1,7,0,8,4,4
939,940,940,white,age.gp3,NoTr,NoTrade,NoGroup,7,1,2,2,2,1,5,1,2,5,2,5,4,3
1219,1220,1220,white,age.gp4,NoTr,NoTrade,NoGroup,6,2,0,1,3,0,5,1,1,5,1,5,4,2
1640,1641,1641,other,age.gp2,NoTr,NoTrade,NoGroup,4,0,1,2,1,0,4,0,2,2,0,4,3,1
1869,1870,1870,other,age.gp1,NoTr,NoTrade,Group,8,2,1,2,3,1,7,0,4,4,0,8,4,4
1937,1938,1938,white,age.gp4,NoTr,NoTrade,Group,12,0,4,1,7,3,9,0,3,9,1,11,8,4
2954,2955,2955,white,age.gp2,Tr,NoTrade,Group,13,0,8,4,1,0,13,0,9,4,0,13,10,3
317,318,318,white,age.gp4,NoTr,NoTrade,Group,11,0,5,1,5,0,10,1,6,5,0,11,7,4
850,851,851,other,age.gp2,Tr,NoTrade,Group,5,0,3,1,1,1,4,0,2,3,0,5,4,1
1252,1253,1253,white,age.gp2,Tr,NoTrade,Group,28,3,14,6,5,6,19,3,9,19,4,24,17,11
2961,2962,2962,white,age.gp2,NoTr,NoTrade,Group,29,3,15,8,3,3,22,4,12,17,3,26,14,15
217,218,218,other,age.gp2,Tr,NoTrade,NoGroup,5,0,1,4,0,2,3,0,1,4,0,5,3,2
257,258,258,white,age.gp4,NoTr,NoTrade,NoGroup,1,0,0,1,0,0,1,0,0,1,0,1,0,1
699,700,700,white,age.gp4,Tr,NoTrade,Group,17,2,5,3,7,3,14,0,6,11,0,17,10,7
1305,1306,1306,white,age.gp2,Tr,NoTrade,NoGroup,6,2,0,3,1,1,5,0,1,5,2,4,3,3
2701,2702,2702,white,age.gp4,NoTr,NoTrade,Group,17,1,1,3,12,1,15,1,5,12,0,17,9,8
2927,2928,2928,white,age.gp4,NoTr,NoTrade,Group,7,1,1,1,4,0,6,1,2,5,1,6,4,3
169,170,170,white,age.gp3,NoTr,NoTrade,NoGroup,11,0,7,2,2,0,11,0,6,5,0,11,8,3
1423,1424,1424,white,age.gp2,NoTr,NoTrade,Group,14,1,5,3,5,0,13,1,7,7,0,14,11,3
1490,1491,1491,white,age.gp4,NoTr,NoTrade,NoGroup,4,0,2,2,0,0,4,0,3,1,0,4,2,2
2342,2343,2343,white,age.gp2,Tr,NoTrade,Group,23,0,13,2,8,2,17,4,7,16,1,22,14,9
2663,2664,2664,white,age.gp3,NoTr,NoTrade,NoGroup,7,1,1,5,0,0,7,0,0,7,2,5,5,2
170,171,171,white,age.gp3,NoTr,NoTrade,NoGroup,12,0,4,6,2,2,10,0,7,5,0,12,9,3
1088,1089,1089,black,age.gp2,Tr,NoTrade,NoGroup,11,2,4,3,2,4,7,0,3,8,2,9,6,5
1434,1435,1435,white,age.gp3,Tr,NoTrade,NoGroup,9,0,3,3,3,0,6,3,4,5,0,9,3,6
1551,1552,1552,white,age.gp3,NoTr,NoTrade,Group,11,2,4,3,2,0,10,1,5,6,0,11,5,6
1619,1620,1620,white,age.gp2,Tr,NoTrade,Group,23,2,8,7,6,1,19,3,9,14,2,21,14,9
2627,2628,2628,white,age.gp4,NoTr,NoTrade,NoGroup,4,0,1,1,2,0,4,0,2,2,0,4,1,3
1898,1899,1899,white,age.gp1,Tr,NoTrade,NoGroup,10,5,2,1,2,1,7,2,4,6,0,10,4,6
2824,2825,2825,other,age.gp2,NoTr,NoTrade,NoGroup,8,0,3,4,1,1,7,0,3,5,0,8,4,4
172,173,173,white,age.gp3,NoTr,NoTrade,NoGroup,6,3,0,2,1,0,4,2,3,3,1,5,2,4
884,885,885,white,age.gp3,NoTr,Trade,Group,25,6,9,4,6,3,18,4,9,16,3,22,14,11
1105,1106,1106,other,age.gp1,NoTr,NoTrade,NoGroup,3,1,1,1,0,0,3,0,2,1,0,3,1,2
1204,1205,1205,white,age.gp4,Tr,NoTrade,NoGroup,7,0,0,1,6,0,7,0,3,4,0,7,4,3
2464,2465,2465,white,age.gp1,Tr,NoTrade,NoGroup,7,1,3,2,1,1,6,0,2,5,0,7,5,2
2542,2543,2543,other,age.gp1,NoTr,NoTrade,NoGroup,4,0,0,3,1,1,3,0,0,4,0,4,1,3
173,174,174,white,age.gp3,NoTr,NoTrade,NoGroup,10,2,4,1,3,1,8,1,3,7,0,10,5,5
682,683,683,white,age.gp4,Tr,NoTrade,Group,9,1,2,1,5,0,9,0,2,7,0,9,2,7
808,809,809,white,age.gp4,NoTr,NoTrade,NoGroup,8,0,4,1,3,1,5,2,4,4,1,7,3,5
1642,1643,1643,other,age.gp2,NoTr,NoTrade,NoGroup,7,0,4,1,2,1,6,0,2,5,0,7,3,4
2405,2406,2406,white,age.gp3,NoTr,NoTrade,NoGroup,13,1,8,2,2,0,13,0,8,5,0,13,11,2
2942,2943,2943,white,age.gp4,NoTr,NoTrade,Group,13,1,0,3,9,0,12,1,3,10,0,13,8,5
189,190,190,white,age.gp3,Tr,NoTrade,NoGroup,7,0,3,4,0,1,6,0,2,5,1,6,4,3
1437,1438,1438,white,age.gp3,Tr,NoTrade,NoGroup,14,0,4,7,3,2,12,0,3,11,0,14,8,6
1776,1777,1777,white,age.gp4,Tr,NoTrade,Group,13,2,5,1,5,1,10,2,3,10,0,13,4,9
2808,2809,2809,other,age.gp2,NoTr,NoTrade,NoGroup,4,0,1,2,1,0,4,0,3,1,0,4,2,2
2940,2941,2941,white,age.gp4,NoTr,NoTrade,Group,7,1,2,2,2,1,4,2,1,6,1,6,2,5
856,857,857,other,age.gp2,Tr,NoTrade,Group,7,0,4,1,2,2,5,0,1,6,1,6,4,3
1106,1107,1107,other,age.gp1,NoTr,NoTrade,NoGroup,2,1,0,1,0,1,1,0,0,2,0,2,0,2
1575,1576,1576,white,age.gp4,Tr,NoTrade,Group,10,0,3,1,6,2,8,0,4,6,0,10,5,5
176,177,177,white,age.gp3,Tr,NoTrade,NoGroup,8,1,3,2,2,1,7,0,2,6,0,8,5,3
423,424,424,white,age.gp4,NoTr,NoTrade,NoGroup,3,0,1,1,1,0,2,1,2,1,0,3,1,2
1013,1014,1014,white,age.gp1,NoTr,NoTrade,NoGroup,11,2,2,4,3,1,10,0,3,8,1,10,6,5
1968,1969,1969,white,age.gp4,Tr,NoTrade,NoGroup,4,0,1,1,2,0,4,0,1,3,0,4,0,4
2348,2349,2349,black,age.gp2,NoTr,NoTrade,Group,24,3,11,8,2,12,12,0,12,12,5,19,10,14
177,178,178,white,age.gp3,Tr,NoTrade,NoGroup,13,2,4,3,4,0,12,1,3,10,0,13,10,3
326,327,327,white,age.gp4,NoTr,NoTrade,Group,9,0,0,4,5,1,8,0,4,5,1,8,6,3
435,436,436,white,age.gp4,NoTr,NoTrade,NoGroup,5,1,2,1,1,0,4,1,3,2,0,5,3,2
937,938,938,white,age.gp3,NoTr,NoTrade,NoGroup,7,0,3,3,1,0,6,1,6,1,0,7,3,4
1456,1457,1457,white,age.gp1,NoTr,NoTrade,NoGroup,13,5,3,4,1,2,9,2,5,8,2,11,4,9
1887,1888,1888,other,age.gp1,NoTr,NoTrade,Group,9,4,1,1,3,2,7,0,6,3,1,8,3,6
233,234,234,white,age.gp2,Tr,NoTrade,Group,26,2,15,4,5,3,20,3,12,14,2,24,16,10
630,631,631,other,age.gp1,NoTr,Trade,Group,7,0,3,2,2,1,6,0,3,4,0,7,4,3
2866,2867,2867,white,age.gp2,Tr,NoTrade,Group,29,6,15,6,2,1,25,3,8,21,4,25,17,12
1484,1485,1485,white,age.gp4,NoTr,NoTrade,NoGroup,5,1,2,1,1,1,3,1,3,2,0,5,2,3
2005,2006,2006,black,age.gp4,NoTr,NoTrade,NoGroup,3,0,1,1,1,2,1,0,1,2,1,2,1,2
180,181,181,white,age.gp3,Tr,NoTrade,NoGroup,3,0,1,0,2,0,2,1,2,1,0,3,2,1
687,688,688,white,age.gp4,Tr,NoTrade,Group,11,2,2,3,4,3,8,0,5,6,3,8,5,6
803,804,804,white,age.gp4,NoTr,NoTrade,NoGroup,5,0,1,2,2,1,4,0,2,3,1,4,3,2
1879,1880,1880,other,age.gp1,NoTr,NoTrade,Group,6,4,0,2,0,0,6,0,3,3,1,5,2,4
2199,2200,2200,white,age.gp4,NoTr,NoTrade,NoGroup,1,0,0,1,0,0,1,0,1,0,0,1,0,1
2316,2317,2317,white,age.gp2,NoTr,NoTrade,NoGroup,14,1,8,4,1,1,12,1,4,10,0,14,9,5
2379,2380,2380,white,age.gp2,NoTr,NoTrade,NoGroup,15,2,5,6,2,2,9,4,9,6,2,13,10,5
2536,2537,2537,other,age.gp1,NoTr,NoTrade,NoGroup,2,0,0,1,1,0,2,0,2,0,0,2,1,1
182,183,183,white,age.gp3,Tr,NoTrade,NoGroup,9,0,3,3,3,1,8,0,2,7,0,9,6,3
1236,1237,1237,white,age.gp4,NoTr,NoTrade,NoGroup,1,0,0,1,0,0,1,0,1,0,0,1,0,1
1400,1401,1401,white,age.gp3,NoTr,NoTrade,Group,21,1,10,5,5,3,15,3,6,15,1,20,11,10
1812,1813,1813,black,age.gp4,NoTr,NoTrade,NoGroup,7,0,1,3,3,3,4,0,2,5,1,6,4,3
2068,2069,2069,white,age.gp3,Tr,NoTrade,Group,13,1,6,3,3,0,11,2,7,6,2,11,9,4
2118,2119,2119,white,age.gp3,NoTr,NoTrade,Group,19,2,6,2,9,0,19,0,10,9,0,19,12,7
2377,2378,2378,white,age.gp2,NoTr,NoTrade,NoGroup,9,1,5,3,0,0,8,1,5,4,0,9,6,3
183,184,184,white,age.gp3,Tr,NoTrade,NoGroup,9,2,3,1,3,3,6,0,2,7,1,8,7,2
1505,1506,1506,white,age.gp4,NoTr,NoTrade,NoGroup,4,0,1,2,1,1,3,0,3,1,1,3,2,2
1574,1575,1575,white,age.gp4,Tr,NoTrade,Group,17,2,6,6,3,1,13,3,6,11,1,16,11,6
2718,2719,2719,white,age.gp4,NoTr,NoTrade,Group,20,0,4,8,8,2,18,0,8,12,1,19,10,10
184,185,185,white,age.gp3,Tr,NoTrade,NoGroup,10,1,1,6,2,3,7,0,1,9,2,8,7,3
1291,1292,1292,white,age.gp4,NoTr,NoTrade,Group,7,1,1,2,3,0,6,1,5,2,0,7,6,1
1303,1304,1304,white,age.gp4,NoTr,NoTrade,Group,11,0,2,3,6,0,10,1,6,5,0,11,8,3
2680,2681,2681,black,age.gp3,NoTr,NoTrade,NoGroup,10,2,3,3,2,8,2,0,3,7,2,8,4,6
2846,2847,2847,black,age.gp3,NoTr,NoTrade,Group,8,0,2,4,2,4,4,0,4,4,1,7,4,4
2861,2862,2862,white,age.gp1,Tr,NoTrade,NoGroup,15,3,3,5,4,1,14,0,2,13,0,15,5,10
1095,1096,1096,white,age.gp2,NoTr,NoTrade,Group,19,2,8,8,1,2,17,0,12,7,1,18,11,8
1785,1786,1786,white,age.gp4,Tr,NoTrade,Group,16,0,4,2,10,1,14,1,3,13,0,16,11,5
2567,2568,2568,white,age.gp4,NoTr,NoTrade,Group,12,0,4,4,4,0,12,0,4,8,1,11,9,3
928,929,929,white,age.gp3,NoTr,NoTrade,NoGroup,8,0,3,3,2,2,6,0,4,4,1,7,5,3
1420,1421,1421,white,age.gp2,NoTr,NoTrade,Group,15,2,8,2,3,0,11,4,7,8,0,15,8,7
2650,2651,2651,white,age.gp2,NoTr,NoTrade,Group,28,2,16,5,5,1,25,2,15,13,2,26,17,11
2252,2253,2253,white,age.gp4,Tr,NoTrade,Group,11,1,3,2,5,2,9,0,4,7,0,11,7,4
2272,2273,2273,white,age.gp4,Tr,NoTrade,Group,10,0,2,3,5,1,8,1,2,8,0,10,7,3
2417,2418,2418,white,age.gp3,NoTr,Trade,Group,21,1,7,6,7,0,20,1,13,8,0,21,18,3
190,191,191,white,age.gp3,Tr,NoTrade,NoGroup,8,0,2,2,4,1,7,0,4,4,1,7,7,1
673,674,674,white,age.gp4,Tr,NoTrade,Group,5,0,2,2,1,1,4,0,2,3,0,5,3,2
750,751,751,white,age.gp4,NoTr,NoTrade,NoGroup,6,1,2,1,2,0,5,1,3,3,0,6,4,2
1548,1549,1549,white,age.gp3,NoTr,NoTrade,Group,21,2,5,7,7,0,19,2,8,13,0,21,14,7
1655,1656,1656,other,age.gp2,NoTr,NoTrade,NoGroup,4,0,2,2,0,0,4,0,2,2,0,4,1,3
2294,2295,2295,other,age.gp2,Tr,NoTrade,Group,17,0,8,4,5,2,15,0,7,10,1,16,11,6
2429,2430,2430,white,age.gp4,NoTr,NoTrade,NoGroup,3,0,1,1,1,0,3,0,1,2,1,2,2,1
2778,2779,2779,white,age.gp3,NoTr,NoTrade,Group,11,1,5,4,1,2,8,1,5,6,1,10,5,6
2970,2971,2971,white,age.gp2,NoTr,NoTrade,Group,29,9,13,3,4,1,25,3,10,19,2,27,18,11
192,193,193,white,age.gp2,Tr,NoTrade,NoGroup,9,1,3,3,2,0,6,3,1,8,0,9,5,4
1657,1658,1658,other,age.gp2,NoTr,NoTrade,NoGroup,4,0,3,1,0,0,4,0,2,2,1,3,3,1
1877,1878,1878,other,age.gp1,NoTr,NoTrade,Group,10,4,4,2,0,0,10,0,5,5,0,10,2,8
2140,2141,2141,other,age.gp2,NoTr,NoTrade,NoGroup,4,0,3,0,1,0,4,0,2,2,1,3,2,2
2186,2187,2187,white,age.gp4,NoTr,NoTrade,NoGroup,8,0,1,2,5,2,6,0,5,3,0,8,3,5
2774,2775,2775,white,age.gp3,NoTr,NoTrade,Group,16,2,9,4,1,2,10,4,8,8,1,15,8,8
2882,2883,2883,white,age.gp2,NoTr,NoTrade,NoGroup,9,2,2,3,2,2,7,0,4,5,1,8,6,3
193,194,194,white,age.gp2,Tr,NoTrade,NoGroup,11,0,8,2,1,1,9,1,7,4,0,11,8,3
1620,1621,1621,white,age.gp2,Tr,NoTrade,Group,20,3,6,7,4,2,16,2,6,14,3,17,13,7
2839,2840,2840,white,age.gp2,Tr,NoTrade,Group,23,1,13,5,4,1,18,4,10,13,3,20,14,9
2851,2852,2852,black,age.gp3,NoTr,NoTrade,Group,16,2,4,5,5,10,6,0,3,13,3,13,8,8
194,195,195,white,age.gp2,Tr,NoTrade,NoGroup,11,2,2,5,2,1,10,0,3,8,1,10,6,5
255,256,256,white,age.gp4,NoTr,NoTrade,NoGroup,5,1,1,0,3,0,5,0,3,2,0,5,3,2
323,324,324,white,age.gp4,NoTr,NoTrade,Group,9,0,3,0,6,2,6,1,2,7,0,9,5,4
1847,1848,1848,black,age.gp3,NoTr,NoTrade,NoGroup,8,1,4,2,1,3,3,2,3,5,1,7,3,5
2510,2511,2511,white,age.gp1,NoTr,NoTrade,NoGroup,13,6,3,2,2,0,10,3,5,8,0,13,4,9
2754,2755,2755,white,age.gp3,NoTr,NoTrade,NoGroup,9,1,3,4,1,0,8,1,4,5,0,9,6,3
195,196,196,white,age.gp2,Tr,NoTrade,NoGroup,14,1,9,2,2,2,12,0,4,10,1,13,6,8
668,669,669,white,age.gp2,Tr,NoTrade,NoGroup,8,0,5,2,1,0,8,0,3,5,0,8,6,2
1599,1600,1600,white,age.gp2,Tr,NoTrade,NoGroup,8,1,3,3,1,1,7,0,4,4,0,8,4,4
2092,2093,2093,black,age.gp3,NoTr,NoTrade,NoGroup,7,0,2,2,3,5,2,0,2,5,1,6,3,4
2657,2658,2658,white,age.gp2,NoTr,NoTrade,Group,20,3,11,4,2,3,14,3,9,11,0,20,9,11
2729,2730,2730,black,age.gp3,NoTr,NoTrade,NoGroup,9,1,4,1,3,3,5,1,4,5,1,8,6,3
2916,2917,2917,white,age.gp1,NoTr,NoTrade,NoGroup,3,1,1,1,0,0,3,0,2,1,1,2,1,2
196,197,197,other,age.gp2,Tr,NoTrade,NoGroup,4,0,3,1,0,0,4,0,3,1,1,3,4,0
745,746,746,white,age.gp2,Tr,NoTrade,Group,15,0,4,8,3,1,11,3,5,10,1,14,11,4
197,198,198,other,age.gp2,Tr,NoTrade,NoGroup,5,1,4,0,0,1,4,0,2,3,0,5,4,1
2655,2656,2656,black,age.gp1,NoTr,NoTrade,NoGroup,10,3,2,2,3,4,4,2,5,5,2,8,5,5
199,200,200,other,age.gp2,Tr,NoTrade,NoGroup,3,0,2,1,0,0,3,0,2,1,0,3,3,0
1741,1742,1742,white,age.gp3,Tr,NoTrade,Group,20,1,13,2,4,5,12,3,8,12,1,19,15,5
200,201,201,other,age.gp2,Tr,NoTrade,NoGroup,7,0,4,2,1,1,6,0,3,4,0,7,5,2
1104,1105,1105,black,age.gp2,NoTr,NoTrade,NoGroup,7,0,2,2,3,3,3,1,2,5,1,6,3,4
2604,2605,2605,white,age.gp3,NoTr,NoTrade,Group,22,1,12,3,6,0,17,5,10,12,1,21,16,6
201,202,202,other,age.gp2,Tr,NoTrade,NoGroup,4,0,3,0,1,0,4,0,1,3,0,4,4,0
1280,1281,1281,white,age.gp4,NoTr,NoTrade,Group,10,2,4,0,4,0,8,2,6,4,0,10,7,3
2275,2276,2276,black,age.gp2,Tr,Trade,Group,12,3,4,3,2,8,3,1,4,8,0,12,3,9
203,204,204,other,age.gp2,Tr,NoTrade,NoGroup,3,0,0,1,2,1,2,0,0,3,0,3,2,1
1759,1760,1760,black,age.gp4,NoTr,NoTrade,NoGroup,5,0,2,1,2,1,2,2,2,3,0,5,4,1
204,205,205,other,age.gp2,Tr,NoTrade,NoGroup,4,0,2,2,0,0,4,0,3,1,0,4,4,0
205,206,206,other,age.gp2,Tr,NoTrade,NoGroup,6,0,0,1,5,1,5,0,2,4,0,6,4,2
717,718,718,black,age.gp4,NoTr,NoTrade,NoGroup,5,0,1,1,3,2,2,1,2,3,1,4,2,3
1074,1075,1075,white,age.gp4,NoTr,NoTrade,Group,19,1,4,3,11,3,14,2,7,12,1,18,12,7
2195,2196,2196,white,age.gp4,NoTr,NoTrade,NoGroup,3,0,1,1,1,0,2,1,1,2,0,3,2,1
207,208,208,other,age.gp2,Tr,NoTrade,NoGroup,8,0,4,2,2,1,7,0,4,4,1,7,6,2
2009,2010,2010,black,age.gp4,NoTr,NoTrade,NoGroup,1,0,1,0,0,0,0,1,1,0,0,1,0,1
2422,2423,2423,white,age.gp3,NoTr,Trade,Group,14,2,7,2,3,1,10,3,4,10,1,13,7,7
376,377,377,black,age.gp4,NoTr,NoTrade,NoGroup,6,0,3,2,1,3,2,1,1,5,1,5,3,3
1371,1372,1372,black,age.gp4,NoTr,NoTrade,Group,6,1,1,3,1,4,1,1,2,4,0,6,1,5
2166,2167,2167,black,age.gp2,NoTr,NoTrade,NoGroup,7,2,3,1,1,3,3,1,5,2,0,7,1,6
2192,2193,2193,white,age.gp4,NoTr,NoTrade,NoGroup,1,0,1,0,0,0,0,1,1,0,0,1,0,1
2291,2292,2292,other,age.gp2,Tr,NoTrade,Group,9,1,5,1,2,2,6,1,4,5,1,8,6,3
2388,2389,2389,white,age.gp2,Tr,NoTrade,Group,28,3,14,6,5,2,23,3,9,19,2,26,15,13
2415,2416,2416,white,age.gp3,NoTr,Trade,Group,13,3,5,0,5,1,11,1,3,10,1,12,8,5
2653,2654,2654,black,age.gp1,NoTr,NoTrade,NoGroup,13,8,2,3,0,9,1,3,4,9,2,11,5,8
209,210,210,other,age.gp2,Tr,NoTrade,NoGroup,7,1,0,5,1,1,6,0,2,5,0,7,4,3
1455,1456,1456,white,age.gp1,NoTr,NoTrade,NoGroup,13,5,4,2,2,2,6,5,6,7,3,10,9,4
2052,2053,2053,white,age.gp4,Tr,NoTrade,Group,11,0,2,3,6,0,10,1,7,4,0,11,7,4
661,662,662,white,age.gp2,NoTr,NoTrade,Group,21,3,10,6,2,2,17,2,11,10,1,20,12,9
1451,1452,1452,black,age.gp1,NoTr,NoTrade,NoGroup,5,1,2,0,2,2,1,2,2,3,0,5,3,2
2397,2398,2398,white,age.gp3,NoTr,NoTrade,NoGroup,11,3,5,1,2,1,8,2,5,6,0,11,5,6
316,317,317,white,age.gp4,NoTr,NoTrade,Group,11,1,2,3,5,1,8,2,4,7,2,9,6,5
431,432,432,white,age.gp4,NoTr,NoTrade,NoGroup,1,0,1,0,0,0,0,1,1,0,0,1,0,1
1723,1724,1724,white,age.gp1,Tr,NoTrade,NoGroup,9,2,1,4,2,1,6,2,2,7,0,9,6,3
213,214,214,other,age.gp2,Tr,NoTrade,NoGroup,4,0,2,0,2,0,4,0,2,2,0,4,2,2
531,532,532,white,age.gp4,NoTr,NoTrade,NoGroup,1,0,1,0,0,0,0,1,1,0,0,1,0,1
214,215,215,other,age.gp2,Tr,NoTrade,NoGroup,4,0,0,2,2,0,4,0,0,4,0,4,2,2
324,325,325,white,age.gp4,NoTr,NoTrade,Group,10,0,2,2,6,0,8,2,4,6,1,9,8,2
215,216,216,other,age.gp2,Tr,NoTrade,NoGroup,4,0,2,1,1,0,4,0,3,1,0,4,3,1
304,305,305,white,age.gp4,NoTr,NoTrade,Group,18,1,5,5,7,0,16,2,7,11,0,18,13,5
216,217,217,other,age.gp2,Tr,NoTrade,NoGroup,6,0,1,4,1,1,5,0,2,4,1,5,4,2
318,319,319,white,age.gp4,NoTr,NoTrade,Group,13,0,3,1,9,1,9,3,5,8,0,13,5,8
1332,1333,1333,white,age.gp3,NoTr,NoTrade,NoGroup,10,0,4,1,5,0,8,2,6,4,0,10,6,4
218,219,219,other,age.gp2,Tr,NoTrade,NoGroup,4,1,1,0,2,0,4,0,1,3,0,4,0,4
1343,1344,1344,white,age.gp1,Tr,NoTrade,NoGroup,10,4,2,3,1,2,5,3,3,7,2,8,5,5
2309,2310,2310,white,age.gp2,NoTr,NoTrade,NoGroup,9,2,6,1,0,0,5,4,5,4,0,9,5,4
220,221,221,other,age.gp2,Tr,NoTrade,NoGroup,2,0,1,1,0,0,2,0,2,0,0,2,1,1
235,236,236,white,age.gp2,Tr,NoTrade,Group,20,3,11,3,3,1,14,5,6,14,2,18,13,7
221,222,222,other,age.gp2,Tr,NoTrade,NoGroup,6,2,2,1,1,0,6,0,3,3,1,5,5,1
1626,1627,1627,white,age.gp1,NoTr,NoTrade,NoGroup,6,1,4,0,1,0,5,1,3,3,0,6,3,3
2256,2257,2257,white,age.gp4,Tr,NoTrade,Group,9,0,3,3,3,2,5,2,5,4,1,8,5,4
2870,2871,2871,white,age.gp1,NoTr,NoTrade,Group,28,14,7,5,2,3,20,5,11,17,2,26,14,14
222,223,223,other,age.gp2,Tr,NoTrade,NoGroup,2,0,1,1,0,0,2,0,1,1,0,2,1,1
223,224,224,black,age.gp2,NoTr,NoTrade,NoGroup,7,0,3,3,1,5,2,0,1,6,1,6,4,3
2090,2091,2091,black,age.gp3,NoTr,NoTrade,NoGroup,7,1,3,3,0,3,4,0,2,5,0,7,4,3
224,225,225,black,age.gp2,NoTr,NoTrade,NoGroup,9,1,6,2,0,4,4,1,2,7,1,8,2,7
460,461,461,white,age.gp1,NoTr,NoTrade,NoGroup,16,10,3,3,0,2,9,5,7,9,2,14,5,11
1263,1264,1264,black,age.gp3,NoTr,NoTrade,NoGroup,6,2,4,0,0,2,3,1,3,3,0,6,2,4
2138,2139,2139,other,age.gp2,NoTr,NoTrade,NoGroup,4,0,3,1,0,1,3,0,1,3,0,4,3,1
2163,2164,2164,white,age.gp2,Tr,NoTrade,NoGroup,8,0,3,3,2,3,5,0,2,6,2,6,3,5
2765,2766,2766,black,age.gp2,NoTr,NoTrade,NoGroup,7,1,4,1,1,1,5,1,2,5,0,7,3,4
2965,2966,2966,white,age.gp2,NoTr,NoTrade,NoGroup,7,1,2,1,3,1,6,0,3,4,0,7,3,4
1274,1275,1275,white,age.gp4,NoTr,NoTrade,Group,6,1,1,2,2,3,3,0,3,3,2,4,4,2
2293,2294,2294,other,age.gp2,Tr,NoTrade,Group,10,1,4,4,1,2,8,0,2,8,1,9,8,2
365,366,366,black,age.gp4,NoTr,NoTrade,NoGroup,6,0,2,1,3,4,2,0,1,5,0,6,3,3
1963,1964,1964,white,age.gp4,NoTr,NoTrade,Group,7,0,2,1,4,2,5,0,2,5,0,7,4,3
2605,2606,2606,black,age.gp2,NoTr,NoTrade,Group,22,3,9,6,4,17,5,0,1,21,4,18,11,11
2835,2836,2836,black,age.gp2,NoTr,NoTrade,NoGroup,11,1,4,5,1,5,6,0,3,8,1,10,6,5
241,242,242,white,age.gp2,Tr,NoTrade,Group,20,2,9,8,1,1,18,1,8,12,1,19,10,10
962,963,963,black,age.gp2,NoTr,NoTrade,Group,21,2,7,8,4,9,11,1,5,16,1,20,11,10
1102,1103,1103,black,age.gp2,NoTr,NoTrade,NoGroup,6,0,4,0,2,1,5,0,3,3,1,5,5,1
2453,2454,2454,white,age.gp4,NoTr,NoTrade,NoGroup,7,0,3,0,4,1,6,0,4,3,1,6,6,1
2572,2573,2573,white,age.gp4,NoTr,NoTrade,Group,15,1,6,3,5,1,13,1,7,8,1,14,12,3
2683,2684,2684,black,age.gp3,NoTr,NoTrade,NoGroup,7,1,2,0,4,1,5,1,4,3,0,7,4,3
2781,2782,2782,white,age.gp3,NoTr,NoTrade,Group,13,1,7,1,4,0,13,0,9,4,1,12,7,6
310,311,311,white,age.gp4,NoTr,NoTrade,Group,10,1,2,2,5,0,9,1,6,4,0,10,9,1
358,359,359,black,age.gp4,NoTr,NoTrade,NoGroup,8,1,3,0,4,3,5,0,3,5,2,6,6,2
407,408,408,white,age.gp2,Tr,Trade,Group,18,4,10,2,2,1,15,2,6,12,1,17,10,8
535,536,536,white,age.gp4,NoTr,NoTrade,NoGroup,4,0,2,0,2,0,4,0,3,1,0,4,4,0
831,832,832,white,age.gp3,NoTr,NoTrade,NoGroup,5,0,1,3,1,0,5,0,3,2,0,5,3,2
957,958,958,black,age.gp2,Tr,NoTrade,NoGroup,8,0,3,4,1,4,4,0,4,4,0,8,5,3
1622,1623,1623,white,age.gp2,Tr,NoTrade,Group,13,0,7,5,1,1,11,1,6,7,1,12,10,3
1909,1910,1910,other,age.gp2,NoTr,NoTrade,NoGroup,7,0,1,4,2,1,6,0,4,3,0,7,3,4
2120,2121,2121,white,age.gp3,NoTr,NoTrade,Group,17,1,6,4,6,0,16,1,6,11,0,17,11,6
345,346,346,white,age.gp2,NoTr,NoTrade,Group,15,0,11,3,1,1,12,2,7,8,0,15,13,2
855,856,856,other,age.gp2,Tr,NoTrade,Group,12,0,6,4,2,0,12,0,7,5,2,10,10,2
1239,1240,1240,white,age.gp2,Tr,NoTrade,NoGroup,4,0,2,2,0,0,4,0,2,2,0,4,3,1
1729,1730,1730,white,age.gp3,Tr,NoTrade,Group,24,0,15,8,1,2,21,1,12,12,3,21,19,5
2521,2522,2522,white,age.gp2,Tr,NoTrade,Group,20,0,11,3,6,0,18,2,8,12,2,18,16,4
2666,2667,2667,white,age.gp3,NoTr,NoTrade,NoGroup,4,0,4,0,0,0,4,0,3,1,0,4,4,0
543,544,544,white,age.gp4,NoTr,NoTrade,NoGroup,1,0,1,0,0,0,1,0,1,0,0,1,1,0
581,582,582,other,age.gp4,NoTr,NoTrade,NoGroup,2,0,1,0,1,0,2,0,1,1,0,2,2,0
945,946,946,white,age.gp3,Tr,NoTrade,Group,13,0,5,2,6,2,11,0,5,8,1,12,10,3
1319,1320,1320,white,age.gp2,NoTr,NoTrade,NoGroup,10,0,7,3,0,1,7,2,3,7,1,9,5,5
2590,2591,2591,white,age.gp3,NoTr,NoTrade,Group,13,1,6,3,3,1,11,1,8,5,1,12,8,5
2660,2661,2661,white,age.gp2,NoTr,NoTrade,Group,27,2,13,8,4,4,21,2,11,16,1,26,20,7
832,833,833,white,age.gp3,NoTr,NoTrade,NoGroup,9,0,5,4,0,0,9,0,6,3,2,7,7,2
1266,1267,1267,black,age.gp3,NoTr,NoTrade,NoGroup,7,3,2,0,2,4,2,1,2,5,0,7,3,4
1413,1414,1414,white,age.gp3,NoTr,NoTrade,Group,27,2,9,6,10,2,24,1,8,19,4,23,22,5
2508,2509,2509,black,age.gp2,NoTr,NoTrade,NoGroup,13,1,9,1,2,8,5,0,4,9,0,13,5,8
2938,2939,2939,white,age.gp4,NoTr,NoTrade,Group,7,2,2,0,3,0,7,0,2,5,0,7,6,1
839,840,840,white,age.gp2,NoTr,NoTrade,Group,19,1,13,3,2,1,17,1,12,7,1,18,12,7
872,873,873,other,age.gp2,Tr,NoTrade,Group,16,1,12,1,2,1,14,1,7,9,0,16,8,8
986,987,987,white,age.gp4,NoTr,NoTrade,NoGroup,3,0,1,0,2,0,3,0,2,1,0,3,2,1
1376,1377,1377,black,age.gp2,NoTr,NoTrade,NoGroup,6,0,3,1,2,4,2,0,1,5,0,6,3,3
1805,1806,1806,white,age.gp2,Tr,NoTrade,Group,26,2,14,3,7,1,21,4,14,12,0,26,17,9
1949,1950,1950,white,age.gp4,NoTr,NoTrade,Group,11,1,2,2,6,0,10,1,2,9,1,10,9,2
2161,2162,2162,white,age.gp2,Tr,NoTrade,NoGroup,8,2,5,1,0,1,6,1,3,5,0,8,6,2
859,860,860,other,age.gp2,Tr,NoTrade,Group,8,0,3,4,1,0,8,0,3,5,0,8,6,2
1312,1313,1313,white,age.gp1,NoTr,NoTrade,NoGroup,12,5,6,0,1,0,9,3,7,5,0,12,6,6
1498,1499,1499,white,age.gp4,NoTr,NoTrade,NoGroup,1,0,1,0,0,0,1,0,1,0,0,1,1,0
2297,2298,2298,other,age.gp2,Tr,NoTrade,Group,9,0,6,3,0,0,9,0,4,5,1,8,9,0
2529,2530,2530,white,age.gp2,NoTr,NoTrade,Group,24,3,9,5,7,2,20,2,6,18,2,22,15,9
294,295,295,black,age.gp2,NoTr,NoTrade,Group,17,2,9,3,3,6,11,0,6,11,1,16,12,5
438,439,439,white,age.gp4,NoTr,NoTrade,NoGroup,1,0,1,0,0,0,1,0,1,0,0,1,1,0
634,635,635,other,age.gp1,NoTr,Trade,Group,9,5,2,1,1,1,8,0,3,6,1,8,6,3
1424,1425,1425,white,age.gp2,Tr,NoTrade,Group,19,1,9,4,5,2,16,1,6,13,1,18,15,4
1648,1649,1649,other,age.gp2,NoTr,NoTrade,NoGroup,5,1,2,2,0,0,5,0,2,3,1,4,2,3
2923,2924,2924,white,age.gp4,NoTr,NoTrade,Group,14,1,3,4,6,1,13,0,7,7,1,13,9,5
2935,2936,2936,white,age.gp4,NoTr,NoTrade,Group,10,0,5,1,4,1,9,0,3,7,2,8,6,4
1403,1404,1404,white,age.gp3,NoTr,NoTrade,Group,12,1,5,5,1,0,12,0,5,7,1,11,9,3
1572,1573,1573,white,age.gp4,Tr,NoTrade,Group,14,0,4,2,8,0,12,2,7,7,2,12,12,2
1591,1592,1592,white,age.gp4,Tr,NoTrade,Group,10,1,3,3,3,1,8,1,6,4,0,10,7,3
1944,1945,1945,white,age.gp4,NoTr,NoTrade,Group,17,1,5,4,7,1,16,0,10,7,1,16,14,3
2159,2160,2160,white,age.gp2,Tr,NoTrade,NoGroup,9,1,4,0,4,1,8,0,3,6,0,9,6,3
2671,2672,2672,white,age.gp3,NoTr,NoTrade,NoGroup,1,0,1,0,0,0,1,0,1,0,0,1,1,0
2751,2752,2752,white,age.gp3,NoTr,NoTrade,NoGroup,7,3,2,0,2,1,5,1,2,5,1,6,4,3
2822,2823,2823,other,age.gp2,NoTr,NoTrade,NoGroup,7,1,2,2,2,1,6,0,4,3,2,5,6,1
840,841,841,white,age.gp2,NoTr,NoTrade,Group,24,3,12,7,2,1,20,3,13,11,3,21,19,5
912,913,913,other,age.gp1,Tr,NoTrade,NoGroup,4,1,2,0,1,1,3,0,2,2,0,4,4,0
998,999,999,white,age.gp4,NoTr,NoTrade,NoGroup,3,1,1,0,1,0,2,1,1,2,0,3,2,1
1568,1569,1569,white,age.gp4,Tr,NoTrade,Group,16,3,2,5,6,1,14,1,7,9,1,15,9,7
1643,1644,1644,other,age.gp2,NoTr,NoTrade,NoGroup,5,0,4,0,1,1,4,0,2,3,0,5,2,3
2164,2165,2165,black,age.gp2,NoTr,NoTrade,NoGroup,1,0,1,0,0,0,1,0,1,0,0,1,1,0
239,240,240,white,age.gp2,Tr,NoTrade,Group,13,1,5,4,3,1,11,1,4,9,1,12,10,3
507,508,508,white,age.gp2,Tr,NoTrade,NoGroup,8,0,6,1,1,0,6,2,3,5,1,7,5,3
838,839,839,white,age.gp2,NoTr,NoTrade,Group,16,2,7,2,5,1,15,0,8,8,1,15,10,6
1092,1093,1093,black,age.gp1,NoTr,NoTrade,NoGroup,4,1,1,1,1,2,2,0,2,2,1,3,2,2
1299,1300,1300,white,age.gp4,NoTr,NoTrade,Group,12,1,4,2,5,2,9,1,4,8,3,9,9,3
1770,1771,1771,black,age.gp4,NoTr,NoTrade,NoGroup,7,0,2,1,4,3,4,0,3,4,0,7,3,4
1842,1843,1843,black,age.gp3,NoTr,NoTrade,NoGroup,4,1,2,1,0,2,1,1,2,2,0,4,1,3
2121,2122,2122,white,age.gp3,NoTr,NoTrade,Group,16,3,6,3,4,1,14,1,7,9,0,16,11,5
2127,2128,2128,white,age.gp3,NoTr,NoTrade,Group,11,2,2,4,3,1,9,1,4,7,2,9,7,4
2531,2532,2532,other,age.gp1,NoTr,NoTrade,NoGroup,5,2,2,1,0,1,3,1,3,2,0,5,3,2
417,418,418,white,age.gp4,NoTr,NoTrade,NoGroup,6,0,2,0,4,1,5,0,2,4,0,6,5,1
954,955,955,white,age.gp3,Tr,NoTrade,Group,14,4,1,5,4,1,13,0,6,8,1,13,9,5
1868,1869,1869,other,age.gp1,NoTr,NoTrade,Group,10,7,1,2,0,0,10,0,1,9,2,8,6,4
2595,2596,2596,white,age.gp3,NoTr,NoTrade,Group,12,1,6,5,0,0,12,0,6,6,0,12,11,1
2669,2670,2670,white,age.gp3,NoTr,NoTrade,NoGroup,3,0,3,0,0,0,2,1,2,1,0,3,1,2
1214,1215,1215,white,age.gp4,NoTr,NoTrade,NoGroup,1,0,1,0,0,0,1,0,1,0,0,1,1,0
1428,1429,1429,white,age.gp2,Tr,NoTrade,Group,20,2,8,6,4,2,17,1,4,16,1,19,11,9
2540,2541,2541,other,age.gp1,NoTr,NoTrade,NoGroup,2,1,1,0,0,0,2,0,2,0,0,2,1,1
2574,2575,2575,white,age.gp4,NoTr,NoTrade,Group,11,0,2,3,6,0,11,0,6,5,1,10,9,2
2692,2693,2693,white,age.gp4,NoTr,NoTrade,Group,15,1,5,2,7,3,9,3,3,12,3,12,9,6
2814,2815,2815,other,age.gp2,NoTr,NoTrade,NoGroup,5,0,2,0,3,0,5,0,2,3,0,5,3,2
2883,2884,2884,white,age.gp1,NoTr,NoTrade,Group,26,14,6,3,3,1,20,5,6,20,1,25,15,11
2945,2946,2946,white,age.gp4,NoTr,NoTrade,Group,13,0,6,3,4,1,10,2,8,5,2,11,12,1
1326,1327,1327,white,age.gp3,NoTr,NoTrade,NoGroup,8,1,5,0,2,0,8,0,5,3,0,8,5,3
2153,2154,2154,other,age.gp2,NoTr,NoTrade,NoGroup,5,0,3,0,2,0,5,0,4,1,0,5,3,2
2320,2321,2321,white,age.gp1,NoTr,NoTrade,NoGroup,11,8,2,0,1,2,6,3,3,8,3,8,5,6
2328,2329,2329,white,age.gp3,Tr,NoTrade,Group,18,2,5,7,4,2,15,1,7,11,1,17,13,5
698,699,699,white,age.gp4,Tr,NoTrade,Group,11,0,2,3,6,0,10,1,6,5,1,10,9,2
844,845,845,white,age.gp2,Tr,NoTrade,NoGroup,11,1,3,3,4,1,9,1,2,9,2,9,7,4
1061,1062,1062,white,age.gp4,NoTr,NoTrade,Group,14,1,4,2,7,2,9,3,4,10,0,14,8,6
1904,1905,1905,black,age.gp1,NoTr,NoTrade,NoGroup,12,7,3,0,2,1,8,3,4,8,2,10,7,5
2021,2022,2022,black,age.gp4,NoTr,NoTrade,NoGroup,4,0,1,0,3,0,4,0,2,2,0,4,4,0
2413,2414,2414,white,age.gp3,NoTr,Trade,Group,16,2,5,6,3,1,15,0,7,9,1,15,11,5
2545,2546,2546,other,age.gp1,NoTr,NoTrade,NoGroup,3,1,1,0,1,0,3,0,1,2,0,3,1,2
2616,2617,2617,white,age.gp4,NoTr,NoTrade,NoGroup,7,0,2,3,2,0,7,0,3,4,1,6,6,1
269,270,270,white,age.gp4,NoTr,NoTrade,NoGroup,6,0,1,2,3,0,6,0,2,4,0,6,4,2
1170,1171,1171,white,age.gp4,NoTr,NoTrade,NoGroup,1,0,1,0,0,0,1,0,1,0,0,1,1,0
1255,1256,1256,white,age.gp1,Tr,Trade,Group,15,7,4,2,2,1,12,2,7,8,2,13,9,6
1307,1308,1308,white,age.gp2,Tr,NoTrade,NoGroup,15,1,8,3,3,2,12,1,6,9,2,13,11,4
1543,1544,1544,white,age.gp2,NoTr,NoTrade,NoGroup,14,3,6,4,1,4,9,1,8,6,2,12,9,5
2308,2309,2309,white,age.gp2,NoTr,NoTrade,NoGroup,13,0,8,3,2,1,12,0,4,9,2,11,12,1
2750,2751,2751,white,age.gp3,NoTr,NoTrade,NoGroup,4,0,3,0,1,1,3,0,3,1,0,4,3,1
2767,2768,2768,white,age.gp1,NoTr,NoTrade,NoGroup,10,4,1,1,4,1,8,1,4,6,0,10,5,5
2795,2796,2796,white,age.gp2,Tr,NoTrade,NoGroup,9,1,6,1,1,0,9,0,6,3,1,8,8,1
469,470,470,black,age.gp3,NoTr,Trade,Group,9,2,3,0,4,5,2,2,3,6,3,6,5,4
940,941,941,white,age.gp3,NoTr,NoTrade,NoGroup,8,1,3,2,2,0,8,0,5,3,0,8,6,2
1096,1097,1097,white,age.gp2,NoTr,NoTrade,Group,22,2,13,4,3,2,18,2,13,9,4,18,16,6
1840,1841,1841,black,age.gp3,NoTr,NoTrade,NoGroup,5,1,2,0,2,2,3,0,2,3,2,3,5,0
2133,2134,2134,other,age.gp2,NoTr,NoTrade,NoGroup,5,1,2,0,2,0,5,0,2,3,1,4,3,2
2694,2695,2695,white,age.gp4,NoTr,NoTrade,Group,9,1,1,1,6,1,8,0,3,6,0,9,4,5
2737,2738,2738,white,age.gp2,Tr,NoTrade,Group,18,1,11,4,2,2,14,2,8,10,0,18,11,7
2912,2913,2913,other,age.gp1,NoTr,NoTrade,NoGroup,4,3,1,0,0,0,4,0,1,3,1,3,1,3
632,633,633,other,age.gp1,NoTr,Trade,Group,7,1,3,3,0,1,6,0,1,6,2,5,6,1
987,988,988,white,age.gp4,NoTr,NoTrade,NoGroup,7,0,2,2,3,0,6,1,2,5,0,7,4,3
1020,1021,1021,white,age.gp2,NoTr,Trade,Group,20,4,7,6,3,2,16,2,8,12,2,18,12,8
1287,1288,1288,white,age.gp4,NoTr,NoTrade,Group,10,1,2,1,6,0,10,0,5,5,1,9,8,2
1701,1702,1702,white,age.gp4,NoTr,Trade,NoGroup,4,0,3,0,1,0,4,0,3,1,0,4,4,0
1935,1936,1936,white,age.gp4,NoTr,NoTrade,Group,11,1,3,1,6,1,9,1,5,6,2,9,9,2
2632,2633,2633,white,age.gp4,NoTr,NoTrade,NoGroup,4,0,1,0,3,0,4,0,1,3,0,4,3,1
2898,2899,2899,other,age.gp1,NoTr,NoTrade,NoGroup,5,3,1,0,1,1,4,0,1,4,1,4,3,2
636,637,637,other,age.gp1,NoTr,Trade,Group,8,4,1,0,3,1,7,0,2,6,0,8,3,5
1328,1329,1329,white,age.gp3,NoTr,NoTrade,NoGroup,10,1,4,3,2,1,8,1,4,6,1,9,8,2
1438,1439,1439,white,age.gp3,Tr,NoTrade,NoGroup,6,0,3,1,2,2,4,0,2,4,0,6,4,2
1915,1916,1916,other,age.gp2,NoTr,NoTrade,NoGroup,3,0,3,0,0,0,3,0,3,0,0,3,3,0
2151,2152,2152,other,age.gp2,NoTr,NoTrade,NoGroup,4,0,3,0,1,0,4,0,3,1,0,4,3,1
915,916,916,other,age.gp1,Tr,NoTrade,NoGroup,2,0,2,0,0,0,2,0,1,1,0,2,2,0
925,926,926,white,age.gp2,NoTr,NoTrade,NoGroup,13,1,8,4,0,1,10,2,7,6,1,12,9,4
1532,1533,1533,black,age.gp4,NoTr,NoTrade,NoGroup,5,0,3,0,2,0,3,2,2,3,0,5,3,2
1752,1753,1753,black,age.gp4,NoTr,NoTrade,NoGroup,5,0,2,0,3,1,4,0,2,3,0,5,4,1
1861,1862,1862,white,age.gp3,NoTr,NoTrade,Group,16,2,5,3,6,2,13,1,6,10,0,16,11,5
2299,2300,2300,other,age.gp2,Tr,NoTrade,Group,12,2,6,1,3,3,9,0,7,5,1,11,8,4
2947,2948,2948,white,age.gp4,NoTr,NoTrade,Group,16,2,4,3,7,2,11,3,8,8,1,15,10,6
248,249,249,white,age.gp4,NoTr,NoTrade,NoGroup,2,0,1,1,0,0,2,0,1,1,0,2,2,0
249,250,250,white,age.gp4,NoTr,NoTrade,NoGroup,4,0,1,1,2,0,4,0,2,2,0,4,4,0
1410,1411,1411,white,age.gp3,NoTr,NoTrade,Group,13,2,6,2,3,1,10,2,5,8,1,12,8,5
250,251,251,white,age.gp4,NoTr,NoTrade,NoGroup,1,0,0,0,1,0,1,0,0,1,0,1,1,0
2691,2692,2692,white,age.gp4,NoTr,NoTrade,Group,16,2,0,2,12,1,14,1,3,13,2,14,6,10
251,252,252,white,age.gp4,NoTr,NoTrade,NoGroup,1,0,1,0,0,0,1,0,1,0,0,1,1,0
252,253,253,white,age.gp4,NoTr,NoTrade,NoGroup,1,0,0,0,1,0,1,0,1,0,0,1,1,0
2258,2259,2259,white,age.gp4,Tr,NoTrade,Group,10,1,0,2,7,0,10,0,2,8,0,10,6,4
253,254,254,white,age.gp4,NoTr,NoTrade,NoGroup,2,0,0,0,2,0,2,0,1,1,0,2,2,0
302,303,303,white,age.gp4,NoTr,NoTrade,Group,13,1,2,3,7,1,10,2,2,11,1,12,7,6
254,255,255,white,age.gp4,NoTr,NoTrade,NoGroup,2,0,2,0,0,0,2,0,2,0,0,2,1,1
1806,1807,1807,white,age.gp2,Tr,NoTrade,Group,17,0,7,5,5,1,14,2,2,15,1,16,10,7
1081,1082,1082,white,age.gp4,NoTr,NoTrade,Group,10,2,2,2,4,1,8,1,4,6,1,9,7,3
256,257,257,white,age.gp4,NoTr,NoTrade,NoGroup,1,0,0,1,0,1,0,0,0,1,0,1,0,1
258,259,259,white,age.gp4,NoTr,NoTrade,NoGroup,2,0,1,0,1,1,1,0,0,2,0,2,1,1
690,691,691,white,age.gp4,Tr,NoTrade,Group,9,0,0,3,6,0,9,0,0,9,1,8,6,3
1244,1245,1245,white,age.gp1,NoTr,NoTrade,NoGroup,15,11,1,0,3,0,10,5,4,11,0,15,3,12
1961,1962,1962,white,age.gp4,NoTr,NoTrade,Group,7,0,0,1,6,0,7,0,1,6,1,6,5,2
260,261,261,white,age.gp4,NoTr,NoTrade,NoGroup,5,0,1,2,2,1,4,0,1,4,0,5,4,1
1405,1406,1406,white,age.gp3,NoTr,NoTrade,Group,16,4,7,3,2,2,11,3,6,10,2,14,9,7
2095,2096,2096,black,age.gp3,NoTr,NoTrade,NoGroup,6,2,0,1,3,4,2,0,0,6,0,6,0,6
261,262,262,white,age.gp4,NoTr,NoTrade,NoGroup,7,0,4,0,3,0,6,1,4,3,1,6,5,2
565,566,566,other,age.gp4,NoTr,NoTrade,NoGroup,4,0,1,0,3,0,4,0,2,2,0,4,3,1
262,263,263,white,age.gp4,NoTr,NoTrade,NoGroup,3,0,1,1,1,0,2,1,1,2,0,3,2,1
1144,1145,1145,white,age.gp4,NoTr,NoTrade,NoGroup,3,0,1,0,2,1,1,1,0,3,0,3,0,3
263,264,264,white,age.gp4,NoTr,NoTrade,NoGroup,1,1,0,0,0,1,0,0,0,1,0,1,0,1
266,267,267,white,age.gp4,NoTr,NoTrade,NoGroup,8,1,0,1,6,1,6,1,3,5,0,8,6,2
888,889,889,other,age.gp1,Tr,NoTrade,NoGroup,4,2,1,0,1,0,4,0,1,3,0,4,2,2
1515,1516,1516,black,age.gp4,NoTr,NoTrade,NoGroup,4,0,1,1,2,3,1,0,0,4,0,4,1,3
2580,2581,2581,white,age.gp4,NoTr,NoTrade,Group,10,1,4,0,5,1,9,0,4,6,1,9,6,4
2950,2951,2951,white,age.gp4,NoTr,NoTrade,Group,10,1,0,4,5,0,10,0,4,6,1,9,6,4
267,268,268,white,age.gp4,NoTr,NoTrade,NoGroup,1,0,0,0,1,0,1,0,0,1,0,1,0,1
2428,2429,2429,white,age.gp4,NoTr,NoTrade,NoGroup,6,0,1,0,5,0,5,1,2,4,0,6,4,2
268,269,269,white,age.gp4,NoTr,NoTrade,NoGroup,2,0,2,0,0,0,1,1,1,1,0,2,1,1
971,972,972,white,age.gp4,NoTr,NoTrade,NoGroup,5,0,1,1,3,0,5,0,1,4,0,5,2,3
2175,2176,2176,white,age.gp4,NoTr,NoTrade,NoGroup,10,1,2,2,5,1,8,1,4,6,1,9,6,4
270,271,271,white,age.gp4,NoTr,NoTrade,NoGroup,4,0,1,1,2,0,4,0,3,1,0,4,3,1
439,440,440,white,age.gp4,NoTr,NoTrade,NoGroup,5,0,0,2,3,0,5,0,0,5,1,4,1,4
271,272,272,white,age.gp4,NoTr,NoTrade,NoGroup,3,1,0,1,1,1,2,0,0,3,0,3,2,1
272,273,273,white,age.gp4,NoTr,NoTrade,NoGroup,1,0,0,0,1,1,0,0,0,1,0,1,0,1
2019,2020,2020,black,age.gp4,NoTr,NoTrade,NoGroup,3,0,1,0,2,2,1,0,0,3,0,3,1,2
273,274,274,white,age.gp4,NoTr,NoTrade,NoGroup,1,0,1,0,0,0,1,0,0,1,0,1,0,1
1318,1319,1319,white,age.gp2,NoTr,NoTrade,NoGroup,12,0,4,4,4,1,11,0,5,7,0,12,6,6
274,275,275,white,age.gp4,NoTr,NoTrade,NoGroup,3,0,0,0,3,1,2,0,1,2,0,3,1,2
499,500,500,black,age.gp4,NoTr,NoTrade,NoGroup,5,1,0,1,3,3,2,0,0,5,0,5,0,5
275,276,276,white,age.gp4,NoTr,NoTrade,NoGroup,8,1,2,3,2,0,6,2,4,4,0,8,4,4
821,822,822,white,age.gp3,NoTr,NoTrade,NoGroup,9,1,6,0,2,1,7,1,1,8,0,9,5,4
1592,1593,1593,white,age.gp4,Tr,NoTrade,Group,10,1,1,1,7,0,9,1,3,7,0,10,6,4
1794,1795,1795,white,age.gp4,Tr,NoTrade,Group,10,0,0,2,8,0,10,0,2,8,0,10,6,4
1925,1926,1926,other,age.gp2,NoTr,NoTrade,NoGroup,6,0,4,1,1,0,6,0,4,2,0,6,5,1
2398,2399,2399,white,age.gp3,NoTr,NoTrade,NoGroup,9,0,1,5,3,1,8,0,2,7,0,9,5,4
276,277,277,white,age.gp4,NoTr,NoTrade,NoGroup,1,0,1,0,0,0,1,0,0,1,0,1,1,0
455,456,456,black,age.gp3,NoTr,NoTrade,NoGroup,5,0,1,2,2,1,4,0,2,3,0,5,3,2
278,279,279,white,age.gp4,NoTr,NoTrade,NoGroup,3,0,0,1,2,0,3,0,0,3,0,3,2,1
775,776,776,white,age.gp4,NoTr,NoTrade,NoGroup,5,0,1,1,3,1,4,0,1,4,0,5,3,2
1558,1559,1559,white,age.gp3,NoTr,NoTrade,Group,14,0,3,6,5,1,11,2,6,8,0,14,8,6
1938,1939,1939,white,age.gp4,NoTr,NoTrade,Group,9,0,2,1,6,1,8,0,1,8,1,8,8,1
279,280,280,white,age.gp4,NoTr,NoTrade,NoGroup,1,0,0,1,0,0,1,0,0,1,0,1,0,1
822,823,823,white,age.gp3,NoTr,NoTrade,NoGroup,10,2,2,3,3,2,7,1,3,7,0,10,4,6
1329,1330,1330,white,age.gp3,NoTr,NoTrade,NoGroup,6,0,3,2,1,0,5,1,2,4,1,5,4,2
1683,1684,1684,white,age.gp4,NoTr,Trade,NoGroup,6,0,3,1,2,0,6,0,4,2,0,6,4,2
2367,2368,2368,black,age.gp2,Tr,NoTrade,Group,19,3,5,7,4,11,8,0,5,14,1,18,7,12
2837,2838,2838,black,age.gp2,NoTr,NoTrade,NoGroup,6,1,2,2,1,3,3,0,1,5,0,6,3,3
2936,2937,2937,white,age.gp4,NoTr,NoTrade,Group,6,0,3,1,2,0,6,0,5,1,0,6,5,1
1672,1673,1673,white,age.gp2,Tr,NoTrade,NoGroup,10,0,7,2,1,1,9,0,3,7,1,9,6,4
2304,2305,2305,other,age.gp2,Tr,NoTrade,Group,14,1,7,5,1,0,14,0,7,7,0,14,10,4
2662,2663,2663,white,age.gp3,NoTr,NoTrade,NoGroup,6,2,2,1,1,1,5,0,3,3,0,6,3,3
770,771,771,white,age.gp4,NoTr,NoTrade,NoGroup,3,0,1,0,2,0,3,0,2,1,0,3,3,0
933,934,934,white,age.gp3,NoTr,NoTrade,NoGroup,6,1,2,1,2,0,6,0,4,2,0,6,4,2
1661,1662,1662,other,age.gp2,NoTr,NoTrade,NoGroup,7,0,2,2,3,2,5,0,1,6,1,6,5,2
1865,1866,1866,white,age.gp3,NoTr,NoTrade,Group,19,5,9,2,3,3,15,1,10,9,2,17,12,7
2748,2749,2749,white,age.gp3,NoTr,NoTrade,NoGroup,5,2,3,0,0,0,4,1,3,2,0,5,4,1
477,478,478,black,age.gp4,NoTr,NoTrade,NoGroup,2,0,1,0,1,1,1,0,1,1,0,2,1,1
852,853,853,other,age.gp2,Tr,NoTrade,Group,9,1,2,4,2,1,8,0,2,7,0,9,7,2
980,981,981,white,age.gp4,NoTr,NoTrade,NoGroup,1,0,1,0,0,0,1,0,1,0,0,1,1,0
1922,1923,1923,other,age.gp2,NoTr,NoTrade,NoGroup,5,0,2,2,1,1,4,0,2,3,1,4,5,0
2274,2275,2275,black,age.gp2,Tr,Trade,Group,18,1,9,5,3,10,8,0,4,14,2,16,8,10
2434,2435,2435,white,age.gp4,NoTr,NoTrade,NoGroup,1,0,1,0,0,0,1,0,1,0,0,1,1,0
2685,2686,2686,black,age.gp3,NoTr,NoTrade,NoGroup,6,2,3,1,0,4,2,0,1,5,0,6,2,4
788,789,789,black,age.gp1,Tr,NoTrade,NoGroup,15,4,3,6,2,5,8,2,3,12,2,13,12,3
2134,2135,2135,other,age.gp2,NoTr,NoTrade,NoGroup,5,0,3,2,0,1,4,0,2,3,0,5,4,1
2867,2868,2868,white,age.gp2,Tr,NoTrade,Group,23,3,9,6,5,2,19,2,9,14,0,23,13,10
2937,2938,2938,white,age.gp4,NoTr,NoTrade,Group,5,0,2,0,3,1,4,0,1,4,1,4,3,2
1011,1012,1012,white,age.gp1,Tr,NoTrade,NoGroup,12,6,2,2,2,0,10,2,3,9,1,11,7,5
1084,1085,1085,white,age.gp4,NoTr,NoTrade,Group,13,1,0,3,9,0,13,0,4,9,2,11,8,5
648,649,649,other,age.gp1,NoTr,Trade,Group,6,5,0,1,0,0,6,0,3,3,0,6,2,4
1881,1882,1882,other,age.gp1,NoTr,NoTrade,Group,11,6,1,3,1,3,8,0,2,9,1,10,4,7
2382,2383,2383,white,age.gp1,NoTr,NoTrade,NoGroup,10,8,1,0,1,0,9,1,3,7,3,7,3,7
287,288,288,white,age.gp1,NoTr,NoTrade,NoGroup,9,5,1,2,1,2,5,2,3,6,0,9,5,4
1850,1851,1851,black,age.gp3,NoTr,NoTrade,NoGroup,7,1,1,2,3,3,4,0,1,6,1,6,4,3
1905,1906,1906,black,age.gp1,NoTr,NoTrade,NoGroup,9,3,1,4,1,6,2,1,2,7,1,8,2,7
2056,2057,2057,white,age.gp4,Tr,NoTrade,Group,9,2,2,0,5,0,8,1,4,5,0,9,4,5
643,644,644,other,age.gp1,NoTr,Trade,Group,6,4,1,1,0,2,4,0,2,4,0,6,2,4
785,786,786,black,age.gp1,Tr,NoTrade,NoGroup,11,4,0,7,0,7,3,1,1,10,1,10,1,10
1306,1307,1307,white,age.gp2,Tr,NoTrade,NoGroup,7,2,4,0,1,3,3,1,2,5,2,5,3,4
289,290,290,white,age.gp1,NoTr,NoTrade,NoGroup,17,12,2,1,2,2,11,4,1,16,1,16,10,7
958,959,959,black,age.gp2,Tr,NoTrade,NoGroup,11,1,7,1,2,5,6,0,3,8,0,11,4,7
1384,1385,1385,white,age.gp1,NoTr,NoTrade,NoGroup,13,8,2,0,3,2,7,4,1,12,4,9,9,4
2770,2771,2771,white,age.gp1,NoTr,NoTrade,NoGroup,4,3,0,0,1,1,2,1,0,4,0,4,0,4
1349,1350,1350,black,age.gp4,NoTr,NoTrade,Group,9,2,2,2,3,2,7,0,3,6,0,9,6,3
1502,1503,1503,white,age.gp4,NoTr,NoTrade,NoGroup,6,0,1,2,3,2,4,0,2,4,0,6,6,0
2276,2277,2277,black,age.gp2,Tr,Trade,Group,13,0,8,3,2,7,5,1,6,7,1,12,8,5
291,292,292,black,age.gp2,NoTr,NoTrade,Group,16,2,5,4,5,8,6,2,6,10,4,12,9,7
377,378,378,black,age.gp4,NoTr,NoTrade,NoGroup,1,0,1,0,0,1,0,0,0,1,0,1,1,0
475,476,476,black,age.gp3,NoTr,Trade,Group,10,0,1,6,3,7,3,0,3,7,0,10,5,5
1596,1597,1597,black,age.gp1,Tr,Trade,NoGroup,7,2,1,0,4,5,1,1,1,6,2,5,3,4
2144,2145,2145,other,age.gp2,NoTr,NoTrade,NoGroup,4,0,3,1,0,2,2,0,2,2,0,4,3,1
2268,2269,2269,white,age.gp4,Tr,NoTrade,Group,6,1,2,0,3,1,5,0,2,4,0,6,6,0
2298,2299,2299,other,age.gp2,Tr,NoTrade,Group,7,0,5,0,2,3,4,0,2,5,1,6,6,1
1054,1055,1055,white,age.gp4,NoTr,NoTrade,Group,11,1,5,2,3,2,8,1,2,9,2,9,9,2
1205,1206,1206,white,age.gp4,Tr,NoTrade,NoGroup,6,0,4,1,1,1,5,0,1,5,0,6,3,3
1593,1594,1594,black,age.gp1,Tr,Trade,NoGroup,7,4,1,1,1,3,2,2,2,5,0,7,2,5
2075,2076,2076,black,age.gp3,NoTr,NoTrade,NoGroup,5,2,3,0,0,3,2,0,1,4,1,4,4,1
2507,2508,2508,black,age.gp2,NoTr,NoTrade,NoGroup,8,1,5,1,1,7,1,0,2,6,1,7,6,2
1091,1092,1092,black,age.gp1,NoTr,NoTrade,NoGroup,10,4,1,3,2,4,5,1,1,9,0,10,5,5
1100,1101,1101,black,age.gp2,NoTr,NoTrade,NoGroup,6,0,5,1,0,5,0,1,0,6,0,6,3,3
1320,1321,1321,white,age.gp2,Tr,NoTrade,Group,15,1,7,4,3,2,13,0,5,10,1,14,11,4
1418,1419,1419,black,age.gp2,NoTr,NoTrade,NoGroup,9,2,6,1,0,3,5,1,4,5,2,7,6,3
1751,1752,1752,black,age.gp4,NoTr,NoTrade,NoGroup,7,0,4,0,3,2,5,0,1,6,0,7,5,2
2506,2507,2507,black,age.gp2,NoTr,NoTrade,NoGroup,8,0,4,1,3,4,3,1,4,4,1,7,6,2
1165,1166,1166,white,age.gp4,NoTr,NoTrade,NoGroup,1,0,1,0,0,1,0,0,0,1,0,1,1,0
2446,2447,2447,white,age.gp4,NoTr,NoTrade,NoGroup,7,1,2,0,4,1,4,2,4,3,0,7,5,2
393,394,394,black,age.gp4,NoTr,NoTrade,NoGroup,3,0,0,1,2,1,2,0,1,2,0,3,2,1
795,796,796,white,age.gp4,NoTr,NoTrade,NoGroup,7,1,1,0,5,0,6,1,1,6,0,7,4,3
1177,1178,1178,white,age.gp4,Tr,NoTrade,NoGroup,5,1,1,0,3,0,5,0,0,5,0,5,5,0
1181,1182,1182,white,age.gp4,Tr,NoTrade,NoGroup,5,2,1,0,2,0,4,1,1,4,0,5,3,2
1251,1252,1252,white,age.gp2,Tr,NoTrade,Group,21,0,11,6,4,2,18,1,4,17,0,21,10,11
2143,2144,2144,other,age.gp2,NoTr,NoTrade,NoGroup,3,1,1,0,1,0,2,1,1,2,0,3,2,1
2921,2922,2922,white,age.gp4,NoTr,NoTrade,Group,13,2,3,4,4,1,12,0,7,6,1,12,12,1
390,391,391,black,age.gp4,NoTr,NoTrade,NoGroup,6,0,1,0,5,3,3,0,0,6,0,6,3,3
1542,1543,1543,white,age.gp2,NoTr,NoTrade,NoGroup,7,0,2,2,3,0,7,0,1,6,0,7,4,3
2589,2590,2590,white,age.gp4,NoTr,NoTrade,Group,11,1,3,1,6,0,9,2,5,6,0,11,8,3
1799,1800,1800,white,age.gp4,Tr,NoTrade,Group,11,0,2,4,5,1,9,1,2,9,0,11,9,2
2598,2599,2599,white,age.gp3,NoTr,NoTrade,Group,15,3,2,2,8,1,12,2,4,11,0,15,7,8
298,299,299,white,age.gp4,NoTr,NoTrade,Group,12,0,1,1,10,0,12,0,4,8,2,10,7,5
529,530,530,white,age.gp4,NoTr,NoTrade,NoGroup,3,0,1,0,2,1,2,0,2,1,0,3,3,0
681,682,682,white,age.gp4,Tr,NoTrade,Group,10,0,1,4,5,0,10,0,2,8,0,10,7,3
790,791,791,white,age.gp4,NoTr,NoTrade,NoGroup,1,0,0,0,1,0,1,0,0,1,0,1,1,0
1684,1685,1685,white,age.gp4,NoTr,Trade,NoGroup,6,0,2,2,2,0,5,1,3,3,1,5,6,0
1696,1697,1697,white,age.gp4,NoTr,Trade,NoGroup,4,1,1,1,1,1,3,0,1,3,1,3,3,1
587,588,588,other,age.gp4,NoTr,NoTrade,NoGroup,2,0,0,0,2,0,2,0,1,1,0,2,2,0
1225,1226,1226,white,age.gp4,NoTr,NoTrade,NoGroup,3,0,0,0,3,0,3,0,2,1,0,3,2,1
1924,1925,1925,other,age.gp2,NoTr,NoTrade,NoGroup,2,0,1,0,1,0,2,0,0,2,0,2,1,1
2571,2572,2572,white,age.gp4,NoTr,NoTrade,Group,8,1,1,1,5,2,5,1,2,6,3,5,5,3
2577,2578,2578,white,age.gp4,NoTr,NoTrade,Group,12,1,2,3,6,2,9,1,4,8,2,10,7,5
491,492,492,black,age.gp4,NoTr,NoTrade,NoGroup,6,1,0,2,3,5,1,0,1,5,1,5,2,4
834,835,835,white,age.gp3,NoTr,NoTrade,NoGroup,7,0,4,2,1,0,7,0,4,3,1,6,5,2
1569,1570,1570,white,age.gp4,Tr,NoTrade,Group,8,2,2,0,4,0,7,1,2,6,1,7,7,1
2042,2043,2043,white,age.gp4,Tr,NoTrade,Group,12,2,2,3,5,1,9,2,2,10,1,11,7,5
2552,2553,2553,other,age.gp1,NoTr,NoTrade,NoGroup,7,3,0,2,2,2,5,0,2,5,1,6,2,5
2581,2582,2582,white,age.gp4,NoTr,NoTrade,Group,10,0,2,1,7,0,10,0,3,7,0,10,7,3
2743,2744,2744,white,age.gp2,NoTr,NoTrade,Group,21,2,14,1,4,2,16,3,12,9,3,18,16,5
429,430,430,white,age.gp4,NoTr,NoTrade,NoGroup,4,0,0,2,2,0,4,0,1,3,0,4,3,1
893,894,894,other,age.gp1,Tr,NoTrade,NoGroup,8,5,0,1,2,0,8,0,2,6,0,8,3,5
1172,1173,1173,white,age.gp4,NoTr,NoTrade,NoGroup,2,0,0,0,2,0,2,0,0,2,0,2,2,0
2221,2222,2222,black,age.gp4,NoTr,Trade,Group,15,2,5,1,7,6,8,1,7,8,2,13,10,5
303,304,304,white,age.gp4,NoTr,NoTrade,Group,14,2,2,1,9,2,10,2,7,7,2,12,10,4
1101,1102,1102,black,age.gp2,NoTr,NoTrade,NoGroup,8,1,3,1,3,2,6,0,5,3,0,8,4,4
1185,1186,1186,white,age.gp4,Tr,NoTrade,NoGroup,4,0,1,0,3,0,3,1,0,4,0,4,2,2
1782,1783,1783,white,age.gp4,Tr,NoTrade,Group,13,2,2,1,8,0,12,1,5,8,0,13,10,3
1896,1897,1897,white,age.gp1,Tr,NoTrade,NoGroup,7,3,3,0,1,1,6,0,4,3,1,6,4,3
2036,2037,2037,white,age.gp4,Tr,NoTrade,Group,11,1,1,0,9,1,10,0,2,9,0,11,6,5
2226,2227,2227,black,age.gp4,NoTr,Trade,Group,9,1,1,3,4,6,3,0,1,8,0,9,2,7
2495,2496,2496,other,age.gp1,NoTr,NoTrade,NoGroup,5,2,1,0,2,0,5,0,2,3,0,5,2,3
1573,1574,1574,white,age.gp4,Tr,NoTrade,Group,13,0,5,2,6,1,11,1,5,8,1,12,12,1
2178,2179,2179,white,age.gp4,NoTr,NoTrade,NoGroup,5,0,2,0,3,0,4,1,3,2,0,5,3,2
2357,2358,2358,white,age.gp3,Tr,NoTrade,NoGroup,4,0,0,2,2,1,3,0,0,4,0,4,2,2
2711,2712,2712,white,age.gp4,NoTr,NoTrade,Group,11,0,1,2,8,0,11,0,1,10,0,11,9,2
2791,2792,2792,white,age.gp2,NoTr,NoTrade,Group,28,3,15,3,7,1,23,4,16,12,1,27,16,12
305,306,306,white,age.gp4,NoTr,NoTrade,Group,7,1,2,1,3,1,6,0,3,4,1,6,5,2
1059,1060,1060,white,age.gp4,NoTr,NoTrade,Group,10,1,4,1,4,1,9,0,6,4,0,10,6,4
801,802,802,white,age.gp4,NoTr,NoTrade,NoGroup,3,0,0,1,2,0,3,0,1,2,0,3,2,1
1998,1999,1999,black,age.gp4,NoTr,NoTrade,NoGroup,9,0,2,2,5,2,6,1,4,5,0,9,8,1
2672,2673,2673,white,age.gp3,NoTr,NoTrade,NoGroup,9,0,5,0,4,0,8,1,4,5,0,9,8,1
2896,2897,2897,other,age.gp1,NoTr,NoTrade,NoGroup,3,0,0,1,2,0,3,0,0,3,0,3,3,0
307,308,308,white,age.gp4,NoTr,NoTrade,Group,14,0,5,4,5,1,12,1,7,7,2,12,8,6
414,415,415,white,age.gp4,NoTr,NoTrade,NoGroup,5,0,0,1,4,0,5,0,3,2,0,5,5,0
685,686,686,white,age.gp4,Tr,NoTrade,Group,12,1,1,4,6,2,10,0,3,9,0,12,6,6
946,947,947,white,age.gp3,Tr,NoTrade,Group,15,1,4,3,7,3,12,0,4,11,1,14,12,3
1526,1527,1527,black,age.gp4,NoTr,NoTrade,NoGroup,5,2,1,0,2,2,2,1,0,5,1,4,4,1
1615,1616,1616,white,age.gp3,Tr,NoTrade,NoGroup,6,0,1,2,3,0,5,1,2,4,0,6,5,1
1689,1690,1690,white,age.gp4,NoTr,Trade,NoGroup,5,0,0,2,3,0,4,1,1,4,0,5,2,3
2704,2705,2705,white,age.gp4,NoTr,NoTrade,Group,9,1,0,2,6,2,7,0,4,5,0,9,6,3
2799,2800,2800,white,age.gp2,NoTr,NoTrade,NoGroup,13,0,7,3,3,1,11,1,3,10,1,12,8,5
325,326,326,white,age.gp4,NoTr,NoTrade,Group,11,0,5,2,4,1,9,1,4,7,0,11,10,1
548,549,549,white,age.gp4,NoTr,NoTrade,NoGroup,7,1,1,0,5,0,7,0,3,4,1,6,6,1
906,907,907,other,age.gp1,Tr,NoTrade,NoGroup,7,4,1,1,1,0,7,0,1,6,1,6,5,2
1916,1917,1917,other,age.gp2,NoTr,NoTrade,NoGroup,4,0,2,1,1,1,3,0,2,2,0,4,1,3
2733,2734,2734,black,age.gp3,NoTr,NoTrade,NoGroup,8,0,2,1,5,3,4,1,2,6,1,7,6,2
1293,1294,1294,white,age.gp4,NoTr,NoTrade,Group,9,0,3,1,5,0,9,0,3,6,0,9,6,3
1483,1484,1484,white,age.gp4,NoTr,NoTrade,NoGroup,10,2,1,3,4,0,10,0,4,6,1,9,6,4
1160,1161,1161,white,age.gp4,NoTr,NoTrade,NoGroup,8,0,4,1,3,0,7,1,5,3,1,7,8,0
1988,1989,1989,white,age.gp4,Tr,NoTrade,NoGroup,1,0,0,0,1,0,1,0,0,1,0,1,1,0
2183,2184,2184,white,age.gp4,NoTr,NoTrade,NoGroup,7,2,3,0,2,0,5,2,4,3,0,7,3,4
2442,2443,2443,white,age.gp4,NoTr,NoTrade,NoGroup,1,0,0,0,1,0,1,0,0,1,0,1,1,0
2448,2449,2449,white,age.gp4,NoTr,NoTrade,NoGroup,8,0,2,2,4,2,6,0,3,5,0,8,5,3
1339,1340,1340,white,age.gp3,NoTr,NoTrade,NoGroup,8,1,3,3,1,2,6,0,1,7,0,8,4,4
1579,1580,1580,white,age.gp4,Tr,NoTrade,Group,9,1,1,2,5,1,8,0,5,4,1,8,6,3
2353,2354,2354,white,age.gp3,Tr,NoTrade,NoGroup,6,0,2,3,1,1,4,1,1,5,1,5,5,1
2576,2577,2577,white,age.gp4,NoTr,NoTrade,Group,13,1,3,4,5,1,11,1,5,8,0,13,10,3
1730,1731,1731,white,age.gp3,Tr,NoTrade,Group,16,3,5,6,2,0,14,2,5,11,0,16,10,6
2007,2008,2008,black,age.gp4,NoTr,NoTrade,NoGroup,4,0,1,1,2,1,3,0,2,2,1,3,3,1
2230,2231,2231,black,age.gp4,NoTr,Trade,Group,9,0,2,1,6,2,5,2,1,8,1,8,3,6
2631,2632,2632,white,age.gp4,NoTr,NoTrade,NoGroup,10,1,3,0,6,1,7,2,2,8,0,10,5,5
2794,2795,2795,white,age.gp2,Tr,NoTrade,NoGroup,10,0,7,1,2,2,8,0,5,5,2,8,7,3
1186,1187,1187,white,age.gp4,Tr,NoTrade,NoGroup,5,0,1,1,3,0,4,1,1,4,0,5,3,2
526,527,527,white,age.gp4,NoTr,NoTrade,NoGroup,4,0,0,2,2,0,3,1,1,3,0,4,3,1
1617,1618,1618,white,age.gp3,Tr,NoTrade,NoGroup,6,0,1,2,3,0,6,0,0,6,0,6,6,0
2217,2218,2218,black,age.gp4,NoTr,Trade,Group,8,0,1,2,5,3,5,0,2,6,1,7,5,3
2720,2721,2721,white,age.gp4,NoTr,NoTrade,Group,9,1,0,2,6,0,8,1,3,6,0,9,7,2
1161,1162,1162,white,age.gp4,NoTr,NoTrade,NoGroup,5,0,2,0,3,0,3,2,3,2,0,5,4,1
430,431,431,white,age.gp4,NoTr,NoTrade,NoGroup,5,0,0,1,4,0,5,0,3,2,0,5,4,1
510,511,511,white,age.gp2,Tr,NoTrade,NoGroup,14,3,4,4,3,0,12,2,2,12,2,12,11,3
554,555,555,white,age.gp4,NoTr,NoTrade,NoGroup,4,0,1,1,2,0,3,1,2,2,0,4,3,1
578,579,579,other,age.gp4,NoTr,NoTrade,NoGroup,2,0,0,0,2,0,2,0,0,2,0,2,2,0
595,596,596,other,age.gp4,NoTr,NoTrade,NoGroup,5,0,1,0,4,1,4,0,2,3,0,5,3,2
1417,1418,1418,black,age.gp2,NoTr,NoTrade,NoGroup,7,0,1,3,3,4,3,0,1,6,0,7,2,5
2564,2565,2565,white,age.gp4,NoTr,NoTrade,Group,12,0,3,2,7,1,11,0,6,6,0,12,9,3
319,320,320,white,age.gp4,NoTr,NoTrade,Group,12,2,5,0,5,0,12,0,6,6,0,12,9,3
684,685,685,white,age.gp4,Tr,NoTrade,Group,10,0,3,0,7,2,8,0,3,7,0,10,8,2
686,687,687,white,age.gp4,Tr,NoTrade,Group,14,0,1,3,10,4,9,1,3,11,1,13,6,8
2611,2612,2612,white,age.gp4,NoTr,NoTrade,NoGroup,4,0,1,0,3,0,4,0,0,4,0,4,3,1
371,372,372,black,age.gp4,NoTr,NoTrade,NoGroup,5,1,1,1,2,4,1,0,0,5,0,5,1,4
585,586,586,other,age.gp4,NoTr,NoTrade,NoGroup,3,0,0,0,3,0,3,0,1,2,0,3,2,1
1175,1176,1176,white,age.gp4,Tr,NoTrade,NoGroup,9,1,1,3,4,1,7,1,3,6,1,8,5,4
1646,1647,1647,other,age.gp2,NoTr,NoTrade,NoGroup,8,2,2,2,2,2,6,0,2,6,1,7,5,3
2043,2044,2044,white,age.gp4,Tr,NoTrade,Group,7,0,0,1,6,1,6,0,2,5,0,7,6,1
434,435,435,white,age.gp4,NoTr,NoTrade,NoGroup,2,0,0,1,1,0,2,0,0,2,0,2,2,0
322,323,323,white,age.gp4,NoTr,NoTrade,Group,10,1,1,0,8,1,8,1,5,5,0,10,8,2
1275,1276,1276,white,age.gp4,NoTr,NoTrade,Group,4,0,1,0,3,0,4,0,2,2,0,4,3,1
1997,1998,1998,black,age.gp4,NoTr,NoTrade,NoGroup,1,0,0,0,1,0,1,0,0,1,0,1,1,0
2504,2505,2505,other,age.gp1,NoTr,NoTrade,NoGroup,8,2,3,1,2,3,5,0,3,5,1,7,3,5
574,575,575,other,age.gp4,NoTr,NoTrade,NoGroup,5,0,2,0,3,1,4,0,2,3,0,5,3,2
1056,1057,1057,white,age.gp4,NoTr,NoTrade,Group,11,1,2,3,5,1,9,1,5,6,1,10,7,4
1190,1191,1191,white,age.gp4,Tr,NoTrade,NoGroup,10,3,2,0,5,1,9,0,3,7,2,8,5,5
2259,2260,2260,white,age.gp4,Tr,NoTrade,Group,10,0,2,1,7,1,9,0,3,7,0,10,5,5
444,445,445,black,age.gp3,NoTr,NoTrade,NoGroup,7,1,3,2,1,3,3,1,4,3,2,5,5,2
1066,1067,1067,white,age.gp4,NoTr,NoTrade,Group,11,0,1,3,7,0,11,0,3,8,0,11,9,2
1577,1578,1578,white,age.gp4,Tr,NoTrade,Group,11,0,3,3,5,0,11,0,2,9,1,10,9,2
2080,2081,2081,black,age.gp3,NoTr,NoTrade,NoGroup,4,0,0,3,1,3,1,0,0,4,0,4,1,3
2569,2570,2570,white,age.gp4,NoTr,NoTrade,Group,12,0,4,1,7,2,9,1,1,11,0,12,6,6
903,904,904,other,age.gp1,Tr,NoTrade,NoGroup,4,3,1,0,0,1,3,0,0,4,0,4,1,3
1131,1132,1132,other,age.gp1,NoTr,NoTrade,NoGroup,9,3,1,3,2,0,9,0,3,6,0,9,5,4
1713,1714,1714,white,age.gp1,Tr,NoTrade,NoGroup,8,6,0,2,0,0,5,3,1,7,1,7,3,5
2497,2498,2498,other,age.gp1,NoTr,NoTrade,NoGroup,4,2,0,1,1,1,3,0,0,4,0,4,0,4
2769,2770,2770,white,age.gp1,NoTr,NoTrade,NoGroup,12,7,2,2,1,1,10,1,4,8,1,11,8,4
329,330,330,white,age.gp1,NoTr,NoTrade,NoGroup,11,8,0,1,2,0,10,1,6,5,2,9,4,7
678,679,679,white,age.gp4,Tr,NoTrade,Group,13,3,2,1,7,0,11,2,3,10,1,12,8,5
1624,1625,1625,white,age.gp1,NoTr,NoTrade,NoGroup,8,5,2,1,0,2,3,3,1,7,1,7,3,5
330,331,331,white,age.gp1,NoTr,NoTrade,NoGroup,7,5,0,1,1,2,4,1,2,5,3,4,5,2
1311,1312,1312,white,age.gp1,NoTr,NoTrade,NoGroup,8,6,0,1,1,0,5,3,3,5,2,6,5,3
2496,2497,2497,other,age.gp1,NoTr,NoTrade,NoGroup,1,1,0,0,0,0,1,0,0,1,0,1,0,1
1872,1873,1873,other,age.gp1,NoTr,NoTrade,Group,10,3,0,3,4,3,7,0,3,7,0,10,6,4
2094,2095,2095,black,age.gp3,NoTr,NoTrade,NoGroup,4,0,2,1,1,2,2,0,1,3,2,2,3,1
2352,2353,2353,white,age.gp3,Tr,NoTrade,NoGroup,5,0,1,0,4,0,5,0,2,3,0,5,3,2
2360,2361,2361,white,age.gp3,Tr,NoTrade,NoGroup,5,1,3,1,0,0,4,1,3,2,0,5,2,3
2406,2407,2407,white,age.gp3,NoTr,NoTrade,NoGroup,12,4,6,0,2,0,7,5,5,7,1,11,7,5
2440,2441,2441,white,age.gp4,NoTr,NoTrade,NoGroup,5,0,2,1,2,0,5,0,5,0,0,5,4,1
2963,2964,2964,white,age.gp2,NoTr,NoTrade,NoGroup,7,0,5,1,1,0,5,2,6,1,0,7,5,2
333,334,334,white,age.gp2,Tr,NoTrade,NoGroup,10,0,6,2,2,2,7,1,5,5,3,7,7,3
880,881,881,white,age.gp3,NoTr,Trade,Group,10,1,4,4,1,1,8,1,6,4,0,10,6,4
1660,1661,1661,other,age.gp2,NoTr,NoTrade,NoGroup,7,0,3,2,2,1,6,0,5,2,0,7,4,3
2074,2075,2075,black,age.gp3,NoTr,NoTrade,NoGroup,1,0,1,0,0,0,1,0,1,0,0,1,0,1
335,336,336,white,age.gp2,Tr,NoTrade,NoGroup,9,1,1,3,4,0,9,0,2,7,0,9,6,3
442,443,443,white,age.gp4,NoTr,NoTrade,NoGroup,1,0,1,0,0,0,1,0,1,0,0,1,0,1
2471,2472,2472,white,age.gp1,NoTr,NoTrade,NoGroup,9,3,2,1,3,0,8,1,3,6,1,8,4,5
1911,1912,1912,other,age.gp2,NoTr,NoTrade,NoGroup,5,0,5,0,0,0,5,0,4,1,0,5,3,2
1943,1944,1944,white,age.gp4,NoTr,NoTrade,Group,7,0,2,1,4,0,6,1,4,3,0,7,5,2
1240,1241,1241,white,age.gp2,Tr,NoTrade,NoGroup,9,1,5,2,1,2,7,0,3,6,3,6,4,5
1895,1896,1896,other,age.gp1,NoTr,NoTrade,Group,10,1,4,4,1,3,7,0,1,9,1,9,8,2
2902,2903,2903,other,age.gp1,NoTr,NoTrade,NoGroup,4,1,3,0,0,0,4,0,2,2,1,3,3,1
2903,2904,2904,other,age.gp1,NoTr,NoTrade,NoGroup,6,3,0,2,1,0,6,0,3,3,1,5,4,2
625,626,626,other,age.gp1,NoTr,Trade,Group,7,2,1,2,2,1,6,0,1,6,2,5,4,3
904,905,905,other,age.gp1,Tr,NoTrade,NoGroup,6,4,1,1,0,1,5,0,1,5,1,5,4,2
978,979,979,white,age.gp4,NoTr,NoTrade,NoGroup,5,2,0,0,3,0,4,1,0,5,1,4,2,3
1880,1881,1881,other,age.gp1,NoTr,NoTrade,Group,9,5,1,3,0,3,6,0,2,7,4,5,7,2
2644,2645,2645,white,age.gp1,NoTr,NoTrade,NoGroup,13,7,3,1,2,1,10,2,2,11,3,10,7,6
657,658,658,white,age.gp2,Tr,NoTrade,NoGroup,7,1,3,3,0,0,7,0,1,6,1,6,5,2
786,787,787,black,age.gp1,Tr,NoTrade,NoGroup,11,7,2,1,1,4,4,3,4,7,5,6,6,5
1885,1886,1886,other,age.gp1,NoTr,NoTrade,Group,7,3,2,1,1,2,5,0,1,6,1,6,3,4
2547,2548,2548,other,age.gp1,NoTr,NoTrade,NoGroup,5,1,2,2,0,0,4,1,1,4,1,4,4,1
644,645,645,other,age.gp1,NoTr,Trade,Group,6,2,2,1,1,0,6,0,2,4,1,5,4,2
1433,1434,1434,white,age.gp3,Tr,NoTrade,NoGroup,8,2,4,2,0,1,6,1,3,5,2,6,6,2
1443,1444,1444,white,age.gp3,Tr,NoTrade,NoGroup,7,4,1,0,2,2,4,1,1,6,1,6,4,3
1631,1632,1632,white,age.gp1,NoTr,NoTrade,NoGroup,10,4,3,2,1,1,6,3,4,6,1,9,4,6
1844,1845,1845,black,age.gp3,NoTr,NoTrade,NoGroup,9,3,3,1,2,3,5,1,3,6,2,7,6,3
2400,2401,2401,white,age.gp3,NoTr,NoTrade,NoGroup,5,1,0,1,3,0,4,1,0,5,1,4,3,2
2697,2698,2698,white,age.gp4,NoTr,NoTrade,Group,14,4,3,0,7,0,14,0,6,8,2,12,8,6
2886,2887,2887,white,age.gp1,NoTr,NoTrade,Group,19,10,4,2,3,3,13,3,10,9,3,16,13,6
1871,1872,1872,other,age.gp1,NoTr,NoTrade,Group,11,8,3,0,0,2,9,0,4,7,3,8,6,5
2503,2504,2504,other,age.gp1,NoTr,NoTrade,NoGroup,5,1,2,2,0,0,5,0,2,3,1,4,4,1
2546,2547,2547,other,age.gp1,NoTr,NoTrade,NoGroup,6,4,0,1,1,0,6,0,2,4,3,3,4,2
725,726,726,black,age.gp4,NoTr,NoTrade,NoGroup,3,0,1,1,1,1,1,1,0,3,0,3,1,2
1564,1565,1565,white,age.gp4,Tr,NoTrade,Group,9,2,2,0,5,1,8,0,2,7,1,8,4,5
1647,1648,1648,other,age.gp2,NoTr,NoTrade,NoGroup,7,1,4,2,0,0,7,0,2,5,1,6,6,1
1703,1704,1704,white,age.gp4,NoTr,Trade,NoGroup,1,0,1,0,0,0,1,0,0,1,0,1,1,0
483,484,484,black,age.gp4,NoTr,NoTrade,NoGroup,6,0,3,2,1,3,2,1,2,4,2,4,4,2
2466,2467,2467,white,age.gp1,Tr,NoTrade,NoGroup,12,10,2,0,0,0,9,3,3,9,2,10,4,8
2821,2822,2822,other,age.gp2,NoTr,NoTrade,NoGroup,4,0,3,0,1,2,2,0,1,3,0,4,2,2
902,903,903,other,age.gp1,Tr,NoTrade,NoGroup,4,1,2,1,0,1,3,0,0,4,1,3,2,2
2106,2107,2107,white,age.gp2,Tr,NoTrade,Group,20,2,9,4,5,0,19,1,9,11,1,19,15,5
2386,2387,2387,white,age.gp2,Tr,NoTrade,Group,25,3,8,8,6,2,22,1,9,16,4,21,18,7
2668,2669,2669,white,age.gp3,NoTr,NoTrade,NoGroup,7,2,3,0,2,0,5,2,3,4,0,7,4,3
1719,1720,1720,white,age.gp2,NoTr,NoTrade,Group,21,1,11,4,5,4,15,2,9,12,2,19,16,5
2584,2585,2585,white,age.gp4,NoTr,NoTrade,Group,9,0,3,4,2,3,5,1,4,5,1,8,6,3
2772,2773,2773,white,age.gp3,NoTr,NoTrade,Group,11,2,6,3,0,1,8,2,2,9,0,11,7,4
347,348,348,black,age.gp4,NoTr,NoTrade,NoGroup,4,1,1,0,2,1,3,0,1,3,1,3,4,0
1632,1633,1633,white,age.gp1,NoTr,NoTrade,NoGroup,11,4,2,4,1,1,9,1,2,9,0,11,4,7
2766,2767,2767,black,age.gp2,NoTr,NoTrade,NoGroup,5,0,3,1,1,2,3,0,0,5,0,5,2,3
348,349,349,black,age.gp4,NoTr,NoTrade,NoGroup,5,2,1,1,1,0,2,3,1,4,0,5,2,3
589,590,590,other,age.gp4,NoTr,NoTrade,NoGroup,2,0,0,0,2,2,0,0,0,2,1,1,1,1
1129,1130,1130,other,age.gp1,NoTr,NoTrade,NoGroup,4,1,1,1,1,1,3,0,1,3,0,4,3,1
349,350,350,black,age.gp4,NoTr,NoTrade,NoGroup,5,1,1,1,2,3,1,1,1,4,1,4,2,3
858,859,859,other,age.gp2,Tr,NoTrade,Group,12,0,5,5,2,1,11,0,5,7,0,12,10,2
2003,2004,2004,black,age.gp4,NoTr,NoTrade,NoGroup,5,0,1,0,4,3,2,0,1,4,0,5,2,3
1367,1368,1368,black,age.gp4,NoTr,NoTrade,Group,8,0,1,0,7,4,4,0,1,7,1,7,6,2
351,352,352,black,age.gp4,NoTr,NoTrade,NoGroup,6,1,2,0,3,2,4,0,1,5,0,6,3,3
389,390,390,black,age.gp4,NoTr,NoTrade,NoGroup,6,0,0,1,5,5,1,0,0,6,0,6,4,2
1825,1826,1826,black,age.gp4,NoTr,NoTrade,NoGroup,8,3,1,2,2,7,1,0,4,4,1,7,2,6
352,353,353,black,age.gp4,NoTr,NoTrade,NoGroup,5,0,1,0,4,3,2,0,1,4,0,5,3,2
1346,1347,1347,black,age.gp4,NoTr,NoTrade,Group,14,1,1,4,8,10,2,2,1,13,2,12,5,9
2014,2015,2015,black,age.gp4,NoTr,NoTrade,NoGroup,1,0,0,0,1,1,0,0,0,1,0,1,0,1
353,354,354,black,age.gp4,NoTr,NoTrade,NoGroup,1,0,1,0,0,0,1,0,0,1,0,1,1,0
354,355,355,black,age.gp4,NoTr,NoTrade,NoGroup,1,0,1,0,0,1,0,0,0,1,0,1,1,0
355,356,356,black,age.gp4,NoTr,NoTrade,NoGroup,6,1,1,3,1,3,1,2,0,6,0,6,1,5
2101,2102,2102,black,age.gp3,NoTr,NoTrade,NoGroup,10,2,0,4,4,5,4,1,1,9,1,9,3,7
2626,2627,2627,white,age.gp4,NoTr,NoTrade,NoGroup,5,2,0,1,2,1,4,0,3,2,0,5,3,2
356,357,357,black,age.gp4,NoTr,NoTrade,NoGroup,1,0,0,0,1,0,1,0,0,1,0,1,1,0
357,358,358,black,age.gp4,NoTr,NoTrade,NoGroup,3,0,0,1,2,1,2,0,1,2,0,3,2,1
2271,2272,2272,white,age.gp4,Tr,NoTrade,Group,15,1,3,4,7,1,12,2,7,8,0,15,10,5
1281,1282,1282,white,age.gp4,NoTr,NoTrade,Group,12,1,3,1,7,2,10,0,7,5,0,12,8,4
2033,2034,2034,white,age.gp4,Tr,NoTrade,Group,7,1,2,2,2,1,6,0,2,5,1,6,5,2
359,360,360,black,age.gp4,NoTr,NoTrade,NoGroup,1,0,1,0,0,1,0,0,0,1,0,1,0,1
1379,1380,1380,black,age.gp2,NoTr,NoTrade,NoGroup,10,0,5,1,4,7,2,1,2,8,2,8,6,4
720,721,721,black,age.gp4,NoTr,NoTrade,NoGroup,3,0,1,0,2,1,2,0,1,2,0,3,2,1
1365,1366,1366,black,age.gp4,NoTr,NoTrade,Group,10,1,1,2,6,4,5,1,4,6,0,10,4,6
361,362,362,black,age.gp4,NoTr,NoTrade,NoGroup,2,0,1,0,1,2,0,0,0,2,1,1,1,1
1822,1823,1823,black,age.gp4,NoTr,NoTrade,NoGroup,2,1,0,0,1,1,1,0,0,2,0,2,1,1
1196,1197,1197,white,age.gp4,Tr,NoTrade,NoGroup,5,1,1,0,3,2,2,1,0,5,0,5,1,4
1765,1766,1766,black,age.gp4,NoTr,NoTrade,NoGroup,7,1,0,2,4,6,1,0,2,5,1,6,2,5
2044,2045,2045,white,age.gp4,Tr,NoTrade,Group,9,0,2,1,6,3,6,0,2,7,1,8,6,3
364,365,365,black,age.gp4,NoTr,NoTrade,NoGroup,1,0,0,0,1,1,0,0,0,1,0,1,0,1
984,985,985,white,age.gp4,NoTr,NoTrade,NoGroup,1,0,0,0,1,1,0,0,0,1,0,1,0,1
366,367,367,black,age.gp4,NoTr,NoTrade,NoGroup,2,0,0,0,2,2,0,0,0,2,0,2,0,2
1033,1034,1034,black,age.gp4,NoTr,NoTrade,NoGroup,5,0,0,0,5,4,1,0,0,5,0,5,1,4
367,368,368,black,age.gp4,NoTr,NoTrade,NoGroup,3,0,1,0,2,3,0,0,0,3,1,2,1,2
368,369,369,black,age.gp4,NoTr,NoTrade,NoGroup,1,0,0,0,1,0,1,0,0,1,0,1,1,0
369,370,370,black,age.gp4,NoTr,NoTrade,NoGroup,4,0,0,2,2,3,1,0,1,3,1,3,3,1
406,407,407,black,age.gp4,NoTr,NoTrade,NoGroup,4,1,1,0,2,4,0,0,0,4,1,3,1,3
1375,1376,1376,black,age.gp2,NoTr,NoTrade,NoGroup,4,1,2,0,1,2,1,1,1,3,0,4,2,2
372,373,373,black,age.gp4,NoTr,NoTrade,NoGroup,6,1,2,0,3,3,2,1,1,5,0,6,2,4
503,504,504,black,age.gp4,NoTr,NoTrade,NoGroup,2,0,0,0,2,2,0,0,0,2,1,1,1,1
374,375,375,black,age.gp4,NoTr,NoTrade,NoGroup,4,1,2,0,1,1,2,1,2,2,2,2,4,0
2214,2215,2215,black,age.gp4,NoTr,Trade,Group,9,1,1,0,7,3,5,1,3,6,0,9,4,5
2279,2280,2280,other,age.gp2,Tr,NoTrade,Group,7,0,3,2,2,1,6,0,5,2,1,6,5,2
375,376,376,black,age.gp4,NoTr,NoTrade,NoGroup,1,0,0,0,1,0,1,0,0,1,0,1,1,0
378,379,379,black,age.gp4,NoTr,NoTrade,NoGroup,1,0,0,0,1,0,1,0,1,0,0,1,1,0
379,380,380,black,age.gp4,NoTr,NoTrade,NoGroup,2,0,1,1,0,0,2,0,2,0,0,2,1,1
1611,1612,1612,white,age.gp3,Tr,NoTrade,NoGroup,7,2,3,0,2,1,4,2,4,3,1,6,4,3
380,381,381,black,age.gp4,NoTr,NoTrade,NoGroup,1,0,0,0,1,1,0,0,0,1,0,1,1,0
1360,1361,1361,black,age.gp4,NoTr,NoTrade,Group,7,1,0,0,6,2,5,0,1,6,0,7,0,7
1538,1539,1539,black,age.gp4,NoTr,NoTrade,NoGroup,5,0,1,0,4,4,0,1,0,5,0,5,1,4
2078,2079,2079,black,age.gp3,NoTr,NoTrade,NoGroup,5,1,3,0,1,4,1,0,2,3,1,4,2,3
382,383,383,black,age.gp4,NoTr,NoTrade,NoGroup,4,0,1,2,1,2,2,0,2,2,1,3,2,2
2667,2668,2668,white,age.gp3,NoTr,NoTrade,NoGroup,7,1,1,3,2,1,6,0,2,5,0,7,4,3
383,384,384,black,age.gp4,NoTr,NoTrade,NoGroup,1,0,0,0,1,0,1,0,1,0,0,1,1,0
384,385,385,black,age.gp4,NoTr,NoTrade,NoGroup,4,0,1,0,3,2,2,0,1,3,0,4,2,2
650,651,651,black,age.gp2,NoTr,NoTrade,NoGroup,12,1,2,6,3,6,6,0,2,10,1,11,5,7
1075,1076,1076,white,age.gp4,NoTr,NoTrade,Group,7,1,0,2,4,1,6,0,4,3,0,7,3,4
1182,1183,1183,white,age.gp4,Tr,NoTrade,NoGroup,1,0,0,0,1,1,0,0,0,1,0,1,0,1
385,386,386,black,age.gp4,NoTr,NoTrade,NoGroup,3,0,1,2,0,2,0,1,0,3,0,3,0,3
1930,1931,1931,other,age.gp2,NoTr,NoTrade,NoGroup,4,0,2,0,2,1,3,0,1,3,0,4,3,1
386,387,387,black,age.gp4,NoTr,NoTrade,NoGroup,3,1,0,0,2,2,0,1,0,3,0,3,0,3
571,572,572,other,age.gp4,NoTr,NoTrade,NoGroup,4,0,0,0,4,2,2,0,1,3,0,4,2,2
1531,1532,1532,black,age.gp4,NoTr,NoTrade,NoGroup,5,0,1,1,3,3,2,0,1,4,1,4,3,2
387,388,388,black,age.gp4,NoTr,NoTrade,NoGroup,4,0,1,0,3,2,2,0,2,2,0,4,2,2
480,481,481,black,age.gp4,NoTr,NoTrade,NoGroup,7,0,1,3,3,5,2,0,2,5,2,5,5,2
1192,1193,1193,white,age.gp4,Tr,NoTrade,NoGroup,3,0,0,0,3,1,2,0,1,2,0,3,1,2
388,389,389,black,age.gp4,NoTr,NoTrade,NoGroup,1,0,0,0,1,0,1,0,0,1,0,1,0,1
1348,1349,1349,black,age.gp4,NoTr,NoTrade,Group,5,0,2,0,3,3,2,0,0,5,0,5,2,3
2013,2014,2014,black,age.gp4,NoTr,NoTrade,NoGroup,7,0,1,3,3,4,3,0,2,5,1,6,4,3
730,731,731,black,age.gp4,NoTr,NoTrade,NoGroup,2,0,0,0,2,1,1,0,1,1,0,2,0,2
2744,2745,2745,white,age.gp2,NoTr,NoTrade,Group,19,2,8,6,3,3,15,1,8,11,3,16,10,9
391,392,392,black,age.gp4,NoTr,NoTrade,NoGroup,1,0,0,1,0,1,0,0,0,1,0,1,0,1
2684,2685,2685,black,age.gp3,NoTr,NoTrade,NoGroup,7,0,1,1,5,3,4,0,3,4,0,7,4,3
392,393,393,black,age.gp4,NoTr,NoTrade,NoGroup,3,2,0,0,1,2,1,0,2,1,0,3,1,2
1024,1025,1025,black,age.gp4,NoTr,NoTrade,NoGroup,3,0,0,0,3,2,1,0,1,2,0,3,1,2
394,395,395,black,age.gp4,NoTr,NoTrade,NoGroup,9,0,2,4,3,5,3,1,2,7,0,9,5,4
735,736,736,black,age.gp4,NoTr,NoTrade,NoGroup,2,0,1,0,1,2,0,0,0,2,0,2,1,1
2844,2845,2845,black,age.gp3,NoTr,NoTrade,Group,14,2,1,5,6,9,5,0,4,10,2,12,7,7
399,400,400,black,age.gp4,NoTr,NoTrade,NoGroup,5,0,1,1,3,4,1,0,0,5,0,5,1,4
734,735,735,black,age.gp4,NoTr,NoTrade,NoGroup,6,0,2,2,2,5,1,0,1,5,1,5,2,4
1347,1348,1348,black,age.gp4,NoTr,NoTrade,Group,8,0,1,3,4,6,1,1,1,7,0,8,1,7
1563,1564,1564,white,age.gp4,Tr,NoTrade,Group,11,1,0,4,6,4,7,0,2,9,2,9,4,7
1833,1834,1834,black,age.gp4,NoTr,NoTrade,NoGroup,3,0,1,0,2,2,1,0,1,2,0,3,1,2
397,398,398,black,age.gp4,NoTr,NoTrade,NoGroup,1,0,0,0,1,1,0,0,0,1,0,1,0,1
1040,1041,1041,black,age.gp4,NoTr,NoTrade,NoGroup,4,1,1,0,2,4,0,0,0,4,1,3,1,3
1757,1758,1758,black,age.gp4,NoTr,NoTrade,NoGroup,1,0,0,0,1,1,0,0,0,1,0,1,0,1
2690,2691,2691,black,age.gp3,NoTr,NoTrade,NoGroup,13,0,5,6,2,6,5,2,2,11,3,10,7,6
400,401,401,black,age.gp4,NoTr,NoTrade,NoGroup,1,0,0,0,1,1,0,0,0,1,1,0,1,0
401,402,402,black,age.gp4,NoTr,NoTrade,NoGroup,1,0,0,0,1,0,1,0,0,1,0,1,1,0
403,404,404,black,age.gp4,NoTr,NoTrade,NoGroup,1,0,0,0,1,1,0,0,0,1,0,1,0,1
404,405,405,black,age.gp4,NoTr,NoTrade,NoGroup,1,0,0,0,1,1,0,0,0,1,0,1,1,0
1519,1520,1520,black,age.gp4,NoTr,NoTrade,NoGroup,5,1,0,1,3,3,2,0,2,3,0,5,1,4
713,714,714,black,age.gp4,NoTr,NoTrade,NoGroup,6,1,0,0,5,4,1,1,0,6,2,4,5,1
1229,1230,1230,white,age.gp4,NoTr,NoTrade,NoGroup,5,0,3,1,1,1,4,0,3,2,2,3,2,3
2404,2405,2405,white,age.gp3,NoTr,NoTrade,NoGroup,5,0,3,1,1,0,5,0,3,2,2,3,5,0
2468,2469,2469,white,age.gp1,NoTr,NoTrade,NoGroup,7,3,4,0,0,2,3,2,4,3,2,5,2,5
462,463,463,white,age.gp1,NoTr,NoTrade,NoGroup,7,3,3,1,0,1,4,2,1,6,1,6,5,2
2065,2066,2066,white,age.gp3,Tr,NoTrade,Group,20,1,11,1,7,2,15,3,10,10,1,19,16,4
666,667,667,white,age.gp2,Tr,NoTrade,NoGroup,7,0,5,2,0,0,7,0,2,5,3,4,4,3
728,729,729,black,age.gp4,NoTr,NoTrade,NoGroup,3,0,2,1,0,0,3,0,2,1,1,2,1,2
835,836,836,white,age.gp3,NoTr,NoTrade,NoGroup,12,1,6,3,2,0,11,1,6,6,2,10,8,4
2734,2735,2735,black,age.gp3,NoTr,NoTrade,NoGroup,6,0,2,2,2,4,2,0,1,5,1,5,1,5
2907,2908,2908,other,age.gp1,NoTr,NoTrade,NoGroup,4,1,2,0,1,0,4,0,2,2,1,3,3,1
579,580,580,other,age.gp4,NoTr,NoTrade,NoGroup,5,1,2,0,2,4,1,0,1,4,1,4,3,2
1132,1133,1133,other,age.gp1,NoTr,NoTrade,NoGroup,3,1,1,1,0,1,2,0,2,1,2,1,2,1
1495,1496,1496,white,age.gp4,NoTr,NoTrade,NoGroup,4,1,2,0,1,0,3,1,2,2,1,3,3,1
1910,1911,1911,other,age.gp2,NoTr,NoTrade,NoGroup,3,0,2,1,0,0,3,0,2,1,1,2,2,1
1991,1992,1992,white,age.gp4,Tr,NoTrade,NoGroup,7,0,2,2,3,1,5,1,4,3,1,6,4,3
2116,2117,2117,white,age.gp2,NoTr,NoTrade,NoGroup,13,1,5,3,4,1,11,1,5,8,2,11,7,6
2816,2817,2817,other,age.gp2,NoTr,NoTrade,NoGroup,4,0,3,1,0,0,4,0,3,1,1,3,3,1
2871,2872,2872,white,age.gp1,NoTr,NoTrade,Group,28,12,5,7,4,1,22,5,10,18,4,24,17,11
2889,2890,2890,other,age.gp1,NoTr,NoTrade,NoGroup,1,0,1,0,0,0,1,0,1,0,1,0,1,0
659,660,660,white,age.gp2,Tr,NoTrade,NoGroup,15,1,7,1,6,4,9,2,5,10,2,13,9,6
412,413,413,white,age.gp4,NoTr,NoTrade,NoGroup,2,1,1,0,0,0,0,2,0,2,1,1,1,1
2141,2142,2142,other,age.gp2,NoTr,NoTrade,NoGroup,4,0,2,1,1,1,3,0,1,3,0,4,2,2
413,414,414,white,age.gp4,NoTr,NoTrade,NoGroup,1,0,1,0,0,0,1,0,0,1,0,1,0,1
415,416,416,white,age.gp4,NoTr,NoTrade,NoGroup,3,0,0,0,3,0,3,0,2,1,0,3,2,1
2629,2630,2630,white,age.gp4,NoTr,NoTrade,NoGroup,2,0,0,0,2,0,2,0,0,2,0,2,1,1
416,417,417,white,age.gp4,NoTr,NoTrade,NoGroup,1,0,0,0,1,0,1,0,0,1,0,1,1,0
1048,1049,1049,black,age.gp4,NoTr,NoTrade,NoGroup,5,0,1,0,4,2,3,0,1,4,0,5,2,3
1571,1572,1572,white,age.gp4,Tr,NoTrade,Group,9,0,2,0,7,0,8,1,1,8,0,9,7,2
418,419,419,white,age.gp4,NoTr,NoTrade,NoGroup,2,0,0,0,2,0,2,0,1,1,0,2,2,0
2262,2263,2263,white,age.gp4,Tr,NoTrade,Group,11,0,1,2,8,1,10,0,1,10,0,11,6,5
2951,2952,2952,white,age.gp4,NoTr,NoTrade,Group,10,0,0,2,8,1,9,0,4,6,1,9,7,3
419,420,420,white,age.gp4,NoTr,NoTrade,NoGroup,1,0,1,0,0,0,1,0,0,1,0,1,0,1
420,421,421,white,age.gp4,NoTr,NoTrade,NoGroup,5,0,1,2,2,1,4,0,2,3,1,4,4,1
993,994,994,white,age.gp4,NoTr,NoTrade,NoGroup,2,0,0,0,2,0,2,0,1,1,0,2,1,1
421,422,422,white,age.gp4,NoTr,NoTrade,NoGroup,8,2,0,2,4,3,4,1,2,6,2,6,5,3
485,486,486,black,age.gp4,NoTr,NoTrade,NoGroup,6,0,1,2,3,1,5,0,3,3,0,6,3,3
716,717,717,black,age.gp4,NoTr,NoTrade,NoGroup,5,0,1,0,4,1,4,0,2,3,0,5,3,2
1874,1875,1875,other,age.gp1,NoTr,NoTrade,Group,6,2,1,0,3,2,4,0,1,5,0,6,1,5
2215,2216,2216,black,age.gp4,NoTr,Trade,Group,9,2,1,1,5,3,4,2,3,6,0,9,5,4
422,423,423,white,age.gp4,NoTr,NoTrade,NoGroup,4,0,1,1,2,0,3,1,3,1,0,4,4,0
2702,2703,2703,white,age.gp4,NoTr,NoTrade,Group,12,0,1,4,7,1,11,0,4,8,1,11,10,2
425,426,426,white,age.gp4,NoTr,NoTrade,NoGroup,4,0,0,1,3,0,4,0,1,3,0,4,2,2
1154,1155,1155,white,age.gp4,NoTr,NoTrade,NoGroup,7,0,0,0,7,0,7,0,1,6,0,7,5,2
1974,1975,1975,white,age.gp4,Tr,NoTrade,NoGroup,4,0,1,2,1,0,4,0,2,2,0,4,2,2
426,427,427,white,age.gp4,NoTr,NoTrade,NoGroup,1,0,0,0,1,0,1,0,0,1,0,1,1,0
2324,2325,2325,white,age.gp1,NoTr,NoTrade,NoGroup,12,5,3,3,1,1,11,0,5,7,0,12,3,9
2779,2780,2780,white,age.gp3,NoTr,NoTrade,Group,17,0,4,6,7,1,15,1,7,10,2,15,10,7
428,429,429,white,age.gp4,NoTr,NoTrade,NoGroup,1,0,0,0,1,0,1,0,0,1,0,1,1,0
2722,2723,2723,white,age.gp4,NoTr,NoTrade,Group,12,0,0,2,10,1,10,1,3,9,0,12,8,4
538,539,539,white,age.gp4,NoTr,NoTrade,NoGroup,4,0,0,0,4,0,4,0,2,2,0,4,2,2
1940,1941,1941,white,age.gp4,NoTr,NoTrade,Group,9,1,0,1,7,0,9,0,1,8,1,8,4,5
612,613,613,other,age.gp4,NoTr,NoTrade,NoGroup,2,0,1,0,1,0,2,0,0,2,1,1,1,1
2561,2562,2562,white,age.gp4,NoTr,NoTrade,Group,10,2,1,1,6,1,9,0,5,5,0,10,6,4
436,437,437,white,age.gp4,NoTr,NoTrade,NoGroup,7,0,2,3,2,0,7,0,2,5,0,7,4,3
767,768,768,white,age.gp4,NoTr,NoTrade,NoGroup,5,0,0,1,4,0,5,0,3,2,0,5,2,3
2959,2960,2960,white,age.gp2,NoTr,NoTrade,Group,22,2,10,6,4,3,17,2,9,13,2,20,13,9
1695,1696,1696,white,age.gp4,NoTr,Trade,NoGroup,4,0,0,0,4,0,4,0,3,1,0,4,2,2
2755,2756,2756,white,age.gp3,NoTr,NoTrade,NoGroup,6,0,3,1,2,0,5,1,2,4,0,6,3,3
440,441,441,white,age.gp4,NoTr,NoTrade,NoGroup,1,0,1,0,0,0,1,0,0,1,0,1,1,0
1268,1269,1269,black,age.gp3,NoTr,NoTrade,NoGroup,7,1,3,2,1,5,2,0,1,6,2,5,2,5
930,931,931,white,age.gp3,NoTr,NoTrade,NoGroup,10,1,4,1,4,2,8,0,3,7,3,7,5,5
1313,1314,1314,white,age.gp1,NoTr,NoTrade,NoGroup,14,2,6,2,4,1,10,3,6,8,1,13,10,4
447,448,448,black,age.gp3,NoTr,NoTrade,NoGroup,5,1,1,1,2,5,0,0,0,5,0,5,3,2
1026,1027,1027,black,age.gp4,NoTr,NoTrade,NoGroup,11,0,0,4,7,2,9,0,2,9,0,11,8,3
448,449,449,black,age.gp3,NoTr,NoTrade,NoGroup,1,0,0,0,1,1,0,0,0,1,0,1,1,0
449,450,450,black,age.gp3,NoTr,NoTrade,NoGroup,6,1,1,4,0,5,0,1,1,5,0,6,2,4
450,451,451,black,age.gp3,NoTr,NoTrade,NoGroup,10,1,6,0,3,5,4,1,4,6,2,8,7,3
532,533,533,white,age.gp4,NoTr,NoTrade,NoGroup,4,1,0,1,2,1,3,0,2,2,0,4,3,1
627,628,628,other,age.gp1,NoTr,Trade,Group,8,3,1,2,2,2,6,0,1,7,0,8,4,4
2378,2379,2379,white,age.gp2,NoTr,NoTrade,NoGroup,6,0,3,1,2,1,5,0,2,4,1,5,3,3
451,452,452,black,age.gp3,NoTr,NoTrade,NoGroup,5,0,1,1,3,4,1,0,0,5,0,5,2,3
552,553,553,white,age.gp4,NoTr,NoTrade,NoGroup,6,1,1,4,0,1,5,0,1,5,1,5,2,4
1528,1529,1529,black,age.gp4,NoTr,NoTrade,NoGroup,4,1,0,1,2,2,2,0,1,3,1,3,2,2
2688,2689,2689,black,age.gp3,NoTr,NoTrade,NoGroup,5,0,2,3,0,2,3,0,0,5,1,4,2,3
2302,2303,2303,other,age.gp2,Tr,NoTrade,Group,9,1,3,4,1,2,7,0,5,4,0,9,6,3
1224,1225,1225,white,age.gp4,NoTr,NoTrade,NoGroup,8,0,3,2,3,3,4,1,1,7,0,8,5,3
1366,1367,1367,black,age.gp4,NoTr,NoTrade,Group,13,0,3,4,6,8,5,0,2,11,2,11,7,6
1732,1733,1733,white,age.gp3,Tr,NoTrade,Group,23,0,10,8,5,3,18,2,8,15,2,21,15,8
1460,1461,1461,white,age.gp1,NoTr,NoTrade,NoGroup,10,4,2,3,1,0,9,1,4,6,1,9,5,5
1470,1471,1471,white,age.gp1,NoTr,NoTrade,NoGroup,7,4,2,1,0,1,4,2,1,6,2,5,4,3
1712,1713,1713,white,age.gp1,Tr,NoTrade,NoGroup,12,7,3,1,1,0,8,4,4,8,1,11,9,3
2498,2499,2499,other,age.gp1,NoTr,NoTrade,NoGroup,3,2,0,0,1,0,3,0,0,3,0,3,1,2
2859,2860,2860,white,age.gp1,Tr,NoTrade,NoGroup,15,9,2,3,1,2,9,4,8,7,1,14,3,12
789,790,790,white,age.gp4,NoTr,NoTrade,NoGroup,5,1,1,1,2,0,4,1,3,2,0,5,3,2
892,893,893,other,age.gp1,Tr,NoTrade,NoGroup,2,2,0,0,0,0,2,0,0,2,0,2,0,2
1117,1118,1118,other,age.gp1,NoTr,NoTrade,NoGroup,3,1,0,2,0,0,3,0,1,2,0,3,1,2
1440,1441,1441,white,age.gp3,Tr,NoTrade,NoGroup,9,2,4,3,0,2,5,2,1,8,0,9,3,6
1636,1637,1637,black,age.gp1,Tr,NoTrade,NoGroup,15,6,5,1,3,4,7,4,5,10,2,13,9,6
2359,2360,2360,white,age.gp3,Tr,NoTrade,NoGroup,9,2,2,3,2,0,9,0,1,8,0,9,6,3
633,634,634,other,age.gp1,NoTr,Trade,Group,4,3,1,0,0,1,3,0,0,4,0,4,2,2
918,919,919,white,age.gp1,NoTr,Trade,NoGroup,13,5,2,6,0,1,11,1,2,11,3,10,9,4
1126,1127,1127,other,age.gp1,NoTr,NoTrade,NoGroup,3,2,1,0,0,0,3,0,1,2,0,3,2,1
1473,1474,1474,white,age.gp1,NoTr,NoTrade,NoGroup,12,6,4,1,1,2,6,4,3,9,1,11,5,7
2481,2482,2482,other,age.gp1,NoTr,NoTrade,NoGroup,4,2,1,1,0,1,3,0,1,3,0,4,2,2
1578,1579,1579,white,age.gp4,Tr,NoTrade,Group,13,0,1,3,9,2,11,0,8,5,1,12,10,3
1761,1762,1762,black,age.gp4,NoTr,NoTrade,NoGroup,6,1,2,1,2,6,0,0,1,5,2,4,2,4
1778,1779,1779,white,age.gp4,Tr,NoTrade,Group,9,1,2,1,5,1,6,2,6,3,1,8,7,2
739,740,740,black,age.gp4,NoTr,NoTrade,NoGroup,3,0,0,1,2,3,0,0,0,3,1,2,2,1
959,960,960,black,age.gp2,Tr,NoTrade,NoGroup,6,1,1,4,0,3,2,1,2,4,2,4,4,2
2150,2151,2151,other,age.gp2,NoTr,NoTrade,NoGroup,3,0,1,1,1,1,2,0,1,2,1,2,3,0
2909,2910,2910,other,age.gp1,NoTr,NoTrade,NoGroup,7,2,2,2,1,2,5,0,2,5,3,4,5,2
642,643,643,other,age.gp1,NoTr,Trade,Group,6,4,0,2,0,1,5,0,1,5,2,4,3,3
1369,1370,1370,black,age.gp4,NoTr,NoTrade,Group,6,0,1,2,3,2,4,0,1,5,1,5,4,2
718,719,719,black,age.gp4,NoTr,NoTrade,NoGroup,1,0,0,1,0,1,0,0,0,1,1,0,1,0
829,830,830,white,age.gp3,NoTr,NoTrade,NoGroup,4,0,1,1,2,1,2,1,2,2,1,3,3,1
908,909,909,other,age.gp1,Tr,NoTrade,NoGroup,5,3,0,2,0,2,3,0,0,5,1,4,2,3
1846,1847,1847,black,age.gp3,NoTr,NoTrade,NoGroup,9,1,2,4,2,6,3,0,3,6,1,8,5,4
1112,1113,1113,other,age.gp1,NoTr,NoTrade,NoGroup,4,2,0,1,1,3,1,0,1,3,1,3,1,3
1089,1090,1090,black,age.gp2,Tr,NoTrade,NoGroup,11,2,5,2,2,8,2,1,3,8,1,10,3,8
2168,2169,2169,black,age.gp2,NoTr,NoTrade,NoGroup,8,0,4,3,1,4,4,0,3,5,3,5,6,2
600,601,601,other,age.gp4,NoTr,NoTrade,NoGroup,6,1,2,3,0,2,4,0,2,4,2,4,4,2
2280,2281,2281,other,age.gp2,Tr,NoTrade,Group,10,1,4,5,0,1,9,0,2,8,1,9,8,2
2396,2397,2397,white,age.gp3,NoTr,NoTrade,NoGroup,8,0,1,5,2,3,5,0,2,6,2,6,7,1
2459,2460,2460,black,age.gp1,NoTr,NoTrade,NoGroup,10,3,3,2,2,4,4,2,1,9,3,7,4,6
1085,1086,1086,black,age.gp2,Tr,NoTrade,NoGroup,10,2,3,2,3,5,4,1,1,9,2,8,7,3
1557,1558,1558,white,age.gp3,NoTr,NoTrade,Group,21,1,5,6,9,4,16,1,6,15,1,20,13,8
2775,2776,2776,white,age.gp3,NoTr,NoTrade,Group,18,1,7,8,2,3,15,0,4,14,1,17,14,4
1122,1123,1123,other,age.gp1,NoTr,NoTrade,NoGroup,1,0,0,1,0,1,0,0,0,1,1,0,1,0
519,520,520,black,age.gp3,NoTr,NoTrade,NoGroup,5,1,2,2,0,3,2,0,1,4,1,4,3,2
2100,2101,2101,black,age.gp3,NoTr,NoTrade,NoGroup,3,1,1,1,0,3,0,0,0,3,1,2,2,1
476,477,477,black,age.gp3,NoTr,Trade,Group,12,1,4,4,3,6,4,2,2,10,0,12,5,7
513,514,514,black,age.gp3,NoTr,NoTrade,NoGroup,6,1,0,2,3,4,2,0,2,4,1,5,3,3
791,792,792,white,age.gp4,NoTr,NoTrade,NoGroup,5,0,1,3,1,1,4,0,3,2,1,4,3,2
1351,1352,1352,black,age.gp4,NoTr,NoTrade,Group,5,1,1,2,1,2,2,1,1,4,2,3,4,1
2736,2737,2737,black,age.gp3,NoTr,NoTrade,NoGroup,7,1,2,3,1,4,2,1,2,5,1,6,4,3
478,479,479,black,age.gp4,NoTr,NoTrade,NoGroup,4,1,0,1,2,3,0,1,0,4,0,4,2,2
1359,1360,1360,black,age.gp4,NoTr,NoTrade,Group,15,0,5,2,8,7,8,0,2,13,3,12,10,5
1829,1830,1830,black,age.gp4,NoTr,NoTrade,NoGroup,1,0,0,0,1,1,0,0,0,1,0,1,0,1
1890,1891,1891,other,age.gp1,NoTr,NoTrade,Group,8,4,0,1,3,2,6,0,3,5,0,8,2,6
2099,2100,2100,black,age.gp3,NoTr,NoTrade,NoGroup,5,0,1,2,2,2,3,0,2,3,1,4,3,2
1356,1357,1357,black,age.gp4,NoTr,NoTrade,Group,12,0,5,2,5,7,4,1,5,7,3,9,10,2
2220,2221,2221,black,age.gp4,NoTr,Trade,Group,7,0,2,0,5,3,3,1,2,5,0,7,3,4
481,482,482,black,age.gp4,NoTr,NoTrade,NoGroup,1,1,0,0,0,1,0,0,0,1,0,1,0,1
1901,1902,1902,black,age.gp1,NoTr,NoTrade,NoGroup,8,6,0,1,1,4,1,3,1,7,1,7,3,5
482,483,483,black,age.gp4,NoTr,NoTrade,NoGroup,1,0,0,0,1,0,1,0,1,0,0,1,1,0
1412,1413,1413,white,age.gp3,NoTr,NoTrade,Group,19,4,4,5,6,1,16,2,4,15,2,17,13,6
486,487,487,black,age.gp4,NoTr,NoTrade,NoGroup,2,1,0,1,0,1,1,0,1,1,0,2,1,1
1475,1476,1476,black,age.gp1,NoTr,NoTrade,NoGroup,8,3,2,0,3,4,2,2,2,6,2,6,3,5
487,488,488,black,age.gp4,NoTr,NoTrade,NoGroup,1,0,0,0,1,0,1,0,1,0,0,1,1,0
488,489,489,black,age.gp4,NoTr,NoTrade,NoGroup,1,0,1,0,0,1,0,0,0,1,0,1,0,1
489,490,490,black,age.gp4,NoTr,NoTrade,NoGroup,5,0,1,0,4,1,4,0,3,2,1,4,4,1
1835,1836,1836,black,age.gp4,NoTr,NoTrade,NoGroup,3,0,1,0,2,1,2,0,1,2,0,3,2,1
2048,2049,2049,white,age.gp4,Tr,NoTrade,Group,10,1,2,2,5,2,8,0,4,6,1,9,4,6
490,491,491,black,age.gp4,NoTr,NoTrade,NoGroup,1,0,0,1,0,1,0,0,0,1,0,1,0,1
1745,1746,1746,black,age.gp4,NoTr,NoTrade,NoGroup,1,0,0,0,1,1,0,0,0,1,0,1,0,1
492,493,493,black,age.gp4,NoTr,NoTrade,NoGroup,5,3,1,0,1,3,2,0,3,2,3,2,4,1
1666,1667,1667,black,age.gp1,Tr,Trade,Group,14,6,2,2,4,8,4,2,3,11,2,12,8,6
2587,2588,2588,white,age.gp4,NoTr,NoTrade,Group,7,1,0,2,4,2,4,1,2,5,0,7,4,3
494,495,495,black,age.gp4,NoTr,NoTrade,NoGroup,2,0,0,1,1,0,2,0,2,0,0,2,2,0
495,496,496,black,age.gp4,NoTr,NoTrade,NoGroup,1,1,0,0,0,1,0,0,0,1,0,1,0,1
496,497,497,black,age.gp4,NoTr,NoTrade,NoGroup,6,0,1,0,5,2,4,0,2,4,1,5,5,1
1838,1839,1839,black,age.gp4,NoTr,NoTrade,NoGroup,3,0,1,1,1,1,2,0,1,2,0,3,2,1
2222,2223,2223,black,age.gp4,NoTr,Trade,Group,5,0,0,1,4,2,3,0,0,5,1,4,1,4
497,498,498,black,age.gp4,NoTr,NoTrade,NoGroup,2,1,1,0,0,1,1,0,0,2,0,2,0,2
498,499,499,black,age.gp4,NoTr,NoTrade,NoGroup,5,2,2,0,1,1,2,2,0,5,0,5,1,4
614,615,615,other,age.gp4,NoTr,NoTrade,NoGroup,1,0,0,0,1,1,0,0,0,1,0,1,0,1
732,733,733,black,age.gp4,NoTr,NoTrade,NoGroup,1,0,0,0,1,1,0,0,0,1,0,1,0,1
500,501,501,black,age.gp4,NoTr,NoTrade,NoGroup,4,0,2,0,2,2,2,0,1,3,0,4,1,3
1750,1751,1751,black,age.gp4,NoTr,NoTrade,NoGroup,3,1,0,0,2,2,1,0,0,3,0,3,2,1
501,502,502,black,age.gp4,NoTr,NoTrade,NoGroup,1,0,0,1,0,1,0,0,0,1,0,1,0,1
2096,2097,2097,black,age.gp3,NoTr,NoTrade,NoGroup,8,1,2,2,3,5,2,1,1,7,1,7,3,5
502,503,503,black,age.gp4,NoTr,NoTrade,NoGroup,1,0,0,0,1,1,0,0,0,1,0,1,0,1
1999,2000,2000,black,age.gp4,NoTr,NoTrade,NoGroup,4,0,0,0,4,1,3,0,2,2,0,4,1,3
2234,2235,2235,black,age.gp4,NoTr,Trade,Group,9,1,3,1,4,6,3,0,5,4,0,9,4,5
738,739,739,black,age.gp4,NoTr,NoTrade,NoGroup,2,0,1,0,1,2,0,0,0,2,0,2,1,1
2726,2727,2727,black,age.gp3,NoTr,NoTrade,NoGroup,6,1,1,1,3,4,1,1,2,4,1,5,3,3
506,507,507,black,age.gp4,NoTr,NoTrade,NoGroup,1,0,0,0,1,0,1,0,0,1,0,1,0,1
2139,2140,2140,other,age.gp2,NoTr,NoTrade,NoGroup,6,0,2,2,2,0,6,0,4,2,0,6,4,2
508,509,509,white,age.gp2,Tr,NoTrade,NoGroup,12,3,4,3,2,0,11,1,2,10,0,12,6,6
973,974,974,white,age.gp4,NoTr,NoTrade,NoGroup,4,0,2,2,0,0,4,0,2,2,0,4,3,1
2323,2324,2324,white,age.gp1,NoTr,NoTrade,NoGroup,9,6,1,2,0,1,6,2,4,5,2,7,3,6
2332,2333,2333,white,age.gp3,Tr,NoTrade,Group,15,2,6,3,4,0,15,0,6,9,0,15,8,7
575,576,576,other,age.gp4,NoTr,NoTrade,NoGroup,3,0,2,1,0,0,3,0,2,1,0,3,2,1
1917,1918,1918,other,age.gp2,NoTr,NoTrade,NoGroup,4,0,3,1,0,0,4,0,2,2,0,4,2,2
2148,2149,2149,other,age.gp2,NoTr,NoTrade,NoGroup,6,0,3,3,0,0,6,0,2,4,1,5,3,3
2792,2793,2793,white,age.gp2,Tr,NoTrade,NoGroup,9,0,6,3,0,0,9,0,3,6,0,9,6,3
520,521,521,black,age.gp3,NoTr,NoTrade,NoGroup,5,0,2,1,2,3,2,0,1,4,0,5,0,5
1086,1087,1087,black,age.gp2,Tr,NoTrade,NoGroup,6,0,2,2,2,5,1,0,0,6,0,6,1,5
1030,1031,1031,black,age.gp4,NoTr,NoTrade,NoGroup,1,0,0,1,0,1,0,0,0,1,0,1,0,1
1118,1119,1119,other,age.gp1,NoTr,NoTrade,NoGroup,2,1,0,1,0,1,1,0,0,2,0,2,0,2
518,519,519,black,age.gp3,NoTr,NoTrade,NoGroup,6,1,2,1,2,4,2,0,1,5,3,3,3,3
2001,2002,2002,black,age.gp4,NoTr,NoTrade,NoGroup,5,0,1,2,2,4,1,0,2,3,1,4,2,3
2723,2724,2724,black,age.gp3,NoTr,NoTrade,NoGroup,9,0,5,2,2,6,3,0,1,8,3,6,6,3
813,814,814,white,age.gp4,NoTr,NoTrade,NoGroup,1,0,0,1,0,1,0,0,0,1,0,1,0,1
1149,1150,1150,white,age.gp4,NoTr,NoTrade,NoGroup,5,0,0,1,4,1,3,1,0,5,0,5,3,2
2167,2168,2168,black,age.gp2,NoTr,NoTrade,NoGroup,11,0,5,5,1,6,3,2,2,9,2,9,6,5
521,522,522,black,age.gp3,NoTr,NoTrade,NoGroup,3,1,1,1,0,2,0,1,0,3,1,2,1,2
624,625,625,other,age.gp1,NoTr,Trade,Group,12,5,1,4,2,3,9,0,3,9,0,12,5,7
522,523,523,black,age.gp3,NoTr,NoTrade,NoGroup,1,1,0,0,0,1,0,0,0,1,0,1,0,1
2785,2786,2786,white,age.gp3,NoTr,NoTrade,Group,14,1,7,4,2,1,13,0,7,7,1,13,10,4
2857,2858,2858,black,age.gp3,NoTr,NoTrade,Group,10,3,0,4,3,5,3,2,4,6,0,10,5,5
1115,1116,1116,other,age.gp1,NoTr,NoTrade,NoGroup,4,0,1,3,0,1,3,0,1,3,0,4,3,1
2558,2559,2559,white,age.gp4,NoTr,NoTrade,Group,12,1,1,6,4,3,9,0,4,8,2,10,9,3
525,526,526,black,age.gp3,NoTr,NoTrade,NoGroup,7,0,2,3,2,2,5,0,2,5,0,7,6,1
923,924,924,white,age.gp2,NoTr,NoTrade,NoGroup,13,0,4,6,3,3,10,0,6,7,0,13,8,5
583,584,584,other,age.gp4,NoTr,NoTrade,NoGroup,5,2,0,1,2,0,5,0,2,3,0,5,3,2
527,528,528,white,age.gp4,NoTr,NoTrade,NoGroup,1,0,0,0,1,0,1,0,0,1,0,1,1,0
1803,1804,1804,white,age.gp4,Tr,NoTrade,Group,9,0,0,3,6,0,9,0,1,8,1,8,7,2
530,531,531,white,age.gp4,NoTr,NoTrade,NoGroup,5,0,1,1,3,0,5,0,2,3,0,5,3,2
994,995,995,white,age.gp4,NoTr,NoTrade,NoGroup,1,0,0,0,1,0,1,0,0,1,0,1,0,1
533,534,534,white,age.gp4,NoTr,NoTrade,NoGroup,4,1,0,1,2,0,3,1,1,3,1,3,3,1
1700,1701,1701,white,age.gp4,NoTr,Trade,NoGroup,4,0,1,1,2,0,4,0,1,3,0,4,2,2
1779,1780,1780,white,age.gp4,Tr,NoTrade,Group,11,0,2,3,6,2,8,1,2,9,0,11,6,5
536,537,537,white,age.gp4,NoTr,NoTrade,NoGroup,4,0,1,3,0,0,4,0,3,1,1,3,3,1
537,538,538,white,age.gp4,NoTr,NoTrade,NoGroup,9,0,2,2,5,2,7,0,3,6,0,9,7,2
1843,1844,1844,black,age.gp3,NoTr,NoTrade,NoGroup,5,0,2,2,1,2,2,1,0,5,0,5,1,4
2035,2036,2036,white,age.gp4,Tr,NoTrade,Group,11,1,1,1,8,0,10,1,2,9,1,10,6,5
1184,1185,1185,white,age.gp4,Tr,NoTrade,NoGroup,11,0,2,3,6,1,10,0,6,5,0,11,8,3
1582,1583,1583,white,age.gp4,Tr,NoTrade,Group,12,0,2,2,8,0,12,0,3,9,0,12,8,4
539,540,540,white,age.gp4,NoTr,NoTrade,NoGroup,1,0,0,0,1,0,1,0,0,1,0,1,1,0
540,541,541,white,age.gp4,NoTr,NoTrade,NoGroup,1,0,0,0,1,0,1,0,1,0,0,1,1,0
541,542,542,white,age.gp4,NoTr,NoTrade,NoGroup,5,2,0,1,2,2,2,1,2,3,1,4,4,1
542,543,543,white,age.gp4,NoTr,NoTrade,NoGroup,7,1,2,0,4,1,6,0,3,4,1,6,4,3
2568,2569,2569,white,age.gp4,NoTr,NoTrade,Group,9,1,3,2,3,0,8,1,5,4,0,9,6,3
544,545,545,white,age.gp4,NoTr,NoTrade,NoGroup,1,0,0,0,1,0,1,0,1,0,0,1,0,1
1967,1968,1968,white,age.gp4,Tr,NoTrade,NoGroup,4,0,1,2,1,1,3,0,0,4,0,4,1,3
545,546,546,white,age.gp4,NoTr,NoTrade,NoGroup,1,0,1,0,0,0,1,0,1,0,0,1,1,0
547,548,548,white,age.gp4,NoTr,NoTrade,NoGroup,1,0,1,0,0,0,1,0,0,1,0,1,1,0
549,550,550,white,age.gp4,NoTr,NoTrade,NoGroup,2,0,0,1,1,0,2,0,1,1,0,2,2,0
550,551,551,white,age.gp4,NoTr,NoTrade,NoGroup,1,0,0,0,1,0,1,0,1,0,0,1,0,1
1188,1189,1189,white,age.gp4,Tr,NoTrade,NoGroup,9,1,0,3,5,2,7,0,1,8,3,6,5,4
551,552,552,white,age.gp4,NoTr,NoTrade,NoGroup,1,0,0,0,1,1,0,0,0,1,0,1,0,1
920,921,921,white,age.gp1,NoTr,Trade,NoGroup,11,6,1,2,2,0,8,3,1,10,2,9,7,4
1674,1675,1675,white,age.gp2,Tr,NoTrade,NoGroup,7,1,3,0,3,1,6,0,2,5,0,7,5,2
1795,1796,1796,white,age.gp4,Tr,NoTrade,Group,23,0,3,5,15,2,19,2,3,20,1,22,13,10
555,556,556,white,age.gp4,NoTr,NoTrade,NoGroup,3,0,0,1,2,0,3,0,0,3,0,3,3,0
1962,1963,1963,white,age.gp4,NoTr,NoTrade,Group,9,0,2,1,6,1,8,0,4,5,0,9,5,4
559,560,560,other,age.gp4,NoTr,NoTrade,NoGroup,4,0,1,0,3,1,3,0,1,3,1,3,3,1
2251,2252,2252,white,age.gp4,Tr,NoTrade,Group,15,2,3,0,10,1,13,1,6,9,1,14,9,6
560,561,561,other,age.gp4,NoTr,NoTrade,NoGroup,2,0,0,1,1,0,2,0,0,2,0,2,2,0
561,562,562,other,age.gp4,NoTr,NoTrade,NoGroup,1,0,0,0,1,0,1,0,1,0,0,1,1,0
562,563,563,other,age.gp4,NoTr,NoTrade,NoGroup,5,0,1,1,3,1,4,0,2,3,0,5,3,2
740,741,741,black,age.gp4,NoTr,NoTrade,NoGroup,6,0,1,1,4,2,3,1,1,5,0,6,4,2
2045,2046,2046,white,age.gp4,Tr,NoTrade,Group,9,0,1,1,7,0,8,1,2,7,0,9,5,4
563,564,564,other,age.gp4,NoTr,NoTrade,NoGroup,3,0,1,1,1,0,3,0,2,1,1,2,3,0
564,565,565,other,age.gp4,NoTr,NoTrade,NoGroup,2,0,0,0,2,0,2,0,1,1,0,2,2,0
1786,1787,1787,white,age.gp4,Tr,NoTrade,Group,15,1,3,5,6,2,11,2,3,12,3,12,9,6
2244,2245,2245,white,age.gp4,Tr,NoTrade,Group,11,0,1,0,10,3,7,1,0,11,0,11,7,4
568,569,569,other,age.gp4,NoTr,NoTrade,NoGroup,1,0,0,0,1,0,1,0,1,0,0,1,1,0
569,570,570,other,age.gp4,NoTr,NoTrade,NoGroup,2,1,0,0,1,1,1,0,0,2,0,2,1,1
570,571,571,other,age.gp4,NoTr,NoTrade,NoGroup,1,0,1,0,0,0,1,0,0,1,0,1,1,0
573,574,574,other,age.gp4,NoTr,NoTrade,NoGroup,2,0,1,1,0,0,2,0,1,1,0,2,2,0
669,670,670,white,age.gp2,Tr,NoTrade,NoGroup,4,0,3,0,1,0,1,3,2,2,0,4,3,1
576,577,577,other,age.gp4,NoTr,NoTrade,NoGroup,1,0,0,0,1,0,1,0,0,1,0,1,0,1
577,578,578,other,age.gp4,NoTr,NoTrade,NoGroup,1,0,0,0,1,0,1,0,0,1,0,1,1,0
1289,1290,1290,white,age.gp4,NoTr,NoTrade,Group,12,2,3,2,5,0,10,2,3,9,2,10,7,5
580,581,581,other,age.gp4,NoTr,NoTrade,NoGroup,2,1,0,0,1,0,2,0,0,2,0,2,2,0
1083,1084,1084,white,age.gp4,NoTr,NoTrade,Group,10,1,2,0,7,1,7,2,3,7,1,9,6,4
582,583,583,other,age.gp4,NoTr,NoTrade,NoGroup,1,0,1,0,0,0,1,0,1,0,0,1,1,0
1975,1976,1976,white,age.gp4,Tr,NoTrade,NoGroup,7,0,0,1,6,2,4,1,0,7,1,6,5,2
586,587,587,other,age.gp4,NoTr,NoTrade,NoGroup,1,1,0,0,0,0,1,0,0,1,0,1,1,0
588,589,589,other,age.gp4,NoTr,NoTrade,NoGroup,3,0,1,0,2,1,2,0,1,2,0,3,2,1
2374,2375,2375,black,age.gp2,NoTr,NoTrade,NoGroup,6,0,1,1,4,4,1,1,1,5,1,5,1,5
590,591,591,other,age.gp4,NoTr,NoTrade,NoGroup,2,0,0,1,1,0,2,0,2,0,0,2,2,0
591,592,592,other,age.gp4,NoTr,NoTrade,NoGroup,3,0,0,1,2,1,2,0,1,2,1,2,2,1
2708,2709,2709,white,age.gp4,NoTr,NoTrade,Group,16,2,1,3,10,1,13,2,8,8,0,16,9,7
592,593,593,other,age.gp4,NoTr,NoTrade,NoGroup,6,0,1,2,3,0,6,0,3,3,0,6,3,3
2719,2720,2720,white,age.gp4,NoTr,NoTrade,Group,10,0,3,2,5,3,6,1,3,7,0,10,4,6
594,595,595,other,age.gp4,NoTr,NoTrade,NoGroup,3,0,1,0,2,0,3,0,2,1,0,3,3,0
2699,2700,2700,white,age.gp4,NoTr,NoTrade,Group,9,1,2,2,4,0,7,2,2,7,2,7,7,2
1194,1195,1195,white,age.gp4,Tr,NoTrade,NoGroup,5,1,1,0,3,1,3,1,1,4,0,5,1,4
596,597,597,other,age.gp4,NoTr,NoTrade,NoGroup,1,0,0,0,1,0,1,0,1,0,0,1,1,0
599,600,600,other,age.gp4,NoTr,NoTrade,NoGroup,1,0,1,0,0,0,1,0,0,1,0,1,0,1
602,603,603,other,age.gp4,NoTr,NoTrade,NoGroup,1,0,0,0,1,1,0,0,0,1,0,1,1,0
603,604,604,other,age.gp4,NoTr,NoTrade,NoGroup,1,0,0,1,0,1,0,0,0,1,0,1,0,1
604,605,605,other,age.gp4,NoTr,NoTrade,NoGroup,4,2,0,0,2,2,2,0,0,4,1,3,0,4
605,606,606,other,age.gp4,NoTr,NoTrade,NoGroup,2,0,0,0,2,0,2,0,1,1,0,2,2,0
606,607,607,other,age.gp4,NoTr,NoTrade,NoGroup,3,0,0,2,1,0,3,0,2,1,0,3,2,1
771,772,772,white,age.gp4,NoTr,NoTrade,NoGroup,7,0,0,1,6,0,6,1,2,5,0,7,5,2
1208,1209,1209,white,age.gp4,NoTr,NoTrade,NoGroup,4,0,2,1,1,1,2,1,0,4,0,4,2,2
2634,2635,2635,white,age.gp4,NoTr,NoTrade,NoGroup,4,0,0,1,3,0,3,1,1,3,0,4,3,1
608,609,609,other,age.gp4,NoTr,NoTrade,NoGroup,2,0,1,0,1,0,2,0,1,1,0,2,2,0
2578,2579,2579,white,age.gp4,NoTr,NoTrade,Group,6,0,1,3,2,0,5,1,0,6,1,5,5,1
609,610,610,other,age.gp4,NoTr,NoTrade,NoGroup,1,0,1,0,0,0,1,0,0,1,0,1,0,1
613,614,614,other,age.gp4,NoTr,NoTrade,NoGroup,2,0,0,0,2,0,2,0,1,1,1,1,0,2
1687,1688,1688,white,age.gp4,NoTr,Trade,NoGroup,5,0,1,1,3,0,4,1,0,5,1,4,2,3
618,619,619,other,age.gp4,NoTr,NoTrade,NoGroup,4,2,0,0,2,0,4,0,1,3,0,4,2,2
1297,1298,1298,white,age.gp4,NoTr,NoTrade,Group,11,2,1,2,6,1,9,1,3,8,1,10,6,5
619,620,620,other,age.gp4,NoTr,NoTrade,NoGroup,2,0,1,0,1,0,2,0,0,2,1,1,1,1
991,992,992,white,age.gp4,NoTr,NoTrade,NoGroup,1,0,0,0,1,0,0,1,0,1,0,1,0,1
620,621,621,other,age.gp4,NoTr,NoTrade,NoGroup,3,0,0,2,1,0,3,0,1,2,1,2,2,1
1990,1991,1991,white,age.gp4,Tr,NoTrade,NoGroup,6,0,2,1,3,1,3,2,2,4,0,6,2,4
621,622,622,other,age.gp4,NoTr,NoTrade,NoGroup,1,0,1,0,0,0,1,0,1,0,0,1,1,0
697,698,698,white,age.gp4,Tr,NoTrade,Group,8,1,0,3,4,0,7,1,1,7,2,6,3,5
1010,1011,1011,white,age.gp1,Tr,NoTrade,NoGroup,12,7,1,1,3,1,9,2,3,9,2,10,7,5
1454,1455,1455,white,age.gp1,NoTr,NoTrade,NoGroup,10,4,0,4,2,2,6,2,3,7,3,7,8,2
623,624,624,other,age.gp1,NoTr,Trade,Group,10,3,1,3,3,1,9,0,2,8,0,10,5,5
1472,1473,1473,white,age.gp1,NoTr,NoTrade,NoGroup,6,4,2,0,0,1,3,2,1,5,1,5,3,3
1854,1855,1855,white,age.gp3,NoTr,NoTrade,Group,21,6,5,5,5,2,16,3,6,15,4,17,13,8
2727,2728,2728,black,age.gp3,NoTr,NoTrade,NoGroup,9,1,3,2,3,4,4,1,2,7,2,7,3,6
1009,1010,1010,white,age.gp1,Tr,NoTrade,NoGroup,16,11,1,3,1,0,11,5,5,11,3,13,9,7
2076,2077,2077,black,age.gp3,NoTr,NoTrade,NoGroup,8,4,3,0,1,4,2,2,2,6,3,5,5,3
626,627,627,other,age.gp1,NoTr,Trade,Group,8,3,2,2,1,0,7,1,5,3,0,8,3,5
1899,1900,1900,white,age.gp1,Tr,NoTrade,NoGroup,9,2,2,1,4,0,7,2,2,7,1,8,8,1
2000,2001,2001,black,age.gp4,NoTr,NoTrade,NoGroup,1,1,0,0,0,0,0,1,0,1,1,0,1,0
2874,2875,2875,white,age.gp1,NoTr,NoTrade,NoGroup,14,8,2,3,1,2,10,2,4,10,4,10,9,5
629,630,630,other,age.gp1,NoTr,Trade,Group,6,3,0,1,2,1,5,0,3,3,0,6,1,5
1008,1009,1009,white,age.gp1,Tr,NoTrade,NoGroup,10,6,2,1,1,0,6,4,3,7,1,9,4,6
1158,1159,1159,white,age.gp4,NoTr,NoTrade,NoGroup,5,3,1,0,1,0,4,1,3,2,1,4,3,2
1067,1068,1068,white,age.gp4,NoTr,NoTrade,Group,7,2,1,2,2,0,5,2,3,4,1,6,4,3
1381,1382,1382,white,age.gp1,NoTr,NoTrade,NoGroup,8,2,2,0,4,0,5,3,3,5,2,6,5,3
1508,1509,1509,white,age.gp4,NoTr,NoTrade,NoGroup,7,1,0,2,4,0,6,1,1,6,1,6,6,1
2086,2087,2087,black,age.gp3,NoTr,NoTrade,NoGroup,5,1,1,0,3,1,3,1,1,4,1,4,5,0
916,917,917,white,age.gp1,NoTr,Trade,NoGroup,7,7,0,0,0,1,3,3,0,7,1,6,2,5
2610,2611,2611,white,age.gp4,NoTr,NoTrade,NoGroup,4,2,0,1,1,0,3,1,1,3,1,3,3,1
1610,1611,1611,white,age.gp3,Tr,NoTrade,NoGroup,8,1,3,2,2,2,5,1,1,7,2,6,6,2
2522,2523,2523,white,age.gp2,Tr,NoTrade,Group,22,2,11,2,7,6,13,3,6,16,3,19,17,5
2420,2421,2421,white,age.gp3,NoTr,Trade,Group,13,2,2,6,3,0,11,2,6,7,1,12,9,4
647,648,648,other,age.gp1,NoTr,Trade,Group,11,4,3,1,3,1,9,1,6,5,0,11,7,4
1341,1342,1342,white,age.gp1,Tr,NoTrade,NoGroup,11,7,1,1,2,1,9,1,3,8,1,10,4,7
1037,1038,1038,black,age.gp4,NoTr,NoTrade,NoGroup,10,1,2,4,3,6,4,0,2,8,0,10,6,4
2617,2618,2618,white,age.gp4,NoTr,NoTrade,NoGroup,1,0,1,0,0,1,0,0,0,1,0,1,0,1
651,652,652,black,age.gp2,NoTr,NoTrade,NoGroup,7,0,5,0,2,3,4,0,3,4,2,5,7,0
1080,1081,1081,white,age.gp4,NoTr,NoTrade,Group,12,1,3,2,6,2,9,1,4,8,0,12,8,4
653,654,654,black,age.gp2,NoTr,NoTrade,NoGroup,4,1,1,1,1,2,2,0,1,3,0,4,2,2
1634,1635,1635,black,age.gp1,Tr,NoTrade,NoGroup,14,6,5,2,1,7,5,2,6,8,3,11,9,5
2006,2007,2007,black,age.gp4,NoTr,NoTrade,NoGroup,3,0,1,1,1,1,2,0,0,3,1,2,2,1
654,655,655,black,age.gp2,NoTr,NoTrade,NoGroup,2,0,0,2,0,1,1,0,1,1,0,2,1,1
970,971,971,white,age.gp2,Tr,NoTrade,Group,22,1,13,5,3,2,20,0,7,15,0,22,16,6
1032,1033,1033,black,age.gp4,NoTr,NoTrade,NoGroup,1,0,1,0,0,0,1,0,1,0,0,1,0,1
2266,2267,2267,white,age.gp4,Tr,NoTrade,Group,9,1,2,2,4,1,8,0,2,7,0,9,5,4
2831,2832,2832,white,age.gp2,Tr,NoTrade,NoGroup,8,1,6,0,1,0,7,1,4,4,0,8,6,2
783,784,784,white,age.gp2,NoTr,NoTrade,NoGroup,7,1,3,1,2,1,6,0,2,5,0,7,3,4
2538,2539,2539,other,age.gp1,NoTr,NoTrade,NoGroup,2,0,1,0,1,0,2,0,1,1,0,2,2,0
1450,1451,1451,black,age.gp1,NoTr,NoTrade,NoGroup,8,4,2,2,0,5,2,1,0,8,0,8,2,6
1492,1493,1493,white,age.gp4,NoTr,NoTrade,NoGroup,3,0,1,0,2,0,3,0,1,2,0,3,3,0
2695,2696,2696,white,age.gp4,NoTr,NoTrade,Group,14,2,4,0,8,3,10,1,1,13,0,14,10,4
910,911,911,other,age.gp1,Tr,NoTrade,NoGroup,5,2,3,0,0,1,4,0,3,2,1,4,3,2
1082,1083,1083,white,age.gp4,NoTr,NoTrade,Group,11,1,3,1,6,1,9,1,3,8,1,10,8,3
1973,1974,1974,white,age.gp4,Tr,NoTrade,NoGroup,5,1,1,1,2,0,5,0,3,2,0,5,3,2
806,807,807,white,age.gp4,NoTr,NoTrade,NoGroup,6,0,2,0,4,0,6,0,1,5,0,6,6,0
2081,2082,2082,black,age.gp3,NoTr,NoTrade,NoGroup,14,2,7,2,3,8,4,2,4,10,1,13,7,7
2157,2158,2158,other,age.gp2,NoTr,NoTrade,NoGroup,4,0,4,0,0,1,3,0,2,2,0,4,3,1
665,666,666,white,age.gp2,Tr,NoTrade,NoGroup,5,1,1,1,2,0,4,1,1,4,0,5,4,1
748,749,749,white,age.gp4,NoTr,NoTrade,NoGroup,6,1,0,2,3,0,6,0,1,5,0,6,3,3
1233,1234,1234,white,age.gp4,NoTr,NoTrade,NoGroup,5,0,1,1,3,1,4,0,3,2,0,5,4,1
1980,1981,1981,white,age.gp4,Tr,NoTrade,NoGroup,1,0,0,0,1,0,1,0,1,0,0,1,1,0
671,672,672,white,age.gp4,Tr,NoTrade,Group,11,0,4,4,3,1,9,1,4,7,3,8,8,3
1218,1219,1219,white,age.gp4,NoTr,NoTrade,NoGroup,4,0,0,0,4,1,3,0,2,2,0,4,3,1
1285,1286,1286,white,age.gp4,NoTr,NoTrade,Group,12,2,3,3,4,2,9,1,5,7,0,12,9,3
2361,2362,2362,white,age.gp3,Tr,NoTrade,NoGroup,5,2,0,2,1,0,4,1,2,3,0,5,3,2
1378,1379,1379,black,age.gp2,NoTr,NoTrade,NoGroup,2,0,1,0,1,1,1,0,1,1,1,1,2,0
674,675,675,white,age.gp4,Tr,NoTrade,Group,14,1,3,3,7,1,12,1,5,9,1,13,8,6
761,762,762,white,age.gp4,NoTr,NoTrade,NoGroup,6,0,1,1,4,0,6,0,3,3,1,5,5,1
889,890,890,other,age.gp1,Tr,NoTrade,NoGroup,3,1,0,0,2,0,3,0,1,2,0,3,1,2
2641,2642,2642,white,age.gp4,NoTr,NoTrade,NoGroup,7,2,0,0,5,1,6,0,5,2,1,6,4,3
1507,1508,1508,white,age.gp4,NoTr,NoTrade,NoGroup,2,0,0,0,2,0,2,0,1,1,0,2,2,0
1824,1825,1825,black,age.gp4,NoTr,NoTrade,NoGroup,4,0,0,0,4,1,3,0,2,2,0,4,3,1
2515,2516,2516,black,age.gp2,NoTr,NoTrade,Group,16,2,8,3,3,7,8,1,6,10,2,14,10,6
2523,2524,2524,white,age.gp2,Tr,NoTrade,Group,24,3,13,6,2,1,21,2,10,14,1,23,14,10
2180,2181,2181,white,age.gp4,NoTr,NoTrade,NoGroup,4,0,1,0,3,0,4,0,3,1,0,4,3,1
1459,1460,1460,white,age.gp1,NoTr,NoTrade,NoGroup,7,3,0,1,3,0,6,1,1,6,0,7,4,3
753,754,754,white,age.gp4,NoTr,NoTrade,NoGroup,1,0,0,0,1,0,1,0,1,0,0,1,1,0
919,920,920,white,age.gp1,NoTr,Trade,NoGroup,5,2,0,1,2,0,5,0,2,3,0,5,3,2
1234,1235,1235,white,age.gp4,NoTr,NoTrade,NoGroup,2,0,1,0,1,0,2,0,2,0,0,2,2,0
1183,1184,1184,white,age.gp4,Tr,NoTrade,NoGroup,5,0,1,1,3,1,4,0,2,3,0,5,3,2
1222,1223,1223,white,age.gp4,NoTr,NoTrade,NoGroup,3,1,0,0,2,0,2,1,2,1,0,3,2,1
830,831,831,white,age.gp3,NoTr,NoTrade,NoGroup,4,0,2,0,2,1,3,0,3,1,0,4,3,1
1800,1801,1801,white,age.gp4,Tr,NoTrade,Group,8,0,4,2,2,1,6,1,3,5,1,7,5,3
2463,2464,2464,white,age.gp1,Tr,NoTrade,NoGroup,12,5,0,4,3,1,10,1,3,9,1,11,6,6
1603,1604,1604,white,age.gp3,Tr,NoTrade,NoGroup,8,2,1,3,2,0,7,1,2,6,0,8,6,2
1981,1982,1982,white,age.gp4,Tr,NoTrade,NoGroup,6,0,2,2,2,0,6,0,3,3,1,5,6,0
1830,1831,1831,black,age.gp4,NoTr,NoTrade,NoGroup,3,0,1,0,2,1,2,0,3,0,0,3,2,1
2565,2566,2566,white,age.gp4,NoTr,NoTrade,Group,7,1,1,0,5,1,6,0,3,4,0,7,6,1
2640,2641,2641,white,age.gp4,NoTr,NoTrade,NoGroup,5,0,0,0,5,0,5,0,2,3,0,5,4,1
825,826,826,white,age.gp3,NoTr,NoTrade,NoGroup,7,1,1,2,3,1,6,0,2,5,2,5,7,0
1110,1111,1111,other,age.gp1,NoTr,NoTrade,NoGroup,3,1,0,1,1,1,2,0,1,2,0,3,2,1
793,794,794,white,age.gp4,NoTr,NoTrade,NoGroup,7,1,0,0,6,0,6,1,2,5,0,7,2,5
1316,1317,1317,white,age.gp2,NoTr,NoTrade,NoGroup,11,1,4,2,4,0,11,0,3,8,0,11,8,3
2452,2453,2453,white,age.gp4,NoTr,NoTrade,NoGroup,6,2,1,1,2,0,5,1,2,4,0,6,4,2
2693,2694,2694,white,age.gp4,NoTr,NoTrade,Group,10,1,2,1,6,1,7,2,5,5,0,10,7,3
1065,1066,1066,white,age.gp4,NoTr,NoTrade,Group,12,1,1,4,6,2,10,0,5,7,0,12,7,5
1189,1190,1190,white,age.gp4,Tr,NoTrade,NoGroup,3,0,0,0,3,0,3,0,2,1,0,3,3,0
2093,2094,2094,black,age.gp3,NoTr,NoTrade,NoGroup,5,0,0,1,4,1,4,0,1,4,0,5,3,2
694,695,695,white,age.gp4,Tr,NoTrade,Group,8,0,2,1,5,0,8,0,3,5,0,8,6,2
755,756,756,white,age.gp4,NoTr,NoTrade,NoGroup,1,0,0,0,1,0,1,0,1,0,0,1,1,0
2823,2824,2824,other,age.gp2,NoTr,NoTrade,NoGroup,4,0,1,1,2,0,4,0,2,2,0,4,4,0
1230,1231,1231,white,age.gp4,NoTr,NoTrade,NoGroup,4,0,0,0,4,0,4,0,2,2,0,4,3,1
1956,1957,1957,white,age.gp4,NoTr,NoTrade,Group,8,0,3,1,4,1,7,0,3,5,0,8,4,4
2376,2377,2377,white,age.gp2,NoTr,NoTrade,NoGroup,7,1,2,1,3,0,7,0,3,4,0,7,5,2
1501,1502,1502,white,age.gp4,NoTr,NoTrade,NoGroup,6,1,2,0,3,0,6,0,3,3,1,5,4,2
2431,2432,2432,white,age.gp4,NoTr,NoTrade,NoGroup,4,0,1,1,2,1,3,0,3,1,0,4,3,1
1728,1729,1729,white,age.gp3,Tr,NoTrade,Group,16,0,6,6,4,3,12,1,5,11,2,14,12,4
700,701,701,white,age.gp4,Tr,NoTrade,Group,7,2,1,0,4,1,5,1,3,4,0,7,4,3
2905,2906,2906,other,age.gp1,NoTr,NoTrade,NoGroup,5,0,3,0,2,0,5,0,2,3,0,5,4,1
1503,1504,1504,white,age.gp4,NoTr,NoTrade,NoGroup,1,0,0,0,1,0,1,0,1,0,0,1,1,0
2490,2491,2491,other,age.gp1,NoTr,NoTrade,NoGroup,6,2,1,1,2,0,6,0,1,5,1,5,4,2
2906,2907,2907,other,age.gp1,NoTr,NoTrade,NoGroup,2,0,0,0,2,0,2,0,2,0,0,2,1,1
1494,1495,1495,white,age.gp4,NoTr,NoTrade,NoGroup,3,0,1,0,2,0,3,0,0,3,0,3,3,0
2437,2438,2438,white,age.gp4,NoTr,NoTrade,NoGroup,1,0,1,0,0,0,1,0,0,1,0,1,1,0
861,862,862,other,age.gp2,Tr,NoTrade,Group,7,1,4,1,1,0,6,1,2,5,0,7,6,1
2899,2900,2900,other,age.gp1,NoTr,NoTrade,NoGroup,2,1,1,0,0,0,2,0,1,1,1,1,2,0
2292,2293,2293,other,age.gp2,Tr,NoTrade,Group,11,1,6,2,2,1,10,0,4,7,0,11,7,4
1377,1378,1378,black,age.gp2,NoTr,NoTrade,NoGroup,6,2,2,0,2,3,3,0,0,6,1,5,5,1
1197,1198,1198,white,age.gp4,Tr,NoTrade,NoGroup,11,0,3,3,5,1,10,0,6,5,0,11,9,2
1269,1270,1270,black,age.gp3,NoTr,NoTrade,NoGroup,4,0,1,3,0,0,4,0,2,2,1,3,3,1
1932,1933,1933,other,age.gp2,NoTr,NoTrade,NoGroup,6,0,5,0,1,0,6,0,5,1,0,6,4,2
2152,2153,2153,other,age.gp2,NoTr,NoTrade,NoGroup,3,2,1,0,0,0,2,1,2,1,0,3,1,2
1114,1115,1115,other,age.gp1,NoTr,NoTrade,NoGroup,5,3,1,1,0,0,4,1,2,3,1,4,3,2
1512,1513,1513,black,age.gp4,NoTr,NoTrade,NoGroup,6,0,2,2,2,3,3,0,1,5,1,5,4,2
2194,2195,2195,white,age.gp4,NoTr,NoTrade,NoGroup,2,0,1,0,1,1,1,0,1,1,0,2,1,1
2926,2927,2927,white,age.gp4,NoTr,NoTrade,Group,12,1,3,4,4,1,10,1,6,6,0,12,7,5
1107,1108,1108,other,age.gp1,NoTr,NoTrade,NoGroup,6,2,2,1,1,0,6,0,3,3,1,5,4,2
2004,2005,2005,black,age.gp4,NoTr,NoTrade,NoGroup,2,0,2,0,0,0,2,0,2,0,0,2,2,0
769,770,770,white,age.gp4,NoTr,NoTrade,NoGroup,1,0,1,0,0,0,1,0,1,0,0,1,1,0
1220,1221,1221,white,age.gp4,NoTr,NoTrade,NoGroup,7,1,3,0,3,1,5,1,5,2,0,7,5,2
1264,1265,1265,black,age.gp3,NoTr,NoTrade,NoGroup,4,0,3,1,0,2,2,0,2,2,0,4,2,2
1928,1929,1929,other,age.gp2,NoTr,NoTrade,NoGroup,8,1,4,2,1,0,8,0,4,4,1,7,7,1
2812,2813,2813,other,age.gp2,NoTr,NoTrade,NoGroup,2,0,2,0,0,0,2,0,1,1,0,2,1,1
2760,2761,2761,white,age.gp3,NoTr,NoTrade,NoGroup,5,0,4,0,1,0,4,1,3,2,0,5,4,1
2801,2802,2802,white,age.gp2,NoTr,NoTrade,NoGroup,6,0,5,1,0,0,6,0,3,3,1,5,4,2
712,713,713,black,age.gp4,NoTr,NoTrade,NoGroup,1,0,0,0,1,1,0,0,0,1,1,0,1,0
1298,1299,1299,white,age.gp4,NoTr,NoTrade,Group,13,0,1,5,7,1,11,1,6,7,0,13,10,3
1566,1567,1567,white,age.gp4,Tr,NoTrade,Group,6,0,1,1,4,1,5,0,2,4,0,6,3,3
1653,1654,1654,other,age.gp2,NoTr,NoTrade,NoGroup,3,0,1,0,2,1,2,0,1,2,0,3,2,1
2147,2148,2148,other,age.gp2,NoTr,NoTrade,NoGroup,3,0,1,0,2,1,2,0,1,2,0,3,2,1
2678,2679,2679,black,age.gp3,NoTr,NoTrade,NoGroup,8,0,1,1,6,5,3,0,1,7,0,8,3,5
1511,1512,1512,black,age.gp4,NoTr,NoTrade,NoGroup,2,0,0,0,2,1,1,0,1,1,0,2,1,1
719,720,720,black,age.gp4,NoTr,NoTrade,NoGroup,1,0,1,0,0,1,0,0,0,1,0,1,1,0
723,724,724,black,age.gp4,NoTr,NoTrade,NoGroup,5,0,2,1,2,1,3,1,2,3,1,4,4,1
1171,1172,1172,white,age.gp4,NoTr,NoTrade,NoGroup,6,0,1,1,4,1,5,0,1,5,0,6,5,1
2089,2090,2090,black,age.gp3,NoTr,NoTrade,NoGroup,12,1,2,4,5,7,5,0,2,10,0,12,4,8
726,727,727,black,age.gp4,NoTr,NoTrade,NoGroup,1,0,0,0,1,0,1,0,0,1,0,1,0,1
729,730,730,black,age.gp4,NoTr,NoTrade,NoGroup,1,0,0,0,1,1,0,0,0,1,0,1,1,0
1350,1351,1351,black,age.gp4,NoTr,NoTrade,Group,9,0,2,0,7,5,3,1,0,9,0,9,3,6
731,732,732,black,age.gp4,NoTr,NoTrade,NoGroup,1,0,0,1,0,1,0,0,0,1,0,1,0,1
733,734,734,black,age.gp4,NoTr,NoTrade,NoGroup,1,0,0,0,1,0,1,0,0,1,0,1,1,0
1947,1948,1948,white,age.gp4,NoTr,NoTrade,Group,16,1,5,2,8,2,14,0,7,9,0,16,10,6
1374,1375,1375,black,age.gp4,NoTr,NoTrade,Group,3,1,0,0,2,1,2,0,1,2,1,2,2,1
736,737,737,black,age.gp4,NoTr,NoTrade,NoGroup,1,1,0,0,0,0,1,0,1,0,1,0,1,0
737,738,738,black,age.gp4,NoTr,NoTrade,NoGroup,1,0,1,0,0,1,0,0,0,1,0,1,0,1
1355,1356,1356,black,age.gp4,NoTr,NoTrade,Group,8,0,1,1,6,6,2,0,1,7,0,8,3,5
1836,1837,1837,black,age.gp4,NoTr,NoTrade,NoGroup,1,0,0,0,1,1,0,0,0,1,0,1,0,1
741,742,742,black,age.gp4,NoTr,NoTrade,NoGroup,1,0,0,0,1,1,0,0,0,1,0,1,0,1
2020,2021,2021,black,age.gp4,NoTr,NoTrade,NoGroup,3,2,0,0,1,2,1,0,2,1,0,3,0,3
1693,1694,1694,white,age.gp4,NoTr,Trade,NoGroup,6,0,4,1,1,0,6,0,5,1,0,6,4,2
2261,2262,2262,white,age.gp4,Tr,NoTrade,Group,10,0,1,2,7,2,8,0,2,8,0,10,9,1
2317,2318,2318,white,age.gp2,NoTr,NoTrade,NoGroup,14,1,6,6,1,1,11,2,6,8,0,14,11,3
2241,2242,2242,white,age.gp4,Tr,NoTrade,Group,12,0,4,4,4,1,11,0,6,6,0,12,10,2
2286,2287,2287,other,age.gp2,Tr,NoTrade,Group,10,1,6,0,3,1,9,0,5,5,0,10,7,3
1756,1757,1757,black,age.gp4,NoTr,NoTrade,NoGroup,1,0,1,0,0,0,1,0,1,0,0,1,1,0
2149,2150,2150,other,age.gp2,NoTr,NoTrade,NoGroup,7,1,1,4,1,1,6,0,2,5,1,6,6,1
2537,2538,2538,other,age.gp1,NoTr,NoTrade,NoGroup,8,3,2,2,1,0,7,1,4,4,1,7,4,4
2836,2837,2837,black,age.gp2,NoTr,NoTrade,NoGroup,9,0,3,3,3,2,6,1,5,4,0,9,7,2
747,748,748,white,age.gp4,NoTr,NoTrade,NoGroup,1,0,0,0,1,1,0,0,0,1,1,0,1,0
1211,1212,1212,white,age.gp4,NoTr,NoTrade,NoGroup,6,0,1,1,4,0,5,1,3,3,0,6,4,2
1245,1246,1246,white,age.gp1,NoTr,NoTrade,NoGroup,7,3,1,0,3,1,5,1,2,5,2,5,4,3
749,750,750,white,age.gp4,NoTr,NoTrade,NoGroup,1,0,0,0,1,0,1,0,1,0,0,1,1,0
1462,1463,1463,white,age.gp1,NoTr,NoTrade,NoGroup,8,3,2,2,1,0,7,1,2,6,0,8,4,4
751,752,752,white,age.gp4,NoTr,NoTrade,NoGroup,6,1,1,1,3,2,4,0,0,6,0,6,3,3
992,993,993,white,age.gp4,NoTr,NoTrade,NoGroup,1,0,0,0,1,0,1,0,0,1,0,1,0,1
1476,1477,1477,black,age.gp1,NoTr,NoTrade,NoGroup,5,2,1,1,1,1,4,0,1,4,0,5,1,4
752,753,753,white,age.gp4,NoTr,NoTrade,NoGroup,4,0,1,1,2,0,4,0,1,3,0,4,2,2
1995,1996,1996,white,age.gp4,Tr,NoTrade,NoGroup,7,0,1,3,3,0,6,1,2,5,0,7,2,5
2091,2092,2092,black,age.gp3,NoTr,NoTrade,NoGroup,9,0,2,4,3,3,6,0,3,6,0,9,3,6
756,757,757,white,age.gp4,NoTr,NoTrade,NoGroup,9,1,5,1,2,0,7,2,4,5,0,9,6,3
757,758,758,white,age.gp4,NoTr,NoTrade,NoGroup,1,0,0,0,1,1,0,0,0,1,1,0,1,0
2059,2060,2060,white,age.gp3,Tr,NoTrade,Group,22,1,9,7,5,2,18,2,4,18,1,21,17,5
2451,2452,2452,white,age.gp4,NoTr,NoTrade,NoGroup,5,0,0,3,2,1,4,0,0,5,0,5,1,4
2721,2722,2722,white,age.gp4,NoTr,NoTrade,Group,4,0,1,1,2,0,4,0,1,3,0,4,3,1
759,760,760,white,age.gp4,NoTr,NoTrade,NoGroup,1,0,0,0,1,0,1,0,1,0,0,1,1,0
760,761,761,white,age.gp4,NoTr,NoTrade,NoGroup,1,1,0,0,0,0,0,1,0,1,0,1,1,0
762,763,763,white,age.gp4,NoTr,NoTrade,NoGroup,1,0,1,0,0,0,1,0,1,0,0,1,1,0
763,764,764,white,age.gp4,NoTr,NoTrade,NoGroup,1,0,0,1,0,0,1,0,0,1,0,1,1,0
765,766,766,white,age.gp4,NoTr,NoTrade,NoGroup,1,0,1,0,0,0,1,0,1,0,0,1,1,0
766,767,767,white,age.gp4,NoTr,NoTrade,NoGroup,3,0,0,1,2,1,2,0,0,3,0,3,1,2
1809,1810,1810,black,age.gp4,NoTr,NoTrade,NoGroup,1,0,0,0,1,0,1,0,0,1,0,1,0,1
2932,2933,2933,white,age.gp4,NoTr,NoTrade,Group,11,1,5,2,3,1,9,1,7,4,0,11,8,3
772,773,773,white,age.gp4,NoTr,NoTrade,NoGroup,1,0,0,0,1,0,1,0,1,0,0,1,1,0
773,774,774,white,age.gp4,NoTr,NoTrade,NoGroup,7,1,1,2,3,0,6,1,3,4,0,7,3,4
1608,1609,1609,white,age.gp3,Tr,NoTrade,NoGroup,9,0,3,4,2,0,9,0,1,8,3,6,6,3
2477,2478,2478,other,age.gp1,NoTr,NoTrade,NoGroup,7,2,2,2,1,0,7,0,3,4,1,6,5,2
774,775,775,white,age.gp4,NoTr,NoTrade,NoGroup,1,0,0,0,1,1,0,0,0,1,1,0,1,0
776,777,777,white,age.gp4,NoTr,NoTrade,NoGroup,1,0,0,0,1,0,1,0,0,1,0,1,1,0
1079,1080,1080,white,age.gp4,NoTr,NoTrade,Group,10,0,2,2,6,0,10,0,4,6,1,9,7,3
778,779,779,white,age.gp4,NoTr,NoTrade,NoGroup,2,0,0,0,2,0,2,0,0,2,0,2,0,2
2619,2620,2620,white,age.gp4,NoTr,NoTrade,NoGroup,7,1,2,0,4,0,6,1,3,4,0,7,5,2
2967,2968,2968,white,age.gp2,NoTr,NoTrade,NoGroup,9,0,5,3,1,1,7,1,4,5,0,9,7,2
782,783,783,white,age.gp2,NoTr,NoTrade,NoGroup,9,1,2,4,2,0,9,0,2,7,0,9,6,3
1232,1233,1233,white,age.gp4,NoTr,NoTrade,NoGroup,6,1,2,0,3,2,4,0,3,3,1,5,4,2
1242,1243,1243,white,age.gp2,Tr,NoTrade,NoGroup,10,0,4,3,3,0,9,1,4,6,0,10,5,5
2023,2024,2024,black,age.gp4,NoTr,NoTrade,NoGroup,4,1,1,0,2,2,2,0,1,3,1,3,1,3
2548,2549,2549,other,age.gp1,NoTr,NoTrade,NoGroup,4,2,0,1,1,1,3,0,2,2,1,3,2,2
1595,1596,1596,black,age.gp1,Tr,Trade,NoGroup,9,5,1,1,2,5,4,0,2,7,0,9,4,5
2008,2009,2009,black,age.gp4,NoTr,NoTrade,NoGroup,1,1,0,0,0,1,0,0,1,0,0,1,0,1
2485,2486,2486,other,age.gp1,NoTr,NoTrade,NoGroup,4,2,1,1,0,1,3,0,3,1,0,4,2,2
792,793,793,white,age.gp4,NoTr,NoTrade,NoGroup,4,0,1,1,2,0,4,0,2,2,0,4,3,1
807,808,808,white,age.gp4,NoTr,NoTrade,NoGroup,4,0,0,1,3,0,4,0,2,2,0,4,2,2
796,797,797,white,age.gp4,NoTr,NoTrade,NoGroup,1,0,0,1,0,0,1,0,1,0,0,1,1,0
798,799,799,white,age.gp4,NoTr,NoTrade,NoGroup,1,0,0,1,0,0,1,0,0,1,0,1,1,0
799,800,800,white,age.gp4,NoTr,NoTrade,NoGroup,4,0,1,0,3,1,3,0,3,1,1,3,4,0
1772,1773,1773,white,age.gp4,Tr,NoTrade,Group,14,0,1,3,10,0,13,1,6,8,0,14,12,2
800,801,801,white,age.gp4,NoTr,NoTrade,NoGroup,7,1,1,0,5,1,6,0,4,3,0,7,5,2
1992,1993,1993,white,age.gp4,Tr,NoTrade,NoGroup,7,1,0,2,4,1,5,1,2,5,0,7,5,2
802,803,803,white,age.gp4,NoTr,NoTrade,NoGroup,1,0,0,1,0,0,1,0,0,1,0,1,1,0
804,805,805,white,age.gp4,NoTr,NoTrade,NoGroup,1,0,0,0,1,0,1,0,1,0,0,1,0,1
810,811,811,white,age.gp4,NoTr,NoTrade,NoGroup,1,0,0,1,0,0,1,0,1,0,0,1,1,0
811,812,812,white,age.gp4,NoTr,NoTrade,NoGroup,1,0,0,0,1,0,1,0,0,1,0,1,1,0
815,816,816,white,age.gp4,NoTr,NoTrade,NoGroup,1,0,0,0,1,0,1,0,0,1,0,1,1,0
818,819,819,white,age.gp4,NoTr,NoTrade,NoGroup,1,0,1,0,0,0,1,0,1,0,0,1,1,0
819,820,820,white,age.gp4,NoTr,NoTrade,NoGroup,4,0,1,1,2,0,3,1,2,2,0,4,3,1
1913,1914,1914,other,age.gp2,NoTr,NoTrade,NoGroup,1,0,0,0,1,0,1,0,0,1,0,1,0,1
1651,1652,1652,other,age.gp2,NoTr,NoTrade,NoGroup,5,0,0,5,0,0,5,0,1,4,0,5,4,1
999,1000,1000,white,age.gp4,NoTr,NoTrade,NoGroup,5,0,2,2,1,0,5,0,1,4,1,4,3,2
2625,2626,2626,white,age.gp4,NoTr,NoTrade,NoGroup,4,0,0,1,3,0,4,0,0,4,0,4,2,2
2200,2201,2201,white,age.gp4,NoTr,NoTrade,NoGroup,7,1,1,1,4,0,7,0,1,6,0,7,4,3
2618,2619,2619,white,age.gp4,NoTr,NoTrade,NoGroup,1,0,0,1,0,0,1,0,0,1,0,1,0,1
828,829,829,white,age.gp3,NoTr,NoTrade,NoGroup,7,0,1,3,3,0,7,0,4,3,1,6,3,4
2201,2202,2202,white,age.gp4,NoTr,NoTrade,NoGroup,5,0,2,2,1,1,4,0,1,4,0,5,4,1
1241,1242,1242,white,age.gp2,Tr,NoTrade,NoGroup,5,0,3,1,1,0,5,0,1,4,0,5,3,2
938,939,939,white,age.gp3,NoTr,NoTrade,NoGroup,7,0,1,6,0,0,7,0,1,6,0,7,5,2
976,977,977,white,age.gp4,NoTr,NoTrade,NoGroup,2,0,0,2,0,0,2,0,0,2,0,2,1,1
1604,1605,1605,white,age.gp3,Tr,NoTrade,NoGroup,13,0,5,5,3,2,9,2,3,10,1,12,9,4
2306,2307,2307,white,age.gp2,NoTr,NoTrade,NoGroup,6,0,2,2,2,2,3,1,2,4,0,6,3,3
1270,1271,1271,black,age.gp3,NoTr,NoTrade,NoGroup,6,3,2,0,1,3,3,0,1,5,0,6,3,3
1663,1664,1664,other,age.gp2,NoTr,NoTrade,NoGroup,8,0,3,3,2,0,8,0,4,4,0,8,4,4
2486,2487,2487,other,age.gp1,NoTr,NoTrade,NoGroup,2,0,1,1,0,0,2,0,1,1,0,2,2,0
2818,2819,2819,other,age.gp2,NoTr,NoTrade,NoGroup,6,0,3,3,0,0,6,0,2,4,1,5,5,1
1791,1792,1792,white,age.gp4,Tr,NoTrade,Group,11,4,2,3,2,0,10,1,3,8,0,11,8,3
1787,1788,1788,white,age.gp4,Tr,NoTrade,Group,12,0,4,1,7,1,9,2,5,7,1,11,9,3
2757,2758,2758,white,age.gp3,NoTr,NoTrade,NoGroup,14,1,8,2,3,1,12,1,9,5,0,14,11,3
868,869,869,other,age.gp2,Tr,NoTrade,Group,4,0,3,1,0,1,3,0,1,3,1,3,4,0
2826,2827,2827,other,age.gp2,NoTr,NoTrade,NoGroup,6,0,3,3,0,2,4,0,4,2,0,6,4,2
1111,1112,1112,other,age.gp1,NoTr,NoTrade,NoGroup,4,2,2,0,0,0,4,0,2,2,0,4,1,3
2862,2863,2863,white,age.gp1,Tr,NoTrade,NoGroup,14,8,2,2,2,1,11,2,4,10,1,13,10,4
853,854,854,other,age.gp2,Tr,NoTrade,Group,7,1,2,3,1,0,7,0,3,4,1,6,7,0
2351,2352,2352,white,age.gp3,Tr,NoTrade,NoGroup,5,1,4,0,0,1,2,2,3,2,0,5,4,1
2759,2760,2760,white,age.gp3,NoTr,NoTrade,NoGroup,4,0,3,0,1,0,3,1,2,2,0,4,2,2
860,861,861,other,age.gp2,Tr,NoTrade,Group,7,0,1,3,3,2,5,0,1,6,0,7,3,4
1041,1042,1042,black,age.gp4,NoTr,NoTrade,NoGroup,1,0,1,0,0,0,0,1,1,0,0,1,1,0
863,864,864,other,age.gp2,Tr,NoTrade,Group,9,1,3,4,1,1,8,0,3,6,1,8,6,3
1784,1785,1785,white,age.gp4,Tr,NoTrade,Group,12,1,4,4,3,1,10,1,4,8,1,11,9,3
1977,1978,1978,white,age.gp4,Tr,NoTrade,NoGroup,9,0,2,2,5,0,8,1,6,3,0,9,6,3
2559,2560,2560,white,age.gp4,NoTr,NoTrade,Group,11,0,3,3,5,0,10,1,7,4,0,11,9,2
1140,1141,1141,white,age.gp1,NoTr,NoTrade,NoGroup,8,3,2,2,1,0,7,1,4,4,2,6,5,3
2930,2931,2931,white,age.gp4,NoTr,NoTrade,Group,6,0,2,0,4,0,5,1,3,3,0,6,6,0
2543,2544,2544,other,age.gp1,NoTr,NoTrade,NoGroup,8,2,1,2,3,1,6,1,3,5,0,8,5,3
2793,2794,2794,white,age.gp2,Tr,NoTrade,NoGroup,9,1,2,2,4,0,7,2,4,5,0,9,9,0
1227,1228,1228,white,age.gp4,NoTr,NoTrade,NoGroup,2,0,1,1,0,0,1,1,0,2,1,1,1,1
1627,1628,1628,white,age.gp1,NoTr,NoTrade,NoGroup,4,1,0,1,2,0,4,0,2,2,1,3,3,1
1545,1546,1546,white,age.gp2,NoTr,NoTrade,NoGroup,8,1,3,2,2,0,7,1,4,4,2,6,6,2
1662,1663,1663,other,age.gp2,NoTr,NoTrade,NoGroup,4,0,0,3,1,0,4,0,1,3,1,3,3,1
1168,1169,1169,white,age.gp4,NoTr,NoTrade,NoGroup,5,0,2,2,1,1,4,0,3,2,1,4,3,2
2615,2616,2616,white,age.gp4,NoTr,NoTrade,NoGroup,4,0,1,1,2,1,3,0,2,2,1,3,3,1
1070,1071,1071,white,age.gp4,NoTr,NoTrade,Group,14,0,5,3,6,1,12,1,7,7,1,13,12,2
2825,2826,2826,other,age.gp2,NoTr,NoTrade,NoGroup,4,2,1,1,0,0,4,0,3,1,2,2,2,2
979,980,980,white,age.gp4,NoTr,NoTrade,NoGroup,5,0,0,3,2,0,5,0,3,2,1,4,4,1
1302,1303,1303,white,age.gp4,NoTr,NoTrade,Group,9,2,2,1,4,1,7,1,3,6,1,8,7,2
1148,1149,1149,white,age.gp4,NoTr,NoTrade,NoGroup,2,0,0,2,0,0,2,0,1,1,1,1,2,0
1952,1953,1953,white,age.gp4,NoTr,NoTrade,Group,7,0,3,2,2,2,5,0,4,3,2,5,6,1
2082,2083,2083,black,age.gp3,NoTr,NoTrade,NoGroup,7,0,2,3,2,3,4,0,2,5,2,5,4,3
2278,2279,2279,other,age.gp2,Tr,NoTrade,Group,9,3,2,1,3,0,9,0,4,5,1,8,7,2
2918,2919,2919,white,age.gp1,NoTr,NoTrade,NoGroup,8,6,0,1,1,0,3,5,3,5,1,7,3,5
1964,1965,1965,white,age.gp4,NoTr,NoTrade,Group,7,2,0,2,3,0,6,1,4,3,1,6,4,3
895,896,896,other,age.gp1,Tr,NoTrade,NoGroup,1,1,0,0,0,0,1,0,0,1,0,1,1,0
898,899,899,other,age.gp1,Tr,NoTrade,NoGroup,5,4,0,1,0,0,5,0,2,3,1,4,3,2
900,901,901,other,age.gp1,Tr,NoTrade,NoGroup,3,1,0,0,2,0,3,0,1,2,1,2,3,0
905,906,906,other,age.gp1,Tr,NoTrade,NoGroup,3,1,0,2,0,0,3,0,2,1,0,3,2,1
1141,1142,1142,white,age.gp1,NoTr,NoTrade,NoGroup,7,3,2,1,1,0,5,2,2,5,0,7,2,5
907,908,908,other,age.gp1,Tr,NoTrade,NoGroup,5,2,0,2,1,1,4,0,1,4,1,4,3,2
913,914,914,other,age.gp1,Tr,NoTrade,NoGroup,1,1,0,0,0,0,1,0,1,0,0,1,1,0
914,915,915,other,age.gp1,Tr,NoTrade,NoGroup,4,3,0,1,0,0,4,0,1,3,0,4,1,3
1016,1017,1017,white,age.gp1,NoTr,NoTrade,NoGroup,8,7,1,0,0,1,6,1,4,4,3,5,6,2
2500,2501,2501,other,age.gp1,NoTr,NoTrade,NoGroup,5,4,0,1,0,0,5,0,0,5,1,4,1,4
1480,1481,1481,white,age.gp4,NoTr,NoTrade,NoGroup,1,0,1,0,0,0,1,0,0,1,0,1,0,1
924,925,925,white,age.gp2,NoTr,NoTrade,NoGroup,9,1,4,3,1,0,6,3,3,6,0,9,4,5
1699,1700,1700,white,age.gp4,NoTr,Trade,NoGroup,4,0,2,1,1,0,3,1,2,2,0,4,3,1
931,932,932,white,age.gp3,NoTr,NoTrade,NoGroup,2,0,1,0,1,0,2,0,0,2,0,2,1,1
932,933,933,white,age.gp3,NoTr,NoTrade,NoGroup,7,0,4,2,1,2,5,0,3,4,1,6,7,0
2210,2211,2211,black,age.gp2,NoTr,Trade,Group,11,0,5,5,1,5,6,0,5,6,1,10,7,4
2761,2762,2762,white,age.gp3,NoTr,NoTrade,NoGroup,8,1,4,2,1,0,7,1,4,4,0,8,6,2
2026,2027,2027,black,age.gp4,NoTr,NoTrade,NoGroup,1,0,0,1,0,0,1,0,0,1,0,1,0,1
1145,1146,1146,white,age.gp4,NoTr,NoTrade,NoGroup,1,0,0,1,0,0,1,0,1,0,0,1,1,0
1200,1201,1201,white,age.gp4,Tr,NoTrade,NoGroup,1,0,0,1,0,0,1,0,1,0,0,1,1,0
2747,2748,2748,white,age.gp3,NoTr,NoTrade,NoGroup,5,0,1,2,2,0,5,0,3,2,0,5,5,0
1793,1794,1794,white,age.gp4,Tr,NoTrade,Group,11,2,2,2,5,1,7,3,5,6,1,10,9,2
2914,2915,2915,other,age.gp1,NoTr,NoTrade,NoGroup,4,1,1,1,1,1,3,0,2,2,0,4,3,1
1985,1986,1986,white,age.gp4,Tr,NoTrade,NoGroup,6,0,2,3,1,1,4,1,3,3,0,6,4,2
2706,2707,2707,white,age.gp4,NoTr,NoTrade,Group,16,1,3,5,7,2,14,0,6,10,1,15,8,8
2363,2364,2364,white,age.gp3,Tr,NoTrade,NoGroup,6,1,1,2,2,1,5,0,2,4,1,5,4,2
1336,1337,1337,white,age.gp3,NoTr,NoTrade,NoGroup,6,2,3,1,0,2,3,1,5,1,1,5,6,0
1746,1747,1747,black,age.gp4,NoTr,NoTrade,NoGroup,6,1,0,2,3,2,3,1,2,4,0,6,4,2
2356,2357,2357,white,age.gp3,Tr,NoTrade,NoGroup,3,1,0,2,0,0,3,0,3,0,0,3,2,1
1150,1151,1151,white,age.gp4,NoTr,NoTrade,NoGroup,1,0,0,1,0,0,1,0,1,0,0,1,1,0
1448,1449,1449,white,age.gp1,NoTr,NoTrade,NoGroup,9,6,2,1,0,1,7,1,2,7,1,8,3,6
2034,2035,2035,white,age.gp4,Tr,NoTrade,Group,14,2,3,3,6,2,12,0,5,9,0,14,9,5
960,961,961,black,age.gp2,Tr,NoTrade,NoGroup,6,0,3,2,1,4,2,0,2,4,1,5,4,2
2098,2099,2099,black,age.gp3,NoTr,NoTrade,NoGroup,9,0,6,2,1,6,3,0,4,5,0,9,5,4
1388,1389,1389,black,age.gp3,NoTr,NoTrade,NoGroup,1,0,1,0,0,1,0,0,0,1,0,1,1,0
2229,2230,2230,black,age.gp4,NoTr,Trade,Group,5,0,1,0,4,4,1,0,0,5,2,3,5,0
2492,2493,2493,other,age.gp1,NoTr,NoTrade,NoGroup,2,1,1,0,0,1,1,0,1,1,0,2,1,1
1656,1657,1657,other,age.gp2,NoTr,NoTrade,NoGroup,4,1,2,0,1,1,3,0,1,3,0,4,3,1
1212,1213,1213,white,age.gp4,NoTr,NoTrade,NoGroup,3,0,2,0,1,0,3,0,2,1,0,3,2,1
1385,1386,1386,black,age.gp3,NoTr,NoTrade,NoGroup,4,0,3,1,0,2,1,1,1,3,0,4,3,1
2050,2051,2051,white,age.gp4,Tr,NoTrade,Group,5,2,2,0,1,0,5,0,3,2,0,5,3,2
1068,1069,1069,white,age.gp4,NoTr,NoTrade,Group,7,1,1,2,3,1,6,0,3,4,0,7,4,3
1955,1956,1956,white,age.gp4,NoTr,NoTrade,Group,8,0,3,1,4,0,8,0,7,1,0,8,8,0
2483,2484,2484,other,age.gp1,NoTr,NoTrade,NoGroup,3,2,1,0,0,1,2,0,2,1,0,3,2,1
1541,1542,1542,white,age.gp2,NoTr,NoTrade,NoGroup,8,0,4,2,2,0,7,1,4,4,0,8,7,1
977,978,978,white,age.gp4,NoTr,NoTrade,NoGroup,1,0,0,0,1,0,1,0,0,1,0,1,0,1
974,975,975,white,age.gp4,NoTr,NoTrade,NoGroup,1,0,0,0,1,0,1,0,0,1,0,1,0,1
975,976,976,white,age.gp4,NoTr,NoTrade,NoGroup,7,0,1,0,6,0,7,0,5,2,0,7,6,1
1979,1980,1980,white,age.gp4,Tr,NoTrade,NoGroup,2,0,0,1,1,0,2,0,1,1,0,2,1,1
982,983,983,white,age.gp4,NoTr,NoTrade,NoGroup,1,0,0,0,1,0,1,0,0,1,0,1,1,0
983,984,984,white,age.gp4,NoTr,NoTrade,NoGroup,1,0,0,0,1,0,1,0,0,1,0,1,1,0
985,986,986,white,age.gp4,NoTr,NoTrade,NoGroup,1,0,1,0,0,0,1,0,0,1,0,1,0,1
1920,1921,1921,other,age.gp2,NoTr,NoTrade,NoGroup,7,1,2,3,1,0,7,0,2,5,0,7,5,2
2197,2198,2198,white,age.gp4,NoTr,NoTrade,NoGroup,3,0,1,1,1,0,3,0,1,2,0,3,2,1
988,989,989,white,age.gp4,NoTr,NoTrade,NoGroup,1,0,0,1,0,0,1,0,1,0,0,1,0,1
995,996,996,white,age.gp4,NoTr,NoTrade,NoGroup,2,0,0,0,2,0,2,0,0,2,0,2,1,1
990,991,991,white,age.gp4,NoTr,NoTrade,NoGroup,1,0,0,0,1,0,1,0,1,0,0,1,1,0
996,997,997,white,age.gp4,NoTr,NoTrade,NoGroup,1,0,0,0,1,0,1,0,0,1,0,1,1,0
997,998,998,white,age.gp4,NoTr,NoTrade,NoGroup,1,0,1,0,0,0,0,1,1,0,0,1,1,0
2933,2934,2934,white,age.gp4,NoTr,NoTrade,Group,10,1,0,0,9,0,10,0,4,6,0,10,6,4
1000,1001,1001,white,age.gp4,NoTr,NoTrade,NoGroup,1,0,0,0,1,0,1,0,0,1,0,1,0,1
1001,1002,1002,white,age.gp4,NoTr,NoTrade,NoGroup,2,0,0,1,1,0,2,0,1,1,0,2,2,0
2499,2500,2500,other,age.gp1,NoTr,NoTrade,NoGroup,9,5,3,1,0,2,7,0,5,4,1,8,5,4
2895,2896,2896,other,age.gp1,NoTr,NoTrade,NoGroup,3,3,0,0,0,0,3,0,2,1,0,3,2,1
2479,2480,2480,other,age.gp1,NoTr,NoTrade,NoGroup,4,3,0,1,0,0,4,0,1,3,0,4,3,1
2532,2533,2533,other,age.gp1,NoTr,NoTrade,NoGroup,7,5,0,2,0,2,5,0,1,6,0,7,2,5
2501,2502,2502,other,age.gp1,NoTr,NoTrade,NoGroup,2,2,0,0,0,0,2,0,1,1,0,2,0,2
2915,2916,2916,other,age.gp1,NoTr,NoTrade,NoGroup,2,2,0,0,0,0,2,0,1,1,0,2,0,2
2638,2639,2639,white,age.gp4,NoTr,NoTrade,NoGroup,4,1,1,1,1,0,4,0,2,2,0,4,2,2
1576,1577,1577,white,age.gp4,Tr,NoTrade,Group,14,2,2,4,6,0,14,0,4,10,1,13,11,3
1130,1131,1131,other,age.gp1,NoTr,NoTrade,NoGroup,7,4,0,1,2,2,5,0,2,5,0,7,2,5
2493,2494,2494,other,age.gp1,NoTr,NoTrade,NoGroup,6,4,0,2,0,0,6,0,1,5,0,6,2,4
2904,2905,2905,other,age.gp1,NoTr,NoTrade,NoGroup,5,4,1,0,0,0,5,0,1,4,0,5,2,3
1614,1615,1615,white,age.gp3,Tr,NoTrade,NoGroup,7,1,5,0,1,1,4,2,2,5,1,6,4,3
2762,2763,2763,black,age.gp2,NoTr,NoTrade,NoGroup,9,0,4,4,1,5,4,0,2,7,1,8,6,3
2964,2965,2965,white,age.gp2,NoTr,NoTrade,NoGroup,6,1,5,0,0,1,5,0,3,3,1,5,5,1
1023,1024,1024,black,age.gp4,NoTr,NoTrade,NoGroup,5,0,1,0,4,2,3,0,1,4,0,5,3,2
1521,1522,1522,black,age.gp4,NoTr,NoTrade,NoGroup,3,0,0,2,1,3,0,0,0,3,0,3,0,3
1817,1818,1818,black,age.gp4,NoTr,NoTrade,NoGroup,1,0,0,0,1,1,0,0,0,1,0,1,0,1
1025,1026,1026,black,age.gp4,NoTr,NoTrade,NoGroup,1,0,0,0,1,1,0,0,0,1,0,1,0,1
1522,1523,1523,black,age.gp4,NoTr,NoTrade,NoGroup,2,0,0,0,2,1,1,0,1,1,0,2,1,1
1485,1486,1486,white,age.gp4,NoTr,NoTrade,NoGroup,5,1,0,1,3,1,4,0,1,4,0,5,4,1
1027,1028,1028,black,age.gp4,NoTr,NoTrade,NoGroup,1,0,1,0,0,0,1,0,0,1,0,1,1,0
1029,1030,1030,black,age.gp4,NoTr,NoTrade,NoGroup,1,0,1,0,0,0,1,0,1,0,0,1,1,0
1031,1032,1032,black,age.gp4,NoTr,NoTrade,NoGroup,3,0,0,1,2,1,2,0,1,2,0,3,2,1
1767,1768,1768,black,age.gp4,NoTr,NoTrade,NoGroup,1,0,0,0,1,1,0,0,0,1,0,1,0,1
1034,1035,1035,black,age.gp4,NoTr,NoTrade,NoGroup,1,0,0,0,1,0,1,0,0,1,0,1,1,0
1035,1036,1036,black,age.gp4,NoTr,NoTrade,NoGroup,1,0,1,0,0,1,0,0,0,1,0,1,0,1
1036,1037,1037,black,age.gp4,NoTr,NoTrade,NoGroup,1,0,1,0,0,0,1,0,1,0,0,1,1,0
1042,1043,1043,black,age.gp4,NoTr,NoTrade,NoGroup,2,1,0,0,1,0,2,0,1,1,0,2,0,2
1043,1044,1044,black,age.gp4,NoTr,NoTrade,NoGroup,1,0,0,0,1,1,0,0,0,1,0,1,0,1
2016,2017,2017,black,age.gp4,NoTr,NoTrade,NoGroup,4,0,0,0,4,2,2,0,0,4,0,4,2,2
1044,1045,1045,black,age.gp4,NoTr,NoTrade,NoGroup,1,0,0,1,0,1,0,0,0,1,0,1,0,1
1045,1046,1046,black,age.gp4,NoTr,NoTrade,NoGroup,1,0,0,0,1,1,0,0,0,1,0,1,0,1
1755,1756,1756,black,age.gp4,NoTr,NoTrade,NoGroup,1,0,0,0,1,1,0,0,0,1,0,1,0,1
2240,2241,2241,black,age.gp4,NoTr,Trade,Group,8,0,0,2,6,6,2,0,1,7,1,7,3,5
2373,2374,2374,black,age.gp2,NoTr,NoTrade,NoGroup,8,1,4,0,3,7,0,1,1,7,0,8,4,4
1047,1048,1048,black,age.gp4,NoTr,NoTrade,NoGroup,1,0,0,0,1,1,0,0,0,1,0,1,1,0
1049,1050,1050,black,age.gp4,NoTr,NoTrade,NoGroup,5,1,1,2,1,2,3,0,2,3,0,5,2,3
1518,1519,1519,black,age.gp4,NoTr,NoTrade,NoGroup,3,0,1,1,1,2,1,0,0,3,0,3,0,3
1052,1053,1053,black,age.gp4,NoTr,NoTrade,NoGroup,1,1,0,0,0,1,0,0,0,1,0,1,0,1
2813,2814,2814,other,age.gp2,NoTr,NoTrade,NoGroup,6,1,2,1,2,1,5,0,1,5,0,6,2,4
1590,1591,1591,white,age.gp4,Tr,NoTrade,Group,8,1,1,0,6,2,6,0,2,6,0,8,6,2
1173,1174,1174,white,age.gp4,NoTr,NoTrade,NoGroup,1,0,0,0,1,0,1,0,0,1,0,1,1,0
2488,2489,2489,other,age.gp1,NoTr,NoTrade,NoGroup,2,0,1,0,1,0,2,0,1,1,0,2,2,0
2860,2861,2861,white,age.gp1,Tr,NoTrade,NoGroup,7,3,2,0,2,1,6,0,1,6,0,7,4,3
2621,2622,2622,white,age.gp4,NoTr,NoTrade,NoGroup,7,0,0,4,3,0,7,0,3,4,0,7,6,1
1984,1985,1985,white,age.gp4,Tr,NoTrade,NoGroup,1,0,0,0,1,0,1,0,0,1,0,1,1,0
1678,1679,1679,white,age.gp4,NoTr,Trade,NoGroup,5,0,1,0,4,0,5,0,3,2,0,5,5,0
2179,2180,2180,white,age.gp4,NoTr,NoTrade,NoGroup,4,0,0,1,3,0,4,0,0,4,0,4,4,0
1076,1077,1077,white,age.gp4,NoTr,NoTrade,Group,4,0,1,0,3,0,4,0,3,1,0,4,2,2
2189,2190,2190,white,age.gp4,NoTr,NoTrade,NoGroup,1,0,0,0,1,0,1,0,0,1,0,1,1,0
1474,1475,1475,black,age.gp1,NoTr,NoTrade,NoGroup,3,1,1,0,1,0,2,1,0,3,0,3,3,0
2456,2457,2457,white,age.gp4,NoTr,NoTrade,NoGroup,1,0,0,0,1,0,1,0,0,1,0,1,1,0
1397,1398,1398,black,age.gp3,NoTr,NoTrade,NoGroup,6,0,2,1,3,4,2,0,0,6,0,6,4,2
2803,2804,2804,other,age.gp2,NoTr,NoTrade,NoGroup,3,0,1,1,1,0,3,0,1,2,0,3,3,0
2433,2434,2434,white,age.gp4,NoTr,NoTrade,NoGroup,6,1,0,0,5,1,4,1,1,5,0,6,4,2
2174,2175,2175,white,age.gp4,NoTr,NoTrade,NoGroup,3,1,1,0,1,1,2,0,2,1,0,3,1,2
1839,1840,1840,black,age.gp3,NoTr,NoTrade,NoGroup,9,1,4,3,1,7,2,0,1,8,1,8,5,4
1635,1636,1636,black,age.gp1,Tr,NoTrade,NoGroup,9,4,4,1,0,4,1,4,2,7,1,8,3,6
2820,2821,2821,other,age.gp2,NoTr,NoTrade,NoGroup,3,0,2,1,0,1,2,0,1,2,0,3,1,2
2502,2503,2503,other,age.gp1,NoTr,NoTrade,NoGroup,3,2,1,0,0,1,2,0,1,2,0,3,1,2
1108,1109,1109,other,age.gp1,NoTr,NoTrade,NoGroup,7,5,1,1,0,3,4,0,0,7,0,7,2,5
1221,1222,1222,white,age.gp4,NoTr,NoTrade,NoGroup,1,0,1,0,0,0,1,0,0,1,0,1,1,0
2642,2643,2643,white,age.gp1,NoTr,NoTrade,NoGroup,7,6,1,0,0,0,5,2,3,4,1,6,2,5
2461,2462,2462,black,age.gp1,NoTr,NoTrade,NoGroup,7,1,4,1,1,5,2,0,1,6,1,6,3,4
1109,1110,1110,other,age.gp1,NoTr,NoTrade,NoGroup,4,4,0,0,0,1,3,0,1,3,1,3,1,3
1116,1117,1117,other,age.gp1,NoTr,NoTrade,NoGroup,5,3,1,0,1,0,5,0,3,2,0,5,3,2
1121,1122,1122,other,age.gp1,NoTr,NoTrade,NoGroup,4,1,0,2,1,1,3,0,2,2,0,4,1,3
1123,1124,1124,other,age.gp1,NoTr,NoTrade,NoGroup,1,0,0,1,0,0,1,0,1,0,0,1,0,1
1124,1125,1125,other,age.gp1,NoTr,NoTrade,NoGroup,6,1,1,1,3,1,5,0,4,2,1,5,5,1
1127,1128,1128,other,age.gp1,NoTr,NoTrade,NoGroup,5,3,0,1,1,1,4,0,2,3,1,4,4,1
1179,1180,1180,white,age.gp4,Tr,NoTrade,NoGroup,5,1,1,0,3,1,4,0,2,3,0,5,2,3
2155,2156,2156,other,age.gp2,NoTr,NoTrade,NoGroup,6,0,4,1,1,1,5,0,3,3,0,6,5,1
2890,2891,2891,other,age.gp1,NoTr,NoTrade,NoGroup,4,1,3,0,0,0,3,1,2,2,0,4,2,2
1278,1279,1279,white,age.gp4,NoTr,NoTrade,Group,9,0,2,2,5,0,9,0,6,3,0,9,9,0
1139,1140,1140,white,age.gp1,NoTr,NoTrade,NoGroup,6,4,2,0,0,0,5,1,2,4,0,6,2,4
1143,1144,1144,white,age.gp4,NoTr,NoTrade,NoGroup,1,0,0,1,0,0,1,0,0,1,0,1,1,0
1146,1147,1147,white,age.gp4,NoTr,NoTrade,NoGroup,1,0,0,1,0,0,1,0,0,1,0,1,1,0
1147,1148,1148,white,age.gp4,NoTr,NoTrade,NoGroup,2,0,0,0,2,0,2,0,1,1,0,2,2,0
1152,1153,1153,white,age.gp4,NoTr,NoTrade,NoGroup,1,0,1,0,0,0,1,0,0,1,0,1,1,0
2566,2567,2567,white,age.gp4,NoTr,NoTrade,Group,10,0,3,2,5,2,7,1,4,6,1,9,4,6
1155,1156,1156,white,age.gp4,NoTr,NoTrade,NoGroup,1,0,1,0,0,0,1,0,1,0,0,1,0,1
1156,1157,1157,white,age.gp4,NoTr,NoTrade,NoGroup,3,0,2,0,1,1,2,0,1,2,0,3,2,1
1159,1160,1160,white,age.gp4,NoTr,NoTrade,NoGroup,8,0,3,2,3,1,7,0,4,4,1,7,8,0
1162,1163,1163,white,age.gp4,NoTr,NoTrade,NoGroup,1,1,0,0,0,0,1,0,1,0,1,0,1,0
1163,1164,1164,white,age.gp4,NoTr,NoTrade,NoGroup,1,0,0,0,1,0,1,0,0,1,0,1,1,0
1436,1437,1437,white,age.gp3,Tr,NoTrade,NoGroup,5,1,0,1,3,0,5,0,3,2,0,5,3,2
1174,1175,1175,white,age.gp4,NoTr,NoTrade,NoGroup,1,1,0,0,0,0,0,1,0,1,0,1,0,1
1690,1691,1691,white,age.gp4,NoTr,Trade,NoGroup,1,0,0,0,1,0,1,0,1,0,0,1,0,1
2295,2296,2296,other,age.gp2,Tr,NoTrade,Group,8,0,5,1,2,0,8,0,6,2,0,8,6,2
1176,1177,1177,white,age.gp4,Tr,NoTrade,NoGroup,5,0,2,2,1,0,5,0,3,2,0,5,4,1
1481,1482,1482,white,age.gp4,NoTr,NoTrade,NoGroup,5,1,1,1,2,0,4,1,2,3,0,5,2,3
1217,1218,1218,white,age.gp4,NoTr,NoTrade,NoGroup,1,0,0,0,1,0,1,0,1,0,0,1,0,1
1180,1181,1181,white,age.gp4,Tr,NoTrade,NoGroup,1,0,1,0,0,0,1,0,0,1,0,1,1,0
2370,2371,2371,black,age.gp2,NoTr,NoTrade,NoGroup,4,0,3,0,1,1,2,1,3,1,0,4,2,2
1216,1217,1217,white,age.gp4,NoTr,NoTrade,NoGroup,3,0,0,1,2,0,3,0,2,1,0,3,2,1
1509,1510,1510,white,age.gp4,NoTr,NoTrade,NoGroup,1,0,0,0,1,0,1,0,1,0,0,1,0,1
1187,1188,1188,white,age.gp4,Tr,NoTrade,NoGroup,1,1,0,0,0,0,0,1,0,1,0,1,1,0
1479,1480,1480,white,age.gp4,NoTr,NoTrade,NoGroup,5,0,1,2,2,1,3,1,2,3,1,4,2,3
1193,1194,1194,white,age.gp4,Tr,NoTrade,NoGroup,1,0,0,0,1,0,1,0,0,1,0,1,1,0
2371,2372,2372,black,age.gp2,NoTr,NoTrade,NoGroup,3,0,0,1,2,0,3,0,2,1,0,3,1,2
1198,1199,1199,white,age.gp4,Tr,NoTrade,NoGroup,7,0,2,1,4,0,6,1,1,6,0,7,6,1
1199,1200,1200,white,age.gp4,Tr,NoTrade,NoGroup,1,0,0,0,1,0,1,0,0,1,0,1,1,0
1202,1203,1203,white,age.gp4,Tr,NoTrade,NoGroup,6,0,2,0,4,1,5,0,4,2,0,6,6,0
1488,1489,1489,white,age.gp4,NoTr,NoTrade,NoGroup,1,0,0,0,1,0,1,0,1,0,0,1,0,1
1206,1207,1207,white,age.gp4,Tr,NoTrade,NoGroup,2,1,1,0,0,0,1,1,0,2,0,2,1,1
1207,1208,1208,white,age.gp4,NoTr,NoTrade,NoGroup,1,0,0,0,1,0,1,0,1,0,0,1,1,0
2347,2348,2348,black,age.gp2,NoTr,NoTrade,Group,16,0,8,7,1,7,8,1,6,10,1,15,9,7
2674,2675,2675,white,age.gp3,NoTr,NoTrade,NoGroup,7,0,3,1,3,0,7,0,1,6,0,7,4,3
1209,1210,1210,white,age.gp4,NoTr,NoTrade,NoGroup,4,0,2,0,2,0,4,0,3,1,0,4,4,0
1215,1216,1216,white,age.gp4,NoTr,NoTrade,NoGroup,1,0,0,0,1,0,1,0,0,1,0,1,0,1
1223,1224,1224,white,age.gp4,NoTr,NoTrade,NoGroup,1,0,0,0,1,0,1,0,0,1,0,1,1,0
1228,1229,1229,white,age.gp4,NoTr,NoTrade,NoGroup,1,0,0,1,0,0,1,0,0,1,0,1,1,0
1235,1236,1236,white,age.gp4,NoTr,NoTrade,NoGroup,1,0,0,0,1,0,1,0,0,1,0,1,1,0
1238,1239,1239,white,age.gp4,NoTr,NoTrade,NoGroup,4,0,0,0,4,0,4,0,2,2,0,4,3,1
1676,1677,1677,white,age.gp4,NoTr,Trade,NoGroup,2,0,1,1,0,0,2,0,1,1,0,2,1,1
2462,2463,2463,white,age.gp1,Tr,NoTrade,NoGroup,8,4,2,1,1,0,8,0,1,7,0,8,5,3
1334,1335,1335,white,age.gp3,NoTr,NoTrade,NoGroup,5,1,2,0,2,0,4,1,2,3,0,5,3,2
2556,2557,2557,other,age.gp1,NoTr,NoTrade,NoGroup,4,3,1,0,0,0,4,0,3,1,0,4,1,3
1330,1331,1331,white,age.gp3,NoTr,NoTrade,NoGroup,1,0,1,0,0,0,1,0,1,0,0,1,1,0
2158,2159,2159,other,age.gp2,NoTr,NoTrade,NoGroup,7,1,3,1,2,2,5,0,1,6,1,6,3,4
1382,1383,1383,white,age.gp1,NoTr,NoTrade,NoGroup,9,4,2,2,1,0,9,0,4,5,1,8,6,3
2384,2385,2385,white,age.gp1,NoTr,NoTrade,NoGroup,7,2,3,1,1,0,6,1,4,3,1,6,5,2
1768,1769,1769,black,age.gp4,NoTr,NoTrade,NoGroup,1,0,0,1,0,1,0,0,0,1,0,1,0,1
1260,1261,1261,black,age.gp3,NoTr,NoTrade,NoGroup,4,1,1,1,1,4,0,0,0,4,1,3,1,3
1513,1514,1514,black,age.gp4,NoTr,NoTrade,NoGroup,2,0,0,1,1,1,1,0,1,1,0,2,0,2
1688,1689,1689,white,age.gp4,NoTr,Trade,NoGroup,1,0,0,1,0,1,0,0,0,1,0,1,0,1
2758,2759,2759,white,age.gp3,NoTr,NoTrade,NoGroup,10,2,1,5,2,2,8,0,3,7,0,10,5,5
2682,2683,2683,black,age.gp3,NoTr,NoTrade,NoGroup,5,2,1,1,1,4,1,0,1,4,0,5,1,4
1439,1440,1440,white,age.gp3,Tr,NoTrade,NoGroup,4,0,0,2,2,1,3,0,2,2,0,4,3,1
1282,1283,1283,white,age.gp4,NoTr,NoTrade,Group,8,1,0,3,4,0,8,0,3,5,1,7,5,3
1681,1682,1682,white,age.gp4,NoTr,Trade,NoGroup,2,0,0,0,2,0,2,0,0,2,0,2,2,0
1704,1705,1705,white,age.gp4,NoTr,Trade,NoGroup,1,0,0,0,1,0,1,0,0,1,0,1,1,0
1929,1930,1930,other,age.gp2,NoTr,NoTrade,NoGroup,4,0,2,0,2,0,4,0,2,2,0,4,3,1
1934,1935,1935,white,age.gp4,NoTr,NoTrade,Group,10,2,0,1,7,3,7,0,6,4,2,8,7,3
1923,1924,1924,other,age.gp2,NoTr,NoTrade,NoGroup,1,0,0,0,1,0,1,0,0,1,0,1,1,0
2487,2488,2488,other,age.gp1,NoTr,NoTrade,NoGroup,3,1,0,1,1,0,3,0,0,3,0,3,2,1
1679,1680,1680,white,age.gp4,NoTr,Trade,NoGroup,1,0,0,0,1,0,1,0,0,1,0,1,1,0
1422,1423,1423,white,age.gp2,NoTr,NoTrade,Group,15,1,7,3,4,1,13,1,4,11,1,14,8,7
1969,1970,1970,white,age.gp4,Tr,NoTrade,NoGroup,3,0,3,0,0,0,2,1,2,1,0,3,1,2
2156,2157,2157,other,age.gp2,NoTr,NoTrade,NoGroup,3,0,2,0,1,0,3,0,2,1,1,2,2,1
1664,1665,1665,other,age.gp2,NoTr,NoTrade,NoGroup,6,0,1,3,2,0,6,0,4,2,0,6,4,2
2901,2902,2902,other,age.gp1,NoTr,NoTrade,NoGroup,3,1,1,0,1,0,3,0,1,2,0,3,2,1
1540,1541,1541,black,age.gp4,NoTr,NoTrade,NoGroup,2,1,0,1,0,1,1,0,1,1,0,2,0,2
1914,1915,1915,other,age.gp2,NoTr,NoTrade,NoGroup,3,0,1,0,2,1,2,0,1,2,0,3,3,0
1530,1531,1531,black,age.gp4,NoTr,NoTrade,NoGroup,1,0,0,0,1,1,0,0,0,1,0,1,1,0
1816,1817,1817,black,age.gp4,NoTr,NoTrade,NoGroup,2,0,0,1,1,2,0,0,0,2,0,2,1,1
2015,2016,2016,black,age.gp4,NoTr,NoTrade,NoGroup,1,0,0,0,1,1,0,0,0,1,0,1,1,0
2185,2186,2186,white,age.gp4,NoTr,NoTrade,NoGroup,1,0,0,0,1,1,0,0,0,1,0,1,1,0
1539,1540,1540,black,age.gp4,NoTr,NoTrade,NoGroup,5,1,1,1,2,3,2,0,2,3,1,4,5,0
1769,1770,1770,black,age.gp4,NoTr,NoTrade,NoGroup,1,0,0,0,1,1,0,0,0,1,0,1,1,0
2639,2640,2640,white,age.gp4,NoTr,NoTrade,NoGroup,1,0,0,0,1,1,0,0,0,1,0,1,1,0
2017,2018,2018,black,age.gp4,NoTr,NoTrade,NoGroup,4,0,1,0,3,1,3,0,2,2,0,4,3,1
1659,1660,1660,other,age.gp2,NoTr,NoTrade,NoGroup,3,0,0,3,0,1,2,0,1,2,0,3,2,1
1392,1393,1393,black,age.gp3,NoTr,NoTrade,NoGroup,2,1,1,0,0,0,2,0,1,1,0,2,1,1
1396,1397,1397,black,age.gp3,NoTr,NoTrade,NoGroup,4,2,1,1,0,2,1,1,1,3,0,4,2,2
1637,1638,1638,black,age.gp1,Tr,NoTrade,NoGroup,8,2,2,3,1,4,4,0,1,7,1,7,5,3
1398,1399,1399,black,age.gp3,NoTr,NoTrade,NoGroup,10,0,5,4,1,6,3,1,2,8,0,10,6,4
2802,2803,2803,other,age.gp2,NoTr,NoTrade,NoGroup,2,0,0,1,1,1,1,0,0,2,0,2,0,2
1491,1492,1492,white,age.gp4,NoTr,NoTrade,NoGroup,1,0,0,1,0,0,1,0,0,1,0,1,1,0
2796,2797,2797,white,age.gp2,Tr,NoTrade,NoGroup,8,0,4,2,2,1,7,0,1,7,0,8,5,3
1821,1822,1822,black,age.gp4,NoTr,NoTrade,NoGroup,1,0,1,0,0,0,1,0,1,0,0,1,1,0
1487,1488,1488,white,age.gp4,NoTr,NoTrade,NoGroup,1,0,1,0,0,0,1,0,1,0,0,1,1,0
1650,1651,1651,other,age.gp2,NoTr,NoTrade,NoGroup,5,0,2,2,1,1,4,0,3,2,0,5,3,2
1461,1462,1462,white,age.gp1,NoTr,NoTrade,NoGroup,4,2,2,0,0,0,4,0,0,4,0,4,3,1
1912,1913,1913,other,age.gp2,NoTr,NoTrade,NoGroup,2,1,1,0,0,1,1,0,0,2,0,2,1,1
1633,1634,1634,black,age.gp1,Tr,NoTrade,NoGroup,4,2,1,1,0,1,3,0,2,2,0,4,3,1
2539,2540,2540,other,age.gp1,NoTr,NoTrade,NoGroup,3,2,0,1,0,0,3,0,1,2,0,3,2,1
2534,2535,2535,other,age.gp1,NoTr,NoTrade,NoGroup,4,1,2,1,0,1,3,0,1,3,1,3,2,2
1641,1642,1642,other,age.gp2,NoTr,NoTrade,NoGroup,2,0,2,0,0,0,2,0,0,2,1,1,2,0
2146,2147,2147,other,age.gp2,NoTr,NoTrade,NoGroup,3,1,1,1,0,0,3,0,2,1,0,3,2,1
1486,1487,1487,white,age.gp4,NoTr,NoTrade,NoGroup,3,1,0,2,0,0,2,1,2,1,0,3,1,2
1489,1490,1490,white,age.gp4,NoTr,NoTrade,NoGroup,6,0,2,1,3,1,4,1,1,5,0,6,3,3
1831,1832,1832,black,age.gp4,NoTr,NoTrade,NoGroup,5,0,0,1,4,2,3,0,1,4,1,4,3,2
1496,1497,1497,white,age.gp4,NoTr,NoTrade,NoGroup,1,0,0,0,1,0,1,0,1,0,0,1,1,0
1497,1498,1498,white,age.gp4,NoTr,NoTrade,NoGroup,1,0,0,0,1,0,1,0,1,0,0,1,1,0
1500,1501,1501,white,age.gp4,NoTr,NoTrade,NoGroup,1,0,1,0,0,0,0,1,1,0,0,1,1,0
1506,1507,1507,white,age.gp4,NoTr,NoTrade,NoGroup,1,0,0,0,1,0,1,0,1,0,0,1,1,0
1514,1515,1515,black,age.gp4,NoTr,NoTrade,NoGroup,1,1,0,0,0,0,1,0,0,1,0,1,1,0
1516,1517,1517,black,age.gp4,NoTr,NoTrade,NoGroup,1,0,1,0,0,0,0,1,0,1,0,1,0,1
1517,1518,1518,black,age.gp4,NoTr,NoTrade,NoGroup,1,0,0,0,1,1,0,0,0,1,0,1,0,1
1828,1829,1829,black,age.gp4,NoTr,NoTrade,NoGroup,2,0,0,0,2,2,0,0,0,2,1,1,1,1
1524,1525,1525,black,age.gp4,NoTr,NoTrade,NoGroup,1,0,1,0,0,0,0,1,1,0,0,1,1,0
1525,1526,1526,black,age.gp4,NoTr,NoTrade,NoGroup,1,0,0,0,1,1,0,0,0,1,0,1,0,1
1535,1536,1536,black,age.gp4,NoTr,NoTrade,NoGroup,1,0,0,0,1,0,1,0,1,0,0,1,1,0
1536,1537,1537,black,age.gp4,NoTr,NoTrade,NoGroup,1,0,0,0,1,0,1,0,0,1,0,1,1,0
2732,2733,2733,black,age.gp3,NoTr,NoTrade,NoGroup,3,0,1,1,1,1,2,0,0,3,0,3,1,2
1970,1971,1971,white,age.gp4,Tr,NoTrade,NoGroup,2,0,0,1,1,0,2,0,1,1,0,2,1,1
2811,2812,2812,other,age.gp2,NoTr,NoTrade,NoGroup,2,0,1,1,0,0,2,0,1,1,0,2,2,0
2193,2194,2194,white,age.gp4,NoTr,NoTrade,NoGroup,1,0,0,0,1,0,1,0,1,0,0,1,1,0
1852,1853,1853,black,age.gp3,NoTr,NoTrade,NoGroup,2,1,0,0,1,0,1,1,1,1,0,2,1,1
2620,2621,2621,white,age.gp4,NoTr,NoTrade,NoGroup,1,0,0,0,1,0,1,0,1,0,0,1,1,0
2880,2881,2881,white,age.gp2,NoTr,NoTrade,NoGroup,1,0,0,0,1,0,1,0,1,0,0,1,1,0
1744,1745,1745,black,age.gp4,NoTr,NoTrade,NoGroup,1,0,0,0,1,0,1,0,1,0,0,1,1,0
2205,2206,2206,white,age.gp4,NoTr,NoTrade,NoGroup,4,0,0,1,3,0,4,0,3,1,0,4,3,1
1691,1692,1692,white,age.gp4,NoTr,Trade,NoGroup,4,0,0,2,2,0,4,0,4,0,0,4,4,0
1743,1744,1744,black,age.gp4,NoTr,NoTrade,NoGroup,1,1,0,0,0,1,0,0,1,0,1,0,0,1
2224,2225,2225,black,age.gp4,NoTr,Trade,Group,4,1,0,2,1,3,1,0,1,3,1,3,3,1
1686,1687,1687,white,age.gp4,NoTr,Trade,NoGroup,1,0,1,0,0,0,1,0,1,0,0,1,0,1
1638,1639,1639,other,age.gp2,NoTr,NoTrade,NoGroup,3,0,1,0,2,0,3,0,1,2,0,3,2,1
1639,1640,1640,other,age.gp2,NoTr,NoTrade,NoGroup,2,0,2,0,0,0,2,0,2,0,0,2,2,0
1645,1646,1646,other,age.gp2,NoTr,NoTrade,NoGroup,1,0,1,0,0,0,1,0,0,1,0,1,0,1
2202,2203,2203,white,age.gp4,NoTr,NoTrade,NoGroup,1,0,1,0,0,0,0,1,0,1,0,1,0,1
1649,1650,1650,other,age.gp2,NoTr,NoTrade,NoGroup,2,0,1,1,0,1,1,0,2,0,1,1,2,0
2010,2011,2011,black,age.gp4,NoTr,NoTrade,NoGroup,1,0,1,0,0,0,1,0,1,0,0,1,0,1
2622,2623,2623,white,age.gp4,NoTr,NoTrade,NoGroup,1,0,1,0,0,0,1,0,1,0,0,1,0,1
1675,1676,1676,white,age.gp4,NoTr,Trade,NoGroup,1,0,0,0,1,0,1,0,0,1,0,1,1,0
1677,1678,1678,white,age.gp4,NoTr,Trade,NoGroup,1,0,0,0,1,0,1,0,1,0,0,1,1,0
1680,1681,1681,white,age.gp4,NoTr,Trade,NoGroup,1,0,0,0,1,0,1,0,1,0,0,1,1,0
1682,1683,1683,white,age.gp4,NoTr,Trade,NoGroup,1,0,0,0,1,1,0,0,0,1,1,0,1,0
1685,1686,1686,white,age.gp4,NoTr,Trade,NoGroup,1,0,0,0,1,0,1,0,1,0,0,1,0,1
1965,1966,1966,white,age.gp4,Tr,NoTrade,NoGroup,7,0,1,3,3,0,7,0,3,4,2,5,5,2
1692,1693,1693,white,age.gp4,NoTr,Trade,NoGroup,1,0,1,0,0,0,1,0,1,0,0,1,1,0
1694,1695,1695,white,age.gp4,NoTr,Trade,NoGroup,1,0,0,0,1,0,1,0,0,1,0,1,1,0
1702,1703,1703,white,age.gp4,NoTr,Trade,NoGroup,1,1,0,0,0,0,1,0,1,0,0,1,0,1
1705,1706,1706,white,age.gp4,NoTr,Trade,NoGroup,1,0,0,0,1,1,0,0,0,1,1,0,1,0
1972,1973,1973,white,age.gp4,Tr,NoTrade,NoGroup,1,0,1,0,0,0,1,0,1,0,0,1,1,0
2553,2554,2554,other,age.gp1,NoTr,NoTrade,NoGroup,2,2,0,0,0,0,2,0,2,0,0,2,0,2
2687,2688,2688,black,age.gp3,NoTr,NoTrade,NoGroup,4,0,2,1,1,2,2,0,1,3,1,3,4,0
2079,2080,2080,black,age.gp3,NoTr,NoTrade,NoGroup,2,0,1,1,0,0,2,0,1,1,0,2,2,0
1742,1743,1743,black,age.gp4,NoTr,NoTrade,NoGroup,1,0,0,1,0,0,1,0,1,0,0,1,0,1
2188,2189,2189,white,age.gp4,NoTr,NoTrade,NoGroup,1,0,0,0,1,1,0,0,0,1,0,1,0,1
1753,1754,1754,black,age.gp4,NoTr,NoTrade,NoGroup,2,0,0,0,2,1,1,0,0,2,1,1,1,1
2450,2451,2451,white,age.gp4,NoTr,NoTrade,NoGroup,1,0,0,0,1,1,0,0,0,1,0,1,0,1
1754,1755,1755,black,age.gp4,NoTr,NoTrade,NoGroup,1,1,0,0,0,0,0,1,0,1,0,1,1,0
1762,1763,1763,black,age.gp4,NoTr,NoTrade,NoGroup,2,0,2,0,0,1,1,0,0,2,0,2,2,0
1763,1764,1764,black,age.gp4,NoTr,NoTrade,NoGroup,1,0,0,1,0,1,0,0,0,1,0,1,0,1
1764,1765,1765,black,age.gp4,NoTr,NoTrade,NoGroup,1,0,0,0,1,0,1,0,1,0,0,1,1,0
2436,2437,2437,white,age.gp4,NoTr,NoTrade,NoGroup,1,0,0,0,1,0,1,0,1,0,0,1,1,0
2441,2442,2442,white,age.gp4,NoTr,NoTrade,NoGroup,1,0,0,0,1,0,1,0,1,0,0,1,1,0
2911,2912,2912,other,age.gp1,NoTr,NoTrade,NoGroup,3,1,1,0,1,0,3,0,1,2,0,3,2,1
2894,2895,2895,other,age.gp1,NoTr,NoTrade,NoGroup,2,0,2,0,0,0,2,0,1,1,0,2,2,0
1811,1812,1812,black,age.gp4,NoTr,NoTrade,NoGroup,1,0,0,1,0,1,0,0,0,1,0,1,0,1
1815,1816,1816,black,age.gp4,NoTr,NoTrade,NoGroup,1,1,0,0,0,1,0,0,0,1,0,1,0,1
1818,1819,1819,black,age.gp4,NoTr,NoTrade,NoGroup,1,0,1,0,0,1,0,0,0,1,0,1,1,0
1819,1820,1820,black,age.gp4,NoTr,NoTrade,NoGroup,1,0,0,1,0,0,1,0,0,1,0,1,0,1
1823,1824,1824,black,age.gp4,NoTr,NoTrade,NoGroup,1,1,0,0,0,0,0,1,0,1,0,1,1,0
1826,1827,1827,black,age.gp4,NoTr,NoTrade,NoGroup,2,0,0,1,1,1,1,0,0,2,0,2,0,2
2225,2226,2226,black,age.gp4,NoTr,Trade,Group,3,0,0,1,2,2,1,0,0,3,0,3,1,2
1832,1833,1833,black,age.gp4,NoTr,NoTrade,NoGroup,1,0,0,1,0,1,0,0,0,1,0,1,1,0
1834,1835,1835,black,age.gp4,NoTr,NoTrade,NoGroup,1,0,0,1,0,1,0,0,0,1,0,1,0,1
1837,1838,1838,black,age.gp4,NoTr,NoTrade,NoGroup,1,0,0,1,0,1,0,0,0,1,0,1,1,0
1841,1842,1842,black,age.gp3,NoTr,NoTrade,NoGroup,4,2,0,2,0,2,2,0,1,3,0,4,1,3
1845,1846,1846,black,age.gp3,NoTr,NoTrade,NoGroup,1,0,0,1,0,0,1,0,1,0,0,1,1,0
2550,2551,2551,other,age.gp1,NoTr,NoTrade,NoGroup,3,2,0,1,0,2,1,0,0,3,0,3,1,2
1987,1988,1988,white,age.gp4,Tr,NoTrade,NoGroup,1,0,0,1,0,0,1,0,0,1,0,1,1,0
2187,2188,2188,white,age.gp4,NoTr,NoTrade,NoGroup,1,1,0,0,0,0,0,1,0,1,0,1,1,0
1921,1922,1922,other,age.gp2,NoTr,NoTrade,NoGroup,3,1,2,0,0,0,3,0,1,2,0,3,3,0
1927,1928,1928,other,age.gp2,NoTr,NoTrade,NoGroup,2,0,1,1,0,1,1,0,0,2,1,1,2,0
1931,1932,1932,other,age.gp2,NoTr,NoTrade,NoGroup,2,0,2,0,0,1,1,0,0,2,0,2,2,0
2432,2433,2433,white,age.gp4,NoTr,NoTrade,NoGroup,3,0,0,0,3,0,3,0,1,2,0,3,3,0
2182,2183,2183,white,age.gp4,NoTr,NoTrade,NoGroup,3,1,0,0,2,0,3,0,1,2,0,3,3,0
2435,2436,2436,white,age.gp4,NoTr,NoTrade,NoGroup,1,0,0,0,1,0,1,0,0,1,0,1,1,0
2455,2456,2456,white,age.gp4,NoTr,NoTrade,NoGroup,3,0,0,0,3,0,3,0,0,3,0,3,3,0
1966,1967,1967,white,age.gp4,Tr,NoTrade,NoGroup,1,0,0,0,1,0,1,0,1,0,0,1,0,1
1982,1983,1983,white,age.gp4,Tr,NoTrade,NoGroup,1,0,1,0,0,1,0,0,0,1,0,1,1,0
1994,1995,1995,white,age.gp4,Tr,NoTrade,NoGroup,1,0,1,0,0,1,0,0,1,0,0,1,1,0
1996,1997,1997,white,age.gp4,Tr,NoTrade,NoGroup,1,0,0,0,1,0,1,0,1,0,0,1,1,0
2204,2205,2205,white,age.gp4,NoTr,NoTrade,NoGroup,1,0,0,0,1,1,0,0,0,1,0,1,0,1
2002,2003,2003,black,age.gp4,NoTr,NoTrade,NoGroup,1,0,0,0,1,0,1,0,1,0,0,1,1,0
2011,2012,2012,black,age.gp4,NoTr,NoTrade,NoGroup,1,0,0,1,0,1,0,0,0,1,0,1,1,0
2012,2013,2013,black,age.gp4,NoTr,NoTrade,NoGroup,3,0,1,1,1,1,2,0,1,2,1,2,3,0
2628,2629,2629,white,age.gp4,NoTr,NoTrade,NoGroup,1,0,0,0,1,1,0,0,0,1,0,1,0,1
2018,2019,2019,black,age.gp4,NoTr,NoTrade,NoGroup,2,0,0,1,1,0,2,0,1,1,1,1,2,0
2024,2025,2025,black,age.gp4,NoTr,NoTrade,NoGroup,1,0,0,0,1,0,1,0,0,1,0,1,1,0
2635,2636,2636,white,age.gp4,NoTr,NoTrade,NoGroup,1,0,0,1,0,0,1,0,1,0,0,1,1,0
2176,2177,2177,white,age.gp4,NoTr,NoTrade,NoGroup,1,0,0,1,0,0,1,0,1,0,0,1,1,0
2190,2191,2191,white,age.gp4,NoTr,NoTrade,NoGroup,1,0,0,1,0,0,1,0,1,0,0,1,1,0
2088,2089,2089,black,age.gp3,NoTr,NoTrade,NoGroup,2,0,1,1,0,0,2,0,2,0,0,2,1,1
2191,2192,2192,white,age.gp4,NoTr,NoTrade,NoGroup,1,0,0,1,0,0,1,0,0,1,1,0,1,0
2196,2197,2197,white,age.gp4,NoTr,NoTrade,NoGroup,1,0,0,0,1,0,1,0,0,1,0,1,0,1
2203,2204,2204,white,age.gp4,NoTr,NoTrade,NoGroup,1,0,0,0,1,0,1,0,0,1,0,1,1,0
2530,2531,2531,other,age.gp1,NoTr,NoTrade,NoGroup,3,1,0,1,1,1,2,0,0,3,1,2,3,0
2364,2365,2365,white,age.gp3,Tr,NoTrade,NoGroup,4,1,1,1,1,0,3,1,2,2,0,4,3,1
2372,2373,2373,black,age.gp2,NoTr,NoTrade,NoGroup,3,1,2,0,0,2,0,1,0,3,0,3,0,3
2403,2404,2404,white,age.gp3,NoTr,NoTrade,NoGroup,1,0,0,1,0,0,1,0,0,1,0,1,0,1
2447,2448,2448,white,age.gp4,NoTr,NoTrade,NoGroup,2,1,0,1,0,0,2,0,0,2,1,1,1,1
2443,2444,2444,white,age.gp4,NoTr,NoTrade,NoGroup,1,0,1,0,0,0,1,0,1,0,0,1,1,0
2444,2445,2445,white,age.gp4,NoTr,NoTrade,NoGroup,1,0,1,0,0,0,1,0,0,1,0,1,1,0
2892,2893,2893,other,age.gp1,NoTr,NoTrade,NoGroup,2,1,0,1,0,1,1,0,0,2,0,2,1,1
2541,2542,2542,other,age.gp1,NoTr,NoTrade,NoGroup,3,3,0,0,0,0,3,0,0,3,0,3,1,2
2554,2555,2555,other,age.gp1,NoTr,NoTrade,NoGroup,1,1,0,0,0,0,1,0,0,1,0,1,0,1
2555,2556,2556,other,age.gp1,NoTr,NoTrade,NoGroup,2,0,2,0,0,0,2,0,2,0,0,2,1,1
2633,2634,2634,white,age.gp4,NoTr,NoTrade,NoGroup,1,0,0,0,1,0,1,0,0,1,0,1,1,0
